abcdefghijklmnopqrstuvwxyz-=[];/
ABCDEFGHIJKLMNOPQRSTUVWXYZ_+{}:?
OOOOOOOOOOOOOOOOCCCCCCCCCCCCCCCC
7
17 17
..@#.........#...
.###.###.###.#.#.
.#.....#.#.#.#.#.
.#.#####.#.#.###.
...#.#...#.......
.###.#.#.########
.#...#.#.#.......
.#.###s###.#####.
...#...#!#...#.#.
##.#.###.###.#.#.
...#...#.....#...
.#####.#######.##
..E..#.......#...
####.#######.###.
...#.#...#.....#.
.###.###.#.#####.
...v.....#.......
17 17
.......#.........
##.###.#.e######.
!..#.#...#...#...
####.#####.T.#.##
...#.......#.#.#.
.#.D.####A##.#.#.
.#.#.....V...#.#.
.#.#####.#.###.#.
.#.....#.#.....t.
.#######.#c#####.
T......#.....#...
.#####.####E.#.#.
.#...#.....#...#.
.#.#.#.#.#######.
...#.#.#.#...#...
####.#.###.#.#.##
@....#.....#.....
17 17
...e...#.E.......
.###.#.#.#.###B#.
...A.#.#...#.....
##.#.#.#####.####
.#.#.B.#...#...b.
.Q.#.#.#.#.###.#.
.#.#dt.v.#...#.#.
.#.#.######Q.###.
...#.#.A...#.....
.###.#.###.####A.
.#...#.#.#.#.....
.#.#.#r#.#.######
.#.#.#...#......!
.#.#B###.########
V#.....#.#.....#.
.Q##.#R#.#.###.#T
..@#.......#.....
17 17
.....#...........
.#####.#######.#.
T#.....#.......#.
.#.e####.#######.
.#.R..@#.#.......
.#.#.###.#u#####.
...#...#C..#..B#.
.###.#.###.#.#.#.
.D.#.#...#...#.#.
##.#.#.#######.#.
.#.#a#.#.......#.
.#.###U#.#####.d#
.#.....#.#...b.#!
.#####.#.###.#s#.
...#...c...#.#...
.#q#.#####.#B#.##
.........#..b....
17 17
..@#.....#..!#...
.###.###.#.###.##
.....#...#.#.....
.#####.#.#.###.#.
.#.....r.#...#.#.
##.#####.###.###.
...#.......S...#.
.#########.###.#.
.#.....#Q..#...#.
.#.###.#####.###.
.#...#...#...#...
.A##.###.#.###.##
.#...#...#.q.....
.#.###.#.#.#v##a.
.#...s.#.#.#.#...
.###.#.###.#C#.#.
.....#........U#.
17 17
.............#...
####.#######.#.#.
...#.#.....#...#.
.#.d.#.###.#E###.
.#...#...#.....#.
.#######.d##u###.
...#..@#...#.....
##.#.###.#####.##
...#.....#!..#.#.
.###.#######.#.#.
.#.S.#.....#.#...
.###.#.#.###.c##.
...#.#.#...#.#.#.
.#.#.#.###.#.#.#s
.Q.#.#.#.#.b.#b..
.#.###.#.#.#.#.##
.#.......#...#...
17 17
..S..#...#!..#...
.#.#.###.###.#.#q
.#.#.......#.#.#.
.#.#######.#.#.#.
.#.#.......#a#.#.
.#.####s.###.u.#.
.#R#.t.#...E...#.
.#.#.#.#.t######.
.#...A.#.#...#...
.#####.#c#.#.#.##
.#...#.Q...#.#.#.
.#.#.#######.#.#.
.#@#.....#...#...
.#q###.#.#.#E###.
...#...#.#...#...
##.#.###.r##.#.##
.....#....E#c....
