abcdefghijklmnopqrstuvwxyz-=[];/
ABCDEFGHIJKLMNOPQRSTUVWXYZ_+{}:?
OOOOOOOOOOOOOOOOCCCCCCCCCCCCCCCC
7
17 17
..........@#.....
.#####.#.###.#.##
...#...#.#...#...
##.#.#####.#####.
...#.#...#.#.....
.###.#.#.#.#.###.
...#.#.#...#.#...
##.#.#.#####.####
...#.......#.#...
#######r.###.#.#.
.....#.#.q...#.#.
.###.#.#.#.###.#.
!#.#.#...#...#.#.
##.#.#######.#.#.
..q#.#.....#...#.
.###.#.###.#####.
.......#.........
17 17
.#!..#...........
.###.###.#####.#.
...#...#.#....R#.
.#.###.###.#####.
.#.....#...#@....
.#######.########
...#...#.........
##.#.#.#########.
.#.#.#.........#.
.#.#.#########.#.
.#.#...#.....#...
.#.#.#.###.#####.
...#.#...#...#...
.#######.###.#.##
.......#.#...#...
######.#.#.#####.
.........#.......
17 17
.....a.......#...
.#.#.###.#R#.#.#.
.#.#...#.#...#@#.
.#.###.#.#.#####.
.#...#...#.....#.
####.#.#######.#.
...#.#.#...#...#.
.#.#.#.#.#.#.###.
.#...#.#.#.#.#...
.#######.#.#.#.#.
.#.......#.#.#.#.
.#.##r#A##.#.#.#.
.#...#.#...#.#.#.
.###.#.#.###.###.
...#!#...#.A...#.
.#####.###.###.#.
.a.....#.........
17 17
...#.......#.....
.#.#.#.###.#.###.
.#.#.#...#.#...#.
.r.#####.#.###.#.
.#..!#...#.....#.
.#####.#########.
.#...#...#@......
.A.#.#.#.########
.#.#...#.........
.#####.#########.
.#...#A....#.#...
.#.#.#r###.#.#.#.
...#...#.#...#.#.
######.#.#.###.#.
.....#.#..R#...#.
.q##.#.#####.###.
..rr.........#...
17 17
..........!#.....
.a############.#.
...#...........#.
##.##Q######.###.
.#.#.........#...
.#.#.#########.a#
.#...#.....#...#.
.#####.###.#.###.
.......#@..#...#.
##.###.#######.#.
...#...#...#...#.
.#######.#.#.###.
.#.......#.#...#.
.#.#######.###.#.
.#...#A..#...#...
.###.###.###.###.
...........#.....
17 17
...........#...#.
####.#.###.#.#.#.
...#.#.#@..R.#...
.#.###.#########.
.#.....#.....#...
.#######.###.####
.......r...#.....
.###########.###.
.......#...#.a...
######.#.#.###.#.
...#...#.#..!#.#.
.#.#####.#####.#.
.#.......#...#.#.
.#########.#.#.#.
.#...#.....#...#.
.#.#.###.r######.
...#.....#.......
17 17
r#.............#.
.#.###.#######.#.
..Q#...#...#...#.
.###.#####.#.###.
.#...#.....#.#...
##.###.#####.#.#.
...#.....#...#@#.
.###.###.#.#####.
.#...#.#...#.....
.#.a##.#######.#.
.#.#...........#.
.#.#.###########.
.#...#!#...#...#.
.#####.#.#.###.#.
.....#...#...#...
.###.#######.#.##
...#.........#...
