abcdefghijklmnopqrstuvwxyz-=[];/
ABCDEFGHIJKLMNOPQRSTUVWXYZ_+{}:?
OOOOOOOOOOOOOOOOCCCCCCCCCCCCCCCC
7
17 17
.......#.#.......
##.###q#.#.#.#C##
...#.....#.#....!
.#G#######.######
.........#.#....@
.#####e#.#.#.####
.#.E...#...#.....
.#.#.#.#########.
.#...#.........x.
.#######.#C###.#.
.#.......#...#.#.
.#.#######.#.#.#.
...#.U.w...#.#.#.
####.#.#V###.#.#.
.......#...#...#.
.#u#r###.#.#####.
W........#.......
17 17
.....e..x....D..F
.#####.f####.####
.#...#.VU#@..#...
.#.#.###.#####.S.
.Qq#...#.#.....#.
.#.###.#.#.#####.
.#b.C#.#.D.....#!
.#.#.#.#.#b###.##
.#.#.#.#.......#.
.#.#.#.#######s#.
.#.#.#.........#T
.###.#########.#X
...R.#.......#...
##.#.#.#####.###.
R#...#E#.s.W...#.
.###x#.###.#.###.
...........#....C
17 17
.............#...
.#.#####.#####.#.
.#.#.....#...f.#r
.#.###.###.#####.
.#...#...#.#!..#.
.##a.#####.###.#.
.#...#.....#a..As
.#v#.#.#s###.###.
.#.#.#.......#...
.#.R##########.##
.#....t........#.
.###############.
.#.....#...#.....
.#.###.###.#.###.
.X.a.#...#...#...
####.###.#####.#.
@..............#.
17 17
.......#...#.....
####.#.#.#.#f#.#.
.....#.#.#.....#.
.#####.#.#######.
u....#...#..R..R.
.###.#.##t.###.#.
...#.#.#...#...#.
##.#.W##.#W#.#F##
@#.#..g....#.....
.#.##f###s######.
.#...#.........#.
.##V.#.#####V#.#.
..G#.#...#...#!#.
##.r.G##.#.#.###.
...#.#...#.#.#...
.###.A.###.#.#.#.
....E#.....#...#.
17 17
.c...B.........v.
####.#########.#.
.....#.#.....#.#.
.#####.#v##x.#u#.
.w...#...#a..#...
.#.#.#.#R#.#.###.
...#.#.#...#..T#.
.###.#.#.#####.#.
...#.#.#.....Fs#.
##.#A#####X#.###.
...#.....d.#.#...
.#########.#.#f##
.Q..C....#.#...#.
.#.###.###.#.###.
.#.#...#.b.#...#.
.#.#.#D#.v###w.#u
...#@#!q.#.......
17 17
...#...........#.
A###.r####w#.#.#.
.B.......#...#.#.
.#########.###.#.
.....g.S...#S.b#F
####.#.#####.###.
.....X.#.....#.U.
.#####.###.###.#.
....@#...#...X.#.
##.#####.#####E#.
!#.#.....#.......
.D.#e#####.######
.v.#.#.....#...q.
.###.#.#d###.###.
.#...#...#...#..c
.#c#####.V##.#.##
...#.........#.f.
17 17
...........#.....
##Q#.#.###.#.###.
...#.#.#.T.#...#.
.#.###.#.##T####.
.#.....#.......#.
.###v#.#######.#.
.#.#...r!#.#...#.
.#.#.###.#.#.##s.
.#...#...#.......
.#####.A########.
.#...#.......t...
.#.#.#######.#.##
...#...#.....#...
####.###.#######.
...#.Q...#.....#.
.#.#######.#####.
@#...............
