abcdefghijklmnopqrstuvwxyz-=[];/
ABCDEFGHIJKLMNOPQRSTUVWXYZ_+{}:?
OOOOOOOOOOOOOOOOCCCCCCCCCCCCCCCC
1
17 17
......R#..b..#...
.###.###.#.#.#.#.
.#...#...#.#.#.#.
.#####.###.#.###.
...#...#A..#B....
.#.#.###.#c#####.
.#.t...#.#...T..c
#######B.###.#.##
..r#Q..#...#.#...
.#.#.S.#.#S#.###t
.#...#.#.#.#...#.
.###A#.#.#.#.###.
q#!#.s.#.#.#.T...
.#.#.#####.#.####
...#.#...a.#.#@..
####.#.#####.###.
.....R.#.....C...
