abcdefghijklmnopqrstuvwxyz-=[];/
ABCDEFGHIJKLMNOPQRSTUVWXYZ_+{}:?
OOOOOOOOOOOOOOOOCCCCCCCCCCCCCCCC
7
29 29
..@#.........#.........#...#.
.###.#####.#.#.#####.#.#.#.#.
...#.....#.#.#.#.....#.#.#...
.#.#####.#.###.#.q####.#.####
.#.......#.#...#.#.......#...
.#########.#.###.#.#######.#.
...#....!#.#.#...#...#.....#.
####.###a#.#.#.#######.###c#.
.....#.......#.#...#.....#...
.#####t#R#####.#.#.#.#r###.#.
.#.....#.....#...#...#...#.#.
.#.###.#.###.#.#######.#.#.##
...#a..#.#.#.#.#.....#.#.#...
####.###.#.#.#.###.###.#.###.
.#...#...#.#.#.....#...#...#.
.#.###.###.#.#.#####.#####.#.
.#...#.#.#...#.#...#...#.....
.###.#.#.#.#####c#.###.#r###.
.....#.#...#...#.#.....#...#.
.#####.#.###.#.#.#######.#.##
.A.....#.#...#.#.#.......#B..
.#.#####.#.###.#.#.#######.R.
...#...#.#.#...#...#.....#.#.
####.###.#.#.###.###.###.#b#.
...#.....#.#.#...#...#.#.#.#.
.###.qc###.#.#S#.#.###.#.#.#.
...#.....#.#...#.#.#...#.#.#.
.#.##t##.#.###.###.#.#.#.###.
.C.........#.......#.#.......
29 29
.............#...........#...
.###.#######.###.#####.###.#.
.#.#.......#...#.#...#.....#.
.#.#######.###.###.#.######c.
.#...#.....#.#.....#.........
.#.#.#.#####.#.#############.
.#.#.#.....#...#.......#.....
.#a#.#####.#####.#####.######
.....#...R...#...#...#.......
####.###.###.#.###.#.#######.
.#...#.....#...#...#...#.....
.#b###.###.#########.#.#.#.##
.#...#.#.#...#.......#.q.#.#!
.###.#.#.###.##T.###.###.#.#.
...#...#...#...#.#.#.#...#.#.
.#.#####.#####.#.#.#.#.#####.
.#.#.....#...#.#.#...#.......
.###.#.###.#.#.#.#.#########r
.#...#.....#...#.#..t#.....tq
.#.t############.###.###.###r
.#.....#.#.......#.#...C...#.
.#####.#t#.#.#####.###.###.##
...#...#...#.#.......#...#...
.###.##S####.#.#####.###.###.
.#...#.......#...#.#..T#.....
.#.###.#########.A.#.#######.
.#.#C..#..@#...#.#.c.....#...
.#.#.###.###.#.#.#.#####.S.##
R....#.......#.........#....C
29 29
.....At....#.#.A.......#....@
.###.#.#.#.#.#.###.#####.#.##
...#.#.#.#.#.....#.......#...
##.#.###.#.#################.
...#.#...#...#...#...#.....#.
.###.#.#####.#.#.#.#.#.###.#.
.#.#...#.....#.#.#.#...#.#...
.#.A####.#####.#.#.B####.###.
.#.....#.#.....#...#.........
.#.#####.#####.##############
.#..ts.........#.............
.#.##t########.#.###########.
.#...S.......#.#.#.s.....#...
.r####.#####.#.#.#######.#.#.
.......#.#...#.#.........#.#.
.#######.#.#R###.#########.#.
.#.....#.#.......#......!#.#.
.#.#.#.#.#########.#######.##
.#.s.#...#...r.#...#.........
.###.###.#####.#.#######.###.
.#...#.#.#T..#Q#.#.....#.#...
.#.###.#.#.#.#.#.###.#.#.#.#.
...#.#...#.#...#.....#.#.#.#.
####.#.###.###.#######.###A#.
.....#...#.R.....#...#.#...#.
.#######.#.#####.###.#.#.###.
.#...#...#...#...#...#.#.#.#.
.#.#.#.#####.#.###.#.#.#.#.#.
...#.........#.....#.#...#...
29 29
...........#...#.......#....s
.#########.#.#.#.#####.###.#.
.#.....#.....#...#...#...#.#.
.#.###.#############.###.#.#.
.#.#.#.....#.......C...C...c.
.#.#.###r#.r.#.###.###.#####.
.#.#...#.#.#.#.#.........#...
.#.#.#.#.#.###.#B#########.##
.....#...#...#.....#...#...#@
########.###.#.###.#.#.#.###.
...#.......#.q...#...#.......
.#.#########.#.##############
.#...........#.#.............
.###.###########.###########.
...b.#.........#.....#.......
.#.###Q#######.###.###.######
.#.....#.....#....q#...#.....
.#######.#.#.#######.##r.#R#.
.......#.#.R.#.....#.....#.#.
######.###.r.#.#.#.#######.#.
...#.#.#...#R#.#.#.#.....S.#!
.#.#.#.s.#####.#.#.#.s##.#.##
.#.#.#.#.....#.#.#.#.#...#.#.
.#.#.#.#.###.#.#t#.#.#.###.#.
.#...#.#...#...#.#.#.#.#.#.#.
.t####.#.#######.#.#C#.#.#.#.
...#...#.#.......#.....#B#...
.#.#.#####.#############.###.
q#.........#.................
29 29
...#...#.........#...........
.#.#.#.#.#######.#.#####.###.
.#...#.#.....#.#...#.#...#.#.
.#####.#####.#.#####.#.###.#a
.....#.....#.#.......#.#...#S
####.#.#####.###.#.###.#.###.
.....#.........#.#A#...#.....
.#############.###.#.##t.####
.#.........#@#.....#...#.#...
.#.#######.#.#####.###.#Q#.#.
.#...#...#.#.....#.#...#...#.
.###.#.#.#.###.###.#.#.#.###.
...#...#.#...#.....#.#.#...#.
#t######.###.#.#####.#####.#.
.......#.#T#.#.....#.......#.
.#.#####.#.#.###.#####C#.###.
.#.......#.#.#!#S#.....#.#...
.#Q##t####.#.#.#.#.###.#.#.##
...#.......#.#.a.#...#.#.#...
##.#.Q####.#.#.#.###.#.#.###.
...#.....#.#...#.#...#.#...#.
.###a#####.#####.#.###.#####.
...#.....#.....#.#.#.#.......
##.#.###.q.#####.#.a.#######.
.#.#...#.#.......#.#.......#.
.#.###.#.##Q######.#.A####A#.
...#...S...#.......#.....#.#.
.###.#####.#.b######A###.###.
.....#.......#.........#.S...
29 29
...#...#...................#.
.#.#.#.#######.###########.C.
.#...#.......#.....#...#...#.
.###########.#.###.#.#.#.Q##.
...#..!#.....#...#...#.#.....
##.#.###.B######S#####.####b.
.#...#.#.#.....#.#...#.#...#.
.#####.#.#.#.###.#.T.#.t.#.##
.#.....#.#.#.#...#.#...#.#...
.Q.#.###.C.#.#.###.#####.###.
.#.#.....#.#.....#.....#.#.#.
.#.###############.###.#.#.#.
...#...#.........#...#...#.#.
.###.#.s##.#####.###.#####.#.
...#.#.....#.....#.#.......#.
##.#.##Q####.##Q##.r####.###.
.#...#.....#...#......s#.#...
.#########.###.#.#######.#.#.
.............#.#.........#.#.
.##A##.#######.#.####R####.#.
.#...#.#...#...#...#...#...#.
.###.#.#.#.#.#####.#.###.###.
.#...#...#...#...#...#...#.#.
.#.#.###########.###.#.###.#.
...#.#..A......#.....#.#@#...
####.#####.###.#######.#.#.##
...#.......#.#.#.....#.#.#...
.###########.#.#.###.#.#.###.
.................#.....#.....
29 29
.............#...#.......#...
.########r.#.#.#.#####.###.#.
...#...#...#r..#.#...#.....#.
####.#.#.#######.#.#.#######.
.....#...#.....#...#...#.....
.#####q###.###########.#.####
.#...#...............#.#.....
.#.#.#.#######.#####A#.#.###.
.#.#...#.....#.........#.#...
.#######.###.#.#########.#.##
.........#...#.......#...#...
.#########.#########.#####.#.
.#.........#.......#.....#.#.
##.#.#######.#####.##a##.###.
...#.#...#.#.....#.....#.....
.#####.#.#.#####.#.###.#####.
.#.....#.#...#...#.#...#.....
.#.#####.#.#.#.###.#.###.##B#
.#.#.#...#.#.....#.#.#.#...#.
.#.#.#.###.#######.#.#.###.#.
.#.#.#.#@..#.......#.....#.#.
.#.#.#.#####.#############.#.
.#...#...#...#.....#.......#.
.###.###.#.###.###.#.#######.
...#.#.#!#.....#...#.#...#...
.###.#.###a#####.###.#.#.###.
.....#...#.#...#.#...#.#.#...
######.###.#.#.#.#.###.#.#.#.
.......A.....#.#.......#...#.
