abcdefghijklmnopqrstuvwxyz-=[];/
ABCDEFGHIJKLMNOPQRSTUVWXYZ_+{}:?
OOOOOOOOOOOOOOOOCCCCCCCCCCCCCCCC
7
17 17
...........#.....
.#####.###.###.#.
.....#...#.#...#.
.#######.#.#.###.
.#.......#...#...
.#.###########.##
.#.#.........#...
##.#.#######.####
...#.#.....#.....
.###.#.#####r###.
.#...#.#.......#.
.#.###.#.###Q#.#.
.#.....#...#...#.
.###.###.#.###.#.
.....#!#.#...#...
.####Q.#####.###.
....@#.......#...
17 17
.....#.........#!
####.#.#######.#.
.....#...#...#...
.#######.#.######
.........#.#.....
.#########.#.#.#.
...#...#.....#.#.
##.#.###.Q####.#.
@#.#.........#.#.
.#.###########.#.
.#...#.......#.#.
.###.#.#####.#.##
...#.#.#...#.#...
.###.#.#.###.#.#.
...#...#.#...#.#.
.#.#####.#.#####.
.q...............
17 17
...#.............
.###.#####.#####.
.#...#...#.....#.
.#.###.#.#####.#.
.#...#.#...#...#.
.###.#.A####.###.
.#...#...#...#...
.#.#####.#.#####.
.........#.....#.
########.#####.#.
.....#...#...#.#.
.A##.#.###.#.#.#.
...#!#@#...#.a.#.
##.#####.#######.
.#.#...#...#.#...
.#.#.#.###.#.#.#Q
.....#.....#.....
17 17
...#...........Q.
.#.#.a.#########.
.#..A#.........#.
############.Q.##
...q.......#.#...
.#########.##R##.
...#.....#.#.....
##.#.###.#.#.###.
.#...#.#!#...#.#.
.#####.#######.#.
.....#.....#.....
##.###.###.#.####
...#...#.#.#...#@
.#.#.###.#.###.#.
.#.#.#...#...#.#.
.###.###.#.###.#.
.........#.......
17 17
.................
.#######.#.######
...#...#.#.......
##.#.#.#.#######.
!#.#.#.#.#@....#.
.###.#.#.###.#.#.
.....#.#.....#.#.
####q#.#######.#.
.....#.#.......#.
.#.###.#####.###.
.#.....#...#.#Q..
.#######.#.###.#.
.#...#...#...#.#.
.#.#.#.#.###.#.#.
...#.#.#...#.#.#.
####.##r##.#.#.#.
...........#...#.
17 17
.#.........#.....
.#.#####.###.###.
.#.#...#...#.#!..
.#.#.#####.#.####
...#.....#...#...
.##q.#.#########.
...q.#..........r
##.#.###.########
.#.#...#.....#...
.#.###.#####.#.#.
.#...#...#.#...#.
.###.###.#.#####.
...#...#...#@..#.
.#.###.###.###.#.
.#...#...#.....#.
.###.###.#######.
...#.............
17 17
...#......@#....R
.###.#.#####.###.
.....#.........#.
.#############Q#.
...#.........#...
####.#######.#.#.
.....#...#...#.#.
.#####.#.R.###.#.
...#...#.#...#.#.
.#.#.###.###.#.#.
.#.#.#.#...#r#.#.
.#.#.#.###.#.#.#.
.#.......#.#...#.
.#########.#####.
.#..!#...#...#.#.
.#.###.#.###.#.#.
.#.....#.....#a..
