abcdefghijklmnopqrstuvwxyz-=[];/
ABCDEFGHIJKLMNOPQRSTUVWXYZ_+{}:?
OOOOOOOOOOOOOOOOCCCCCCCCCCCCCCCC
7
35 35
.......#.....#.......#.....#.......
.###.#.###.#.#.#####.##C.###.#####.
.#...#.....#...#...Q...#...#...#.#.
.#.#############.#.##t.###.###.q.#.
.#.#.............#...#...#...#.#.#.
##.#.#####.#########.###.#.#.#.#.b.
...#...#...#.....#...#.#.#.#.#.#.#.
.#######.###.###.###.#.#.#.###.#.#.
.#.....#.......#...#...#.#.....#.#.
.#.###.###########.###.#.#.#####.#.
.#.#.#.........#...#...#.#.......#.
.#.#.#########.#.###.###.#####B#.#.
.#.#.....#...#.#.#.....#...#...#.#.
.#.#.#.###.#.#.#.#####.##t.#.#.###.
.#.#b#.#...#...#...#.....#...#.....
.#.###.#.########a.#.##########S##.
.#.....#...#.......#.#...........#.
.###.####t.#####.###.#.#######.#.#.
.....#.....#.....#@..#.#.....#.#.#.
.##R##.#####.#########.#.###.#.###.
...q.#.....#...#.......#.#...#.....
##.#.#####.###.#.#########.#.######
.#...#...#...#...#.....#...#.....#.
.q##.#.#####.###.#.###.#.#######.#.
...#.#.....#...#.#.#...a...#.......
.###.#.#.#####.#.#.#.#####.#######.
.....#.#.#.....#...#.....#.....#.#.
.#######.#.##########c##.#####.#.#.
.#.....#.#...#.......#...#...#.#.#.
.#.###.#.###.###.#.###.###.#.#.#.#.
.#...#..B..#...#.#.#...#...#.q.#...
.##c.#########.#.###.###.###.#.#.##
.....#..!s.....#.....#...c...#.#.#.
####.#.T##.#####.#####c#.#.s##.#.#.
.....#.....#.............#.....#...
35 35
...#.....#.....#...#.....r.......#.
.#.#.###.#.###.###.#.A####.r.###.#A
.#R..#.....#.......t.#...#.#...#...
.#########.#########.#.#.#####.###.
...#.....#.#.........#.S.#.....#...
.#.#.##c.###.#########.#.#.#####.##
.#.#...#.....#.....#...#...#...#.#.
.#.#.#######.#.#####.#######.#.#.#.
.#...#.....#.#.#...R.....#...#.#...
.#####.###.#.#.#.#.#####.#.#r#.###.
..S..#.#.#.#.s.#.#.......#.#...#...
######.#.#.#.#.#.#########.##q##.##
.......#.#.#...#...#...#.......#...
.cT#####.#.#######.#.#.#####.#.###.
.#.......#.......#...#A....#.#..@#.
.#b#.####t######.#.#######.###.###.
...#...........#.#.......#...#.....
.#.#.###.#.#####.#########.#.######
.#.#.#...#.#...#.........#.#...#...
.#.#.#.###T#.#.#########.#####.B.#.
.#.#.#.......#...#.....#.#...#...#.
##.#####.####S.#.#.###.#.#.#.#####.
...b...#...#...#.#.#...#.#.#.....#.
.###.#.#C#.#.#####.#.###.#.#####.#.
Q....#.#.#.#.....#.#.#...#.#.....#.
.#####.#.#.s####.#.#.#.###.#.#####.
...#.#.#...#...#.#.#...#...#...#...
##.#.#.#####.#.#.#.#####.####A.#.##
...S.#.#.....#.#.........#.....#...
.###.#.#.#####.#####a#####.A######.
.....#.#.#.#...#...#.....#.........
####.#.#.#.#.#.#.#.###.######T####.
.....#...#.#.#.#.#...#...#.....#...
.#########.#.###.###.#.#.#.#.###.R#
........T..#.......#!#.#...#.......
35 35
b..#.............#@....#...........
.#.#.#######.###.###.#.#.###.#####.
.#...#.#.....#.......#.#...#.#.....
.#####.#.###C#############.#.#####.
A......#...#.#.............#.....#.
##########.###.###A###########T#.#.
.....#!#...#...#b..R.....A.......#.
.###.#.#.###.#b#######.###.c.###R#.
...#...#...............#...#.#...#.
##.#####.#############.#.#.###.#.##
.#...#.#.#.......#.#...#.#.#...#...
.a##.#.#.#.#####.#a#.###.###.#####.
...#.#.#.#...#...c....T#.....#.....
.t.#.#.#.###.#.######B##.#####.###.
.#...#...#.#.#.#.......#...#...#...
.#####.###q#.#.#.#s###.#####.###.##
...#...#...#.#...#...#.......#.t.#.
##.#.###.#.#.#####.#######a###.###.
...#B....#.#.#.....#.........#.#...
.###C#######.#.#####.#T###.###.###.
.............#.......#.#...#...#...
##############.#######.#.###.###.##
.......#.....A.#.....#.#.#...#...t.
.#q#####.#######.###.#.###.#######.
.#.......#.........#.#...c.#.....#.
.#.#######b#########r#########.#.#.
.#.#...........#.#.Rq#.....#...#...
.#.###########.#.#.#.###.#.#.s####.
.#...........#.#.#.#...#.Q.#...S.#.
.###########.#.#.#.##s.#.#.###.#.#.
......A..#.#.#...#.#...#.#.#..s#...
.###R###.#.#.#####.#.###.#.T.###.##
.#.#.#....B#.....#.#.#...#...#.#...
.#.#.####c######.#.#.#.#######.###r
.T.#Q..............#...#...........
35 35
.......#.......#.........#.........
.###.s.Q##.###.###.#.#####.#######.
.#.#.#...#.#.......#.#S....#.....#.
.#.#.###.#.#.####S###b.#######S#.#.
.#.#.#.#.#.#.#.......#...#...#...#.
.#.#.#.#.#.###.###c#.###.#.#.#.q##.
...#.#.#.#.#...#...#...#...#.#...#.
####.#.#.#.#.###.#.#.#######.##T.#.
...#.#c#...#...#.#.#.............#.
.#.#.#.###.###.#.#.##########S####.
.#...#.......A...#.......#.....#...
.##r.#############.##Q####.###.#.##
...#.#.....#.......#.......#...#...
.#.###.###.#.#######.#######.###.#.
.#...#...#T..#..a....#...#...#...#.
####.t.#######.#####a#.###.#######.
.....#.#.......#.....#...#...#.....
.#.###.#.#######.#.t.#.T.###.#.###.
.#.#...#.#.....#.#.#.#.#.....#...#.
.###.###.#.###.#.#.###.####b##.#.##
.#...#...#.#@#...#...#.#.#.....#...
.#.###.###.#.#######.#.#.#.#######.
.#...#.#...#...#...#...#.......#...
.##s.#.###.#.TS#.#.#.###########.#.
.....#...#...#...#.#...........#.#.
.#######.#####.###.###########.#.#.
.#.#.....#.....#...#.......B...#.#.
.#.A.#####.#####.###.###.###.###.#t
...#.....#...#.#...#...#...#...#.#.
##.#####.###.#.###.##s####.###.#.#b
.....#.....A.....#...#!#.....#.#...
.#####.#########.###.#.#.###.#.###.
.#.#...#...Q...#.#.#...#.#...Q.....
.#.#.###.#.#.#.#.#.#####.#########.
...#.....#...#...#.................
35 35
.#...........#...#.......#.....c...
.#.#####.###.###.#.###.#.#.###.#.##
.#.....#.#@#.#...#.#...#.#.#...#...
.#.###r#.#.#.#.###.#.###.#.###.###.
...#...#.#.....#...#.#...#...#...#.
.##s.#.#.#####.#.###.#######.#q#.#.
.#...#...#...#q#.#...#!..Q...#.#.#.
#b.#######.#.###.#.#####.#.###.#.#.
...#.......#...#.#.....#...#s..#.#.
.#.b.##q######.#.###.#.#######.#.#.
.#.#...#.......#...#.#...#.....#..q
.#####.#.#######.###.#####.#.#####.
.#.....#.........#...#.....#...#...
.#.###############.r.#.#####.Q.#.##
.#.#.#.......#.....#.#.#...#.#.#.#.
.#.#.#.#.#####.#####.R.#.#.###.#.#.
.#.#...#.#...#.....#.#.#.#.....#...
.#.#####.#.#.#####.###.#.##c######.
.#.......#.#.....#...#.#.#.......#.
.#######.#.#####.#.#.#.#.#.#####.#.
..R....#.#.#...#.#.#...#...#.....#.
.#####.#.#.###.#.#########.#.#.###.
...#...#.#.#...#.#...#...#.#.#.q...
##.#.###.B.#.###.#.#.#.#.###.#.#.q#
...#.#...#.#...#.#.#...#...#.#.#...
.#.###.###.#.#.#.#.#######.#.#####.
.#.#...#...#.#...#...#...#.#.....#.
.###.###.R##.#######.###.#.###.#.#.
.#...#...#.........#...#.#.#...#.#.
.#.###.###.#######.###.#.#.#.###.#.
.#.#.#.#...#.....#.....#.A...#...#.
.#.#.#.#####.###.#.##############A.
.#.#.#.....#...#.#.#...#...#.....#.
.#.#.#####.###.#.T##.#.#.#.#.###.#.
.........#.....#.....#...#.....#...
35 35
...#@..........#.....a.....#.......
.#.#########.#.#.###.#######.#####.
.#...s.....#.#.#.#.#.......#.....#.
.###.#.###.###.#.#.#######.#.#####.
.#.#...#.#.#...#...#...#.#.#.#...#.
.#.#s###.#.#.B####.#.#.#.#.#.#.#.#.
.#...T.....t.#...#...#...#...#.#...
.#.###.#####.#.#.#######.#####.###.
.#...#.#...#...#...#.....#.....#.#.
.###.#.###.#.###t#.#.####C.#####.#.
...#.....#...#...#.#.....R.#...#...
##.#####.#####.#.#.#####.#.#.###.##
...B...#.#.....#.#.#.....#.#...T.#.
.###.#.#.#.#####.#.#.#####.###.#.#.
...#!#.#.#.T.....#.#.#...#...#...#B
##.###.#.#.#.####C.#.###.###.#b#.#.
.#.....#.#.#.....#.........#...#...
.#####s#.#.#####.#.###########.####
.#.....#.#.#.#...#.#.........#..b..
.#.###.#.#.#.#.#####.#######.#####.
...#...#...#.c.#.....#...#...#.....
.###.#.#####.#.#.#####.#.#.###.###.
.#...#.....#.#.#.#.....#.#.....#...
.#.#######.#t#.#.#####Q#########.##
.#.A.......#.#...#.....#...#...#.#.
.#.#.######c.#####.#####.#.#.#.#.#.
.#S#...#.......#.......#.#...#...#.
##.###.#######.#.#####tQ.#########.
...#.#...#.....#.#.#...#.#.......#.
.###.###.#.#####.#.#.#.#.#.#.###.#.
.#.........#.....#.#.#.#.#.#...#...
.###.#######.#####.C.###.#####.###.
...#...#...B.#.....#...#...#...b...
.#.#####.#####.###.###.###.#.c##.##
.#.............#.....#.......#.....
35 35
.........#.....#.....#.............
.#t###.###.###.#.###.#.###.#######.
.#r..S.......#.B.#...#.#...#.......
.#.#.#r#######.#.R.###t#.###.######
.#.B.........q...#.....#...#.....#.
.#.#########.#.###########.#####.#.
.#...#.....#.#.#...#.......#...#.#.
##b#.###.#.#.#.#.###.#########.#.#.
.....#...#.#.#...#...#.......#.#...
.#####.#####.###.#.###.#####.#.###.
.#.....#.....#...A.#...#...#...c...
.#R#.###.#########.#.#.#.#.#####.##
.#.#.#...#.....#...#.q...#.......#.
.#.###.#####.#.#.#R#.#Q###########.
.#...........#..s#...#.........#...
.######q##########.##T#t.#####.#.#.
.#.....#.....#.#...#.....#...#.#.#.
.#.###.#.###.#.#.##S##.#####.#.#.##
...q...#...#...#.......#.....#.#a..
.###.#####.###.###########.###.#.#.
.#...#.....#.....#.....c...#...#.#.
##.#####.#########.###.#####.#####.
...#...#...#.......#.#.......#.....
.###.#.#.#.#.B####R#.#########.###.
...#.#.#.#...#.....#.......#...#...
.#.#.#.#.#####.###.#.###.#.#.######
.#...#.#.......#...#.#.#.#.#.t.....
.#####.#.#######T#.#.#.#.#.###.###.
...#...#.#...#...#C#..A#.#...#.#.r.
##.#.#####.#.#.#.#.#####.###.C.#.##
.#.s.......#.#.#.#.......#...#.#...
.#.#########.#.#.#########.#######.
.#.#.......#.#.#.#...#@#...#.....#.
.t.####S.#.#.#.#.#.#.#.#.#r###.#B#.
.........#.#...#...#!#.........#...
