abcdefghijklmnopqrstuvwxyz-=[];/
ABCDEFGHIJKLMNOPQRSTUVWXYZ_+{}:?
OOOOOOOOOOOOOOOOCCCCCCCCCCCCCCCC
7
17 17
.#.........#.....
.b.s######.#.#.##
...#.....#.#.#...
.###.#Q#.#.#.###.
.#.....#.#.#...#.
.#.#####.#.###.#.
@#.#.#...#.....#.
##.#.#.###.#####.
...#.U.#.....#T#.
.###q#.#####.#.#.
.b...#...#..e..#.
####.###.#Q#B##e.
...#...#...#.#...
.#.###.D##.#.#.#.
.#.#...#.#!#.#.#R
.###.###.###s#.#.
...........t...#.
17 17
.#.........#.....
.#.#####.#.#####.
....@#...#...#A..
r#####.#####.#.##
.......#...#.#...
.#######.#.#.###.
.#...E...#...#...
.#.R.#####.###.#.
...#.#...#.B...#.
####.#.#.#####V#.
....c#.#.#...#...
.#####.#.###.#.##
.#.....#...#.#...
.#.#######.#.###.
...#.....#.#...#.
.#####.#.#.#.#D#.
....s..#.#!#.#...
17 17
@S.....#!..#...t.
.#.#.##A##.#####.
...#.....#.#.a.#V
.#######.#q#.#.#.
...#...#.#...#...
.###.#.#.#######.
.#...#.#.......#.
.#.###.#####.#.#.
.#.#.Q...#...#.#.
.#.#####.#.#V###.
.#.#...#...#.#.Q.
.#.#.#.#####.#.##
.#...#...#...#...
.#######.d##.###.
...#...#...#...#.
##.#.#.###.#####.
.....#...#.......
17 17
@#E....d.........
.#.#.#.#.#.#.####
...#.#.#.#.#.#..R
####.###u#.###.#.
.....#...#S..#.#.
.#####.#####.#.#.
.......#.....#.#.
.#######.#####.#.
.....#.#.......#.
####.#.####a####.
A..#...........#.
.#.#####.#####.#.
.#.......#..!#.#.
.#########.###.#.
.#...#.....#...#.
.###.B.#########.
.....#...........
17 17
.....#...#.......
.U##.b##.#.#####.
...#...#.#.....#.
.#A##C.#.###r#B#.
.#...#.....#.#!..
.###.######e.e###
.R.#.#.....#.#@..
.#.#.#.###.v.###.
.#.V...#.#.U.....
.#.#####.#.####A.
.D....v..#.#.....
.#.#.###.#.#.###D
.#.#...#.#...#...
.###.#.#.#####.#.
...#.E.#.#.....#.
##.###.#.###.###.
.......#.....#...
17 17
.R.........#.....
##########T#.#.##
.........q.#.#...
.#######.###.###.
.#....e..#.....#.
.####B##.#.##d##.
.......#.#...#...
.#####c###.###.#.
.....q...#.a...#.
########.#d#.###s
...R.....#.#...#.
.###.#####.###.#.
.#u..#.....#...#.
.#####.#####.#V##
...#...E...#.....
.#.#.#####.#####.
@#.V....C..#!....
17 17
.#...#.....#.....
.#.t.#.#T#.###D#.
...#...#.#...#.#.
.####c##.#D#.#.##
.....#.....#.#...
####.###.S##.###.
...#.#...#...#...
.#.#.#.###.###.#.
.#.#...#!#...#.#@
.#####.#.#.#.#.##
.#.....#.#.#.#...
.Q.#####.###.b.#.
e#...T.#.....#.#.
.#####.#########.
...#...#.......a.
.#.#.####v.###.#.
.#....U....#.....
