abcdefghijklmnopqrstuvwxyz-=[];/
ABCDEFGHIJKLMNOPQRSTUVWXYZ_+{}:?
OOOOOOOOOOOOOOOOCCCCCCCCCCCCCCCC
7
33 33
........@#.........#.............
.#########.###.#####.#########.#.
...#...#...#...#.......#.....R.#.
##.#.#.#.#r#.###.#######.#C#.###.
...#.#...#.#.....#.#..!#.#...#...
.#.#.###R#.#######.#.###.#.###.##
.#.#.#.......#.....#.#...#.....q.
.#.#.#####.#.###.###.#.#.#######.
.#.#.#.....#.....#...#.#...#.....
.###.#.#######t#.#.#######.#.#q#.
...#...#.......#.#.#.......#.#...
##.#######.###.#.#.###.#######.t.
...#.....C.#...#.#...#.#.......#.
.#S#.#.#.#.#.###.###.#.#.#.###C#.
.....#.#.#.#...C...#...#.#.....#.
.#####.#.#####.###.##R########.#q
.....#.#.#...#...#.#.......#...#.
##.###.#.#.#.#.#.#.#####.#.#.####
...#...#.#.#...#.#.......#.#.....
####.###.#.###############.#####.
.....#...#...#s.r....#.....#.....
.#####.t##.#.#.###.###.b####.####
.#.#...#...#...#...Q...#.....#.r.
.#.#.########t##.#.A.###.#.###.#.
.#.#.....#.......#.#...#.#.....#.
.#.####t.#.###########.#.#######.
.#.....#...#.......#...#.....#...
.#.#.###.###.#####.#.#######.#.#.
.#.#...S.#...#.#...#.#.......#.#.
.#########.###.#.#.#.#####.###.#.
...#.....#...#.#.#.#....c#...#.#.
.#.#.###.###.#.#.######a.a####.#.
.T...t.#.......#...............#.
33 33
.......#...#...........#.#.......
.#####.#.#.#.#####t###.#.#.#####.
...#.....#...#.......#.#.#..A..#.
##.#.#########.#####.#.#.#####.#.
...#...#...#@..#.a.#.........#.#.
.#######.#.#####.#.###########.#.
.#.....#.C!#...#.#.........#...#.
.#.###.#.#R#.#.#.#########.#.###.
...#.#.#.....#...#.......#...#...
.###.#.#############s#R#######.##
.....#..R....#.......#.......#...
q###.#####.#.#####.###.#.#######.
...#.#.....#a....#.#...#.....#...
.#.#.#.####a####.#.#.#####.#.#.##
.#...#.......#.A.#...#...#.#.#.#t
.###########.#.#.#.###.#.S.#.#.#.
...........#.#.#.#.#.#.#.#.#.#.#.
.######Q####.#.#.#.#.#.#.#.#.#.#.
.#...........#.#.#...#.#.#.#.#...
.#.###########.#.#####.#.###.###.
.#.......#.....#.......#...#...#.
.####C##.#.###.###########.#.###.
...#...#.#.#.#.........#...#...#.
##.#.#.#.#.#.#######.###.#####.#.
...r.#...#.........#...........#.
.###.######T.#####C###########.#.
.#...#.....t.#...#.........C.#.#.
.#.###.###.#b#.#.#.#######.#.#t#.
.#.#...#.#.....#.#...#.....#...#.
##.#.###.#######.#.###.#.#####.#.
...#.#...#.....#...#...#.#...#.#.
.###.#.#.#####.#####.#####.#.###.
.......#...........#.......#.....
33 33
...#.........#...#...........#...
T###.###.###.#.#.#.#.####s####.#.
...#.#.#.#.....#.#.#...........#.
##.#.#.#.#T#######.###########.#.
...#.#.#.#.#.......#...#...#!#.#.
.#.#.#.#.###.##t####.#.#.#.#.#.#.
.#.#...#...#.....#...#...#.#.#.#.
.####a.T##.#####.###.#####.#.#.#.
...#...#.#.....#...#.....#.#.#.#.
##.#.###.#####.###.#####.###.###.
...#.....#...R...#...q.#...#...#.
.#.#####.#.###.#.#####.#.#.###.#.
.#...#...#.#...#.....#.#.#...#...
.#.###.###.#.#######.#.###.######
.#.#...#...#.....#...#...#.....#.
.###.#####.#####.#######.###.#.#.
.#...#.........#.......#.....#...
.#C##c.#.###########.####S#A####.
...#.#.#.#.........#...#.........
.###.#.#.#.#####.#.###.#.########
.#...#.#.#...#s..#...#...#.......
.#.###.#.###.#.###.#######.##R##.
.#...#.#.#...#...#.#.......#...#.
.#.#.#.#.#.#t###.###.#####.###C#.
.#.#...#t..#...#...#.#.....#...#.
.#.#########.#.#.#.#.#.#####.#.#.
.#.......#...#.#.#.qA#.#.....#.#.
.#######.#.###.#######.#.#.###.#.
.....#...#.#.........#.#.#.#...#.
####.#.###.#########.#.#.#.#S###.
...#.#...#.....#...#...#.#.#.....
.r.#.#########.#.#######.#.#.####
.#.............#.........#......@
33 33
.............a.....#.#....R......
########.##B.###.#.#.#.#.########
.....#...#.#.....#.#..b#.........
.###.#.###.#######.#.#s#########.
...#...#@....#...#.#...........#A
.#.#######.#.#.#.#.#########.###.
.#.#.......#.#.#...#...#.....#...
.#.#####.#####.#####.###.#####.#.
.#.....#.....#.....#.#...#..T#.#.
.#####.#.#as.#####.#.#.###.#.#.#.
...#...#...#...#s..#...#...#...#.
.###.#########.#.###.###.##q####.
.#...#.....#...#...Q.#...#...#.#.
.#.#####.#.#.#####.#.#.###.#.#.#T
.#.....s.#.R..T#...#.#.#...#.#...
######.#.#.###.#.#####.#.##c.###.
.......#.#.....#.#.....#.#.#...#.
.#######.#####.#.#.###.#.#.###.#.
.#.#.....#...#.#...#...#...#.#.#.
.#.#.#.##a.#.#######.#####.#.#.#.
.#...#.....#.......#.....#...#.#.
.#.#######t#######.###.#####.#.#A
.#...#...#.#.....#...#.#.....#...
.#####.#.###.###.#t#.#.#.###.#s#.
.......#...#.#.#.#.#...#.#!#...#.
.#########.#.#.A.#.#####.#.#####.
.#.......#.#.#.#.#.....#.#...#...
.#.#####.#.#.#.#.#######.###.B.##
...#...#.#.Q.#.#.....#...#.#.#...
####.a##.#####.#####.#.###.#.#.#.
.#.......#.....#...#...#...#.#.#.
s#.#######.###.#.#.#####.#.#.###.
...........R.....#.......#.#.....
33 33
.....a.#.......#.....#.....#.....
.##q.#.#####.###.###.#.###.#.#.#.
.#...#.A...#.....#...#.#.#.#.#.#.
.#.###q###.######c.#c#.#.#.#.#.##
.#.#.....#...#...#.#.#...#...#...
.#.#.###.###.#.#.#.#.###.#######.
.#.#.#.....#.#.#.#.#...#.....C...
.#.###.#####.#.#.#.#########.#.##
.#...#.........#...#.........#...
.###.#a###########.#.###########.
.#s#.#.#.....#.#...#...#.........
.#.#.###.###.#.#.#####.#.#######.
...#.....#...#.....#...#...#.....
##.#######.#########.#####.#.####
.#.#.....#...#.....#.....#.#...#.
.#.#.###.###.#.###.#####.#.###.#.
...#...#...#...#.#...t.#.#...#...
.###.#.###.#####.###.###.###.###.
.#...#.#.#.#.....#...#.....#.#...
.#.###.#.#.###.#.#.###.#####.#.##
.#r..#.#.#.....#S#.....#...#.#.A.
.#####.#.#####.#########.#.#.###.
.......#...#...#.........#.#...#.
########.#.#.###.#########.#.#.##
.....#...#.#.#.#.#.....#@#.#.#...
.###.#.#.###.#.#.b.###.#.#.#####.
.#...#.#.......#.....#.#.#.......
.#.###.#########.#####.#.#######.
.#...#.#...#...#...t...#.........
####.#.#.q.#.#.#####.#B#.########
.....#.#.#.#!#.#...c.Q...#.....#B
.#####.###.###.#.#.#.#.#####.B.#.
.......B.s...#...#...b.......#...
33 33
...............c...#.............
.#######.#####.#.#.###t#########.
.#...#.#.#.......#.#.....#.....#S
.#.#.#.#.#########.C.##R.#.###.#.
...#.#.#...#B....#...#.....#.#.#.
####.#.###.#.###.###.#######.#.#.
.#...#...S.#.#.#...#.#.....#...#.
.#.#####.#.#.#.###.#.#.###.#.###.
...#.....#.......#.#.#...#.#.....
.###.###.#########.#.###.#.#####.
.....#...r.r.#...#.#...#.#.#T....
######.##C##s#.#.#.##r##.#.###.##
...#...#.......#...R...#.#...#.#.
.#.#.###.#######.###.#.#.###.#.#.
.#.#.#.#...#...#.#...#...#...#.#.
.###.#.###.#.#.#.#.T######.###.#.
.......#.#.#.#...#!#t....#.#.#...
.####c.#.#.#.#######.#q###.#.###.
.#...#...#.#...c...s.#.....#.#...
.#.#.#####.#.#########.#####.#.##
.#.#.......#.#.........s...#...#.
.#.#######t#.#.#########.###.###.
.#.......#...#.#.#.......#...#...
.#######.#.###.#.#.#####.#.###.#a
...#...#.#.#...#...#.....#...#...
.###.#.#.#.a.#A#.###.###.###.#.#.
.#...#...#.#.#.....#...#.#...R.#.
.#.#######.#.#.#######.###.###.#.
.#.......#.#.#.#.#.....#...#...#.
.#######.#.#.#.#.#.#####.s#####A.
...#...#.#@#.#...#.......#.....#.
##.#.#.#.###.###.###########.#.#.
.....#.#.....#...............#...
33 33
.......#.......#.........#......C
.C##.#.#.#####.###.#####.#.r##.##
.#...#...#...#.....#.#...#...#...
##.#######.#.#######.#.#########.
...#@#.....#.......#...#.........
.###.#.#########.#.#.#####.#####.
.#.......#.....#.#.........#...#.
.#########.###.#############.#.#.
.......#...#.#.........#...#.#...
.#####.#.###.#########.#.#.#.###c
.....#.#.#...q.#...#...#.#.#.....
######.#.#.#.#.#.#.#.###.#.#####.
.....#.#.#.#.#.#.C.#.....#.#...#.
.###.#.#.###.#T#.#.#####.#.#.#.#.
.#.....#.....#...#.....#.#.#.#...
.###########.#.#######.###.#.####
.#.......#...#.#.........#.#.#...
.#b###.###.###.#########.#.#.###.
.#.#.#.......R.........#...#.#...
.#.#.a############.###.#####.#.#.
...#.....#.#.....#...#.....#...#.
###c.###.#.#.###.###.#####.#####.
.......#...#...#!#.....#...#...#.
###R##.###.###.#########.###.###.
.......#.....#...#.......#...Q.#.
.#######.#######.#.#######R###.#.
.....#.#.#.....#...#...........#.
.###.#.#.#.###.#####.#####.###.#.
.#.#.#...#.#q#.......#...#.#...#.
.#.#.#.###.#.###########.#.#.###.
.#.#.#.#...#.........#B..#.#...#.
.#.#.###.###q#R#####.#.#.#.#####.
...#.........#.........#.#.......
