abcdefghijklmnopqrstuvwxyz-=[];/
ABCDEFGHIJKLMNOPQRSTUVWXYZ_+{}:?
OOOOOOOOOOOOOOOOCCCCCCCCCCCCCCCC
1
17 17
@#.........#.....
.#.###.#.#.#.T.#.
...#!#.#.#S#R#.#.
####.#.#.###.#.#.
.....#.#.#...#.#.
.C####.#t#.###s#.
.q.#.#.#...#T#.#.
##.#.#C#####.#.#.
.#.#.#.......#.#.
.#.#.#.###A###.#.
.#.#.#.#.B.#...#.
.#.#.#.#.#.#.####
a..#...#.#.#.....
.####q##.#.#.###c
...A.#...#.#..r#.
####.#.###.#####.
......b#Q........
