abcdefghijklmnopqrstuvwxyz-=[];/
ABCDEFGHIJKLMNOPQRSTUVWXYZ_+{}:?
OOOOOOOOOOOOOOOOCCCCCCCCCCCCCCCC
7
17 17
..s..............
######.#.#######.
.....U.#.#.....#.
.###.###.#.#####.
.#......dS...#...
.###########.#.##
.....#.....#.#.#.
.###.#.###.#.#.#.
.#.#.#...#...#.#.
.#.#.###.###.#.#.
...#...#...#.#...
U#####.#.#.#####.
.#.....#.#.#.V.#.
.#.#######.V.#.#.
.#.#!....#.#.#.U.
.#.####a.#.#.####
.#....a..#S.....@
17 17
......E........#!
.#.#####.#######.
.#.#...#@#.......
.#.#.#.###.######
.#.#er...#...#...
.#B#.###.###.###.
S....#v#...#.s.#.
.####t.###.##r.#.
...U.....#...#.#.
##.#.#.###.#.#.#.
.#.#.#.#...#.#.c.
.a.#.###.#####.#.
.#.#...#.......#e
.#.#.#.#########.
.#.#.#...#...#...
.#.###.#.#.#.###.
Q....ta#...#....b
17 17
.#...............
.#.######R##.####
.#.....#...#.#..!
.#####.#.###.#.##
.....#.#...#.#...
##.#.#.###.#crv#.
...#.#.v...#.#...
.###.#.q####.#.##
.#...#D#.....#...
.###.#.#.#.#####.
...#@#.#.#.#...#.
.#.#E#.#.###.#.#.
.#...#.#...#.#...
.##t.#.###.#.###r
...#.#...#.#.#t..
##.#.###.#.#.##r.
...#.....#.......
17 17
.........#.......
.###r#.###.###.##
.#...#...#.#.#u..
.#.#.###.#.#.###.
.#b#...#.....#...
.#.###.###d#.#.#.
.v...#.....d.#.#.
.###.####e.###.#.
.C.#.d...C.....#.
.#.#.###########.
...#.......#...#.
##.#######.#.###.
...#....r..#.....
.###.#########.##
...#.........#.#.
##.#####e###.#.d.
@....#!......#...
17 17
.#!#.............
.#.###########.#.
.#...........#.#.
.######u####.#.##
.......#..B#.#...
.###.###.#.#.###.
.#.#.#...#.#.....
.#.#.#.#C#.#####.
.#.#...#.#.......
.#.##A##.######QU
.c.....#.........
.#.###.#R#######.
.#...#.#.#.......
.###.#.###.#####.
.#...#.#...#...#.
.#.###.#.###.#.#.
...#.....#@..#...
17 17
.................
.#####.#########.
...#...#.......#.
##.#.###.#####.#.
...#.#.....#...#.
.###.#####.#.###.
...#...#...#...#.
.#####.#.#####.#.
.#.....#.#.....#.
.#.#####.#.#E###.
.#.#.#...#.......
##.#.#.#Vt#######
...#.#...#.....#@
.###.###.#.###.#.
!#.....#...#...#.
##.###.##C##.###.
.....q..T........
17 17
.#.......#.....#.
.#.#.#####.#v#.#.
...#...R.#.#.#...
.#tq#q##.#.#.###.
.#.....#...#.#@#.
##.###.#####.C.#.
..Q#.........#.#.
.#############.#.
...#...#.....#.#.
##.#.#.#.###.#.#.
...#.#.....#.#...
.###.#######.D###
.#.....#.....Aq..
.#.#####.#####.#.
...#.....#.....#.
.###.####E.#R###.
..q#.A......d..#!
