abcdefghijklmnopqrstuvwxyz-=[];/
ABCDEFGHIJKLMNOPQRSTUVWXYZ_+{}:?
OOOOOOOOOOOOOOOOCCCCCCCCCCCCCCCC
7
17 17
.......#.........
##.#.##B.#####w#.
...f.#...#...u...
.##B##.##t.#####.
.......#...#...#.
.#######.###E###.
.T...r.#.#..v....
.#.###.#.#.######
.#f#.....#.....#.
##.#.##F######.#.
...#...#.....#...
.#####.#.###.####
...#.#.#..!#.....
.#.#.#.#########.
.#.#......@#...#.
.#.#########.#B#.
.#...........#...
17 17
.......#D..#.....
####.#.###.#.D##.
.....#.....#...#.
.#####.#######.#.
...#...#.......#.
##.#.###.######e.
B.R#.#...#..R..#.
.#####.###.###.#.
.......#.....#.#.
.###R######F.#.#.
.............#.#.
#####R###w##.###.
......@#....R#...
.###.###.#####.#.
.#.r.#...#.A...V.
.#####.#tA.s####.
.........#....!#.
17 17
..S........#...#.
####.#####q#.#.#.
.....bc..#!..#...
.###.#.#.#######.
.#.#.#.#.........
.#.#.#.#C###Q###u
.#...#.#........c
.#####.#.###.###.
.#...#.#..@#...#.
.#.#.#.#####.#.#.
...#.#.#...#.#.c.
A###.#.#.#.#.#.##
w..#.#.e.#.#.#..U
####.#####.#####.
.........#.......
.###########F###.
.................
17 17
...............#d
.##a######.###.#.
...#.....#...#...
##.#.#.##A##.#E#.
.#.#@#.....#...#.
.#.#######.###.#d
.#.#.........#...
.S.#.v####t#W###.
...#.#...#!....#.
.###.#.#.#####a#.
.#.....#.....#...
.##v######.#.####
...#...t...#.#...
#q.#.#.#.###.#.##
..s#.#.#...#.#...
.#D#.#.###.#.###.
.....#.....#.....
17 17
...S.............
.#.#.###########.
.#.#t#....C#!..#.
.###.#.#####C#.#.
...#...#.......#.
.q.###.#.#######.
.#...#.#.#.....#.
.#.###.#.D.#.#.#.
.#.....#.#.#.#.#.
.######W.###.#.#.
.#.....#.s...#.a.
.#.###.#.A.###.#.
.#.#.#.#...#.#.#.
.#.#.AT#####.#.#.
...#F#.....w.#...
####.#####.#.V###
@......W.........
17 17
.....#.....#.....
.#.#.#.###.#####.
.#.#.#...#.....#.
##.#.###.#####.#.
...#.#...#.....#.
.###.#.###.###D#.
.#.#...#.#.......
b#.#####.#######.
.#.......#...#...
.#.###.#.#.#.#.##
.#.#.#.#@#.#...#.
.#.#.#.###.#####.
.#...#...#.#...#.
.###.###.#.#.#.#.
...e...#.#...#...
.#.Q####.#######.
.q....!#.........
17 17
.U...#.........#.
.#.#.#.##W##.#.#.
.V.T......We.#.#.
.######E####.#.#.
......@#.....#..w
#T######.#######.
!......#.#..Q..#.
######.#.#.###.D.
...#.#.w.....#q#D
.#.#.#.####f##.#A
.#...#.......#...
.#.#########.###.
.#.#.....a.#.....
.###.C.#########.
.#SQ.#.........E.
.#.#######.##E##.
.........#.......
