abcdefghijklmnopqrstuvwxyz-=[];/
ABCDEFGHIJKLMNOPQRSTUVWXYZ_+{}:?
OOOOOOOOOOOOOOOOCCCCCCCCCCCCCCCC
7
17 17
.................
.d####.####T####.
.....#S#...#.....
.#E#.###.b.######
.#.#.d...#.......
.#.#######.#####.
.#...#!..#.#.....
.###.###.###.B###
...#...#.....#...
##.#.#.#######.##
.#...e...#...#...
.#######.#.#.#.#.
w#.......#.#.#.#.
.#v#######.#.#.#.
.#.#@......#...#.
.#.#############.
.................
17 17
.#.........#.....
.#B###.###.#.V##.
...#...#.#.#.#.#.
.###.###.#.#.#v#.
.#f..#...#.#...#.
##.###.#D#.#####.
...#.#....D#...#.
.###.#.###t#.#.q.
...#...#..U..#...
##.T.#####.#####.
...u.......#.....
.#######.#######.
.#.......#.....#.
.#########.###.#.
...#.....q!#.#.#.
.#.#.###.v##.#.#.
.#.....#.......#@
17 17
..b........#.....
######.###.#####d
.q..!#...#...#...
.#######.###Q#.##
a..#.....#...#...
##.#.#.#####.##V.
...#.#.....#.....
r#######.#.######
.......#.#....V..
######.#.#######.
...#...#..@#..S#.
##.#.#######.#.#.
...F.#.......#...
.###.#.#.#######.
.....#.#.#..D.Q..
.##w####.#.######
.........#.....c.
17 17
....c..#.........
.s.E#b.###.#####.
.#.#.#...#.a.....
#A.t.###.#.#.####
...#..q#.#@#.....
.###.#b#.#######.
..b#.C.e.#.......
##.#.#.###.######
...#V....F.......
.#######.##A#f##.
.#!..#.#.#....R..
.###.#.#.#.##E##d
.....#...#.#.....
######.###.#.#q#.
...#...#.......#.
.#.#.R##########.
.#...A...........
17 17
@#...#...#..D#A..
.#.#.#.#.###.V.#.
.#.#...q...#.#.#.
.#.#######.#.#.#.
.#.E...Q...#...#.
.#.##t.#####.###.
.#...#..u..#.F.#D
.###.##t#e.##d##.
...d.#...#.#.....
.#.#.#.#B#.Q.####
.#.#.#.#...#....w
.#.d.#.#.#####.#.
.#.#.#.#.....#.#.
.###.#.#####.###.
.#!..#...#...#...
.c####.#.#.###.#.
.......#.......#.
17 17
.........#.......
##.#####.###.###.
...r.#...#...#.#.
.###.#.###.###.#.
.t.#...#....E#...
.#.#.d##.###A####
.#.#C#.....#e#...
##.#.###a###.#.#.
...#.......#...#.
.#q#####B#.#.###.
.#.......#.#.#...
.#.##F##.#.###.#T
.#.#.....#.....#.
.#.#.###########.
.#.#!#.F.#.W...#.
.#.###.#.#.T.B##.
..s#@..U...#.....
17 17
.............#..@
.####S######.#.##
.........#.#.#...
.C######.#.#.#.#.
.....#...#...#.#.
####.#.###.#####.
...#.#...#.....E.
.#t#.##s.####S###
...#...#.#.......
##.###.#.R.#####.
...#...#.....#...
.###.#########.T.
.#...#.#...#...t.
.#.###.#.#.#.#Q#.
.#.#...#.#...#...
.#.#.#.#.#fA##U##
.....#A#........!
