abcdefghijklmnopqrstuvwxyz-=[];/
ABCDEFGHIJKLMNOPQRSTUVWXYZ_+{}:?
OOOOOOOOOOOOOOOOCCCCCCCCCCCCCCCC
5
17 17
.#...............
.#.###s#####.###.
.#.#..b....#.#...
.B.#.#####.###.#.
.#.#.#.....#...#.
.#.#.#s###.#.###.
...B.....#...#.#.
.#######.#####.#.
.#.....#...#.#c..
.#.#.#####.#.#.##
...#.#...#.#..S..
#S##.#.#.#.#.####
...#.#.#..At.#!..
.#.#.#.#####.###.
.#@#.#.#...#.#...
.###.#.#.#.##s.##
.....#...#.......
17 17
@#..T..........#.
.#.###.#######.#.
.....#...#.#s..#.
########.#.#.###.
.....#...#...#...
r###.#.#####.#.#.
.#s....#...#...#.
.#######Q#.#####.
.......#.#.t...#.
a#####.#.#.#.###.
.#...#...#.#.....
.###.#####.#.####
.........#.#...#.
####.r####.###.#.
.....#!..#...#.#.
.#######.###.#.#.
.......#.....#...
17 17
@#.....#...q.....
.#.###.#.#.######
.A..!#.#.t...#...
.#####.#####.#.#.
...#...#...#...#.
.#.#.###.#.##T##.
.#.#.....#.......
.###############.
.#.....#.........
.#.#.###.#q######
.#.#.....#S......
.#.###########.##
.#.#t........#...
.#.##T.###.#.###.
.#...#...#.#.....
.###.#####.#####.
...........#.....
17 17
.......#...#.....
.#.###.#.#.#.#.#.
.#.#.#.#.#...#.#.
##.#.#.#.#####.#.
...#...#.#...#.#.
C#######.#b#.#.#.
.....#.R.#.#.#.#.
.###.#.#####.#.#.
.R.#.#.#....c#.#.
####.#.###.#.#.b.
.....#.#...#.#.#.
.###.#.#.###.#.##
...#c#...#@#.#...
.#.#######.#.###.
.#.........#C#..a
.###.#######.#.##
...#.........#..!
17 17
.....T.....#C..#.
.b##.#T###.#.#.#.
.#.#.....#...#...
.#.###R#.#######.
...#...#.#....r#C
##.#.###.###.###.
...#...#...#.....
.#####.###.#####s
.........#...#..q
############.#.#.
.....C.....#.#!#.
.###A#####.rq###.
..B#.........#...
##.###########.##
...#...#....B..#@
.###.#a#.#######.
.....#...........
