abcdefghijklmnopqrstuvwxyz-=[];/
ABCDEFGHIJKLMNOPQRSTUVWXYZ_+{}:?
OOOOOOOOOOOOOOOOCCCCCCCCCCCCCCCC
11
17 17
.....#.......#...
.#####.###.###.#.
.#...#...#.#...#s
.#.#.q##.#.#.###.
.#.#.....b...#.#.
.b.#######.###.#.
...#.#...#.#...#.
.###.#.#.#.###.#.
.....#.#.#.....#.
####.#.#.B####.#.
...#.#.#.#.....#.
.###.#.#.#######.
.....#.#.......#.
.#####.###Q###.#.
...#!#.#.#...#...
##.#.#.#.#.#.###.
@..#...#...#.....
17 17
.............#...
.###########.#.##
...#...#.....#...
##.#.#.#.#####.#.
.#...#.#.#@....a.
.#####.#.A##.###.
.#...#.#...#.#!#.
.#.#.#.###.###.#.
.#.#...#.#.#...#.
.#.#####.#.c.###.
...#S...rr...#...
.######T.#######.
.#...............
.#.#########R###.
.#...#.....#.....
.###.#.#.###.####
.....#.#......c..
17 17
...........#.....
.#.###.###br.###.
.#...#.#....q..S.
.###.###.#######.
...#...#...#.#...
r#.###.#A#.#.#.##
...#.#.....#.#.#.
.###.#######.#.#.
.#...S.......#!#.
.###.#######.###.
...#...#...#.....
##.#####.#.#####.
.#.#...#.#...#...
.#.#.#.#.###.#.#.
...#.#...#...#.#.
.Q##.#####.###.#.
.....#.........#@
17 17
.#.......#.....#.
.#.#.###.#.###.#.
...#.#.....t.#.#.
.###.#######.#.#.
.#.#...#.....#.#.
.#.###.#.##B##.#.
.#...#.#.#...#.#.
.#.#.#.#.#.#.#.#.
...#.#.#...#...#.
##.###.#######T#.
...#...#!....#...
.###.#######.###.
.#.#.......#a..#.
.#.#######.###.##
.....#@t.....#...
####.#.#.#######.
.......#.........
17 17
....Q..t...#.....
.#####.#.#.###sS#
.....#.#.#..!#...
######.#.#######.
.......#.#....q.Q
.#####.#.#.###Q#.
.#@....r.#...#.#.
.#####r#.#.#.#.#.
.#..A....#.#.#.#.
.#.#########.#.#.
.#.#.....#...#a#.
.#.#.#.#.#.###.#.
...#.#.c...#...#.
.A####.#####.T.#.
.....#...#t..#.#.
####.###.#.###.#.
A...c....#...#...
17 17
.................
.#.#######S#####.
.#.#...#.......#.
.#.#.#.#.#####.#B
.#.#.#...#...#.#.
.#.#.#####.#.#.#.
.#.#.....#.#...#.
.#.###.###.#####.
.#...#.#...#...#.
#b.###.#.##Q.#.#.
...#...#...#c#.#.
.#.#.##s##.#.###.
.#.#.....#.#.#...
.##B####.#.#.#.##
...#.....#!#...#.
.#.#.#######.###.
.#...#@..........
17 17
...........#.....
.###.#####.#.#.##
...#.#.....#@#...
##.#.#.#########.
...#.#.....#...#.
####.#####.#.#.#.
.....#.......#...
.#########.#####.
...#.....#.#...#.
##.#.###.###.#.##
...#...#....rT...
.#####.#######.#.
.#.........#!#.#.
.#.##T######.###.
.#...#.......#...
.###.#.#####T#.#.
.....#.........#.
17 17
...#.....#.......
.#.###.#.#C#####.
.#.#...#...#.....
.#.#.#####.#.####
.#!#...#...T.....
.C####.#.###.###.
.....#.#...#.#.#.
####.#.###.#.#.#.
.....#.#...#...#.
.#####.#.#######.
.....#.#.........
####.#.#########.
...#...#.....#...
.#.#####.###.a.##
.#.#.....#@..C.#.
.###.#.#######.#.
.....#...........
17 17
.......q.......#.
.#b###.#.#####.#.
.#.#.#.#.....#.#.
.#.#.#.#####.#.#.
.#.#.#...#.#!#...
.#.#.###.#.#####.
.#.#R..q...#..Q..
.#.#b#.#.###.####
.#...#.#.#...#...
####.#.#.#.#####.
.....#...#.....#.
.#####.#######.#.
...#@#...#.....#.
.#.#.###.#.#####.
.#.#.....#.#.....
.#.#######.#####.
.#..............B
17 17
.......S.#.......
.#######.#.#.###.
.#...#...a.#...#.
t#.#.#.#######.#T
...#.#.........#.
.###.###########.
.#.#.R.......#.#.
.#.#########.#.#.
.#...#...#...#...
.#.###.#.#.###.#R
...#...#.#...#.#.
##.#.###.###.#.#.
...#...#.....#.#.
.###.#.#######.#.
.#!#.#.#.....#...
.#.###.#.#.#####.
.Q.....#@#.......
17 17
.........#.......
.#####.#.#.###.##
.#.....#.#...#...
##.#####.#####.#.
...#...#.....#.#.
.###.#.#####.###.
...#.#.........#.
T#.####T######.#.
.#.......#...#.Q.
.#######.#.#.#.#.
...#...#...#.#...
##.#.#.#####.###.
.#.#.#.......#...
.#.#.#.#######.##
...#.#.#!#..@#...
.###.t##.#.###st.
...#.....#.....C.
