abcdefghijklmnopqrstuvwxyz-=[];/
ABCDEFGHIJKLMNOPQRSTUVWXYZ_+{}:?
OOOOOOOOOOOOOOOOCCCCCCCCCCCCCCCC
7
17 17
.......#..T#.....
.#####.#.#.###U##
...R.#...#...#...
####.#.##u##.###.
.....#.#...#...#.
.#######.#.###.#.
.........#.#!#...
.#########.#.##Q.
.#...#...#.#.#@..
.###.#.#.#.#.##q#
...#...#.#.#.....
##.###.#.#.##D##.
.#...#.#.#.#.....
.###.###.#.#.####
...#.....#...#...
.#.#####R#####d#.
.#.............#.
17 17
...#...#...#.....
.#.#.#.#.#.#####.
.#@#.#...#...#...
.###.####bQ#.#.##
...#...#.....q...
.#.###.#.#####.#.
.#.U...#.#...C.#.
.#.#.###.#.#.###.
.#.#.#.#.#.#.....
##.#.#.#.#.#####.
...#!#.#.#...#.#.
.#c###.#.###.#.#.
.......#...#.#.#.
.###.#S###.#.#.#.
...#.#.T.#.#.#.#.
##.#.#####.#.#.#.
...#.........#...
17 17
.......#...#.....
.#####.#.#.##t.#.
...#.#...#.....#.
##.#.###########.
A..#.........q...
.##s.#####.###.##
.#@..#!..#.#...#B
.#######.#.#.###.
.........#.#.#...
##########.#.###.
.........#.#.....
.#.#####.#.#A#U#.
.#.#......C....#.
.#.#####.#######.
.#.....#.r...#...
.#####.###.#.#.##
.....u.....#.....
17 17
.........#@......
.#######.##r####.
..t#...#.....#...
AB.###.#####.#.##
.#...#.......#...
.###.#.#########.
.#.#.#.....#.....
.#.#.#####.###.#.
.#.#...#.......#.
.#.###.##########
.....#...........
####.###########.
...#.#.q.....#...
.#.#.#.#####.#.##
.#!#.#.#...#.#...
.#####.#.#.#.###.
.......#.#.C.....
17 17
.....#.b.........
.##R##.###u#####.
.....#.#.....#...
.###.#.#####.#.#.
...#...#.....b.#.
##.#####.a##.#.#.
.#.......#...#.#.
.#########.###.##
.........R.#.#...
.#######s#.#.###.
.#...........#...
.#.###########.##
.#..d..#..!#...#.
.u####.#.###.###.
.....#.#.....#...
.###.#.#########.
..@S....S........
17 17
...#.............
.t.####s####.####
c#..s......#.....
.#.####d##.###S#.
.#.#...#.....#.#.
.###.#.#####.###.
.#...#...#.#.....
.#.#####.#.#####.
...#.....#.....#.
Q###.#####.##S.#.
.C.#.#.....#.#...
.#r#.#.#T###.####
.#.q.#...#.b...#.
.#.#.###.###.#.#.
...#.#.#.#...#.#.
##.#.#.#.#.###.#.
...#!#.....#@....
17 17
.....#...........
.#.#u#.#.#######.
.#.#.#.#.....#.#.
.#.###.#####.#.#.
.#.....#!..#.#...
.#########.#.####
...#.#.a...#.....
##.b.#.#####.###.
...#.#.....#...#.
.###.#####.###.#.
...#.....#.#...#.
##.###.#.#.#####.
.#...#@#.#.......
.###.###.########
...#...#..D......
.#####.s######s#.
.................
