abcdefghijklmnopqrstuvwxyz-=[];/
ABCDEFGHIJKLMNOPQRSTUVWXYZ_+{}:?
OOOOOOOOOOOOOOOOCCCCCCCCCCCCCCCC
7
35 35
.....#.....#.....#.............#...
.###.#.#.###.#.#.#.#.#.#######.#.#.
.#.#...#.#...#.a.a.#.#.#...#.#.c.#.
.#.#####.#.###.###.#.#.#.#.#.#.###.
.R.....#.#.#.#...#.#.#.#.#!#.#.....
.###.#.b.#.c.###.#.#.###.###.#####.
...#.#...#.....#...#...#...#.#.....
.#.#.######c##.#######.###.#.#.##t#
.#.#.#.....#.#.#.....#...#.#.#...#.
.#.#.#.###.#.#.###.###.#.#.#.###.#.
.#.#...#.....#.#...#...#r#.#...#...
##.#.#Q#######.#.###.###T#.###.Q##.
...#.#.........#.#...#...#.c.....#.
.###.#.#######.#.#.###.###.#.#####.
.#...#...#...#...#.#.#...#.#.......
.#####.###.#.###.#.#.###.#.########
.#...#.t...#.c...#.#...#.#.........
.#.#.#.#.###.#####.#.#.#.#########.
.#.#...#...#.......#.#...#.......#.
.#.###t###.#########.#########.###.
.#.....#.#...#.....#Q..#S....#.#...
.#####.#.###.###.#####.#Q#.#.#.#.##
.......#...#.s.#.....#...#.#...#.#.
.#######.#####.#####.###.T.####a.#.
...#......C..#.....#...#...B.....#.
##.#.#######.#####.###.###.#.##r##.
@#.#q#c......#...#.#...#...#.......
.#.##Q.#####.T.###.t.###.#######R#.
.#...#.#...#...#...c.....#...#.r...
.###.#.#.#.###.#.C########.#.#.###Q
.#...#.#.#...#.#...#.......#.#.#...
.#.##C.#.###.#.###.#.#######.#.#.##
.#...#.#...#.#.#.#.#.#.....#...#...
.###.#.###.#.#.#.#.#.###A#.#######.
.......#...#.....#.................
35 35
@..........#A....#...#..!#.r..B....
########.#.#.#####.#.#.#######.####
.........#...#.....#.#.#..s..#.....
.##T#######a##.s####.#.#Q###.#S###.
.#.......#.......#...#.#.#.#...#...
.#.#####.#.#######.###.#.#.###.#.##
...#...#.....#.....#...#.#.....#.q.
.#####.#######.###.#.###.#.#a#####.
.......#...#...#...#.#...#.......#.
########.#.#.#####.#.#.#########.#.
...#.....#.#.....#.#.#..R#.....#.b.
.#.#.#####.#####.#.#.#.#.###.###.#.
b#...#...#...#...#.#.#.#...#...t...
.#####.#####.#.###.#.#.###.########
.#.........#.#.#.S.#.#...#.........
.##C.###.###.#.###.#.#############.
.a.#.r.#.....#...#.#.........#...#.
.#.#####.#####.#.###########.#a#.#.
.#.#...#.#.#...#...#...#.....#.#.#.
.#.#.Q.#.#.B.#####.#.#.#.#####.#.#.
.#...b.#.#.....#...#.#...#.....#.#.
.#####.#.#.#####.###.#########.#.#.
.#...#.#.#...#...#...#.......#.#...
.#.#.#.#.#####.#.#.#######.#.#.####
...#.#.#.......#.#.........#.#.....
####.q.#########.###########.#####.
.....#.....#..r#.#...........#.....
##########.#.#.#.#.###########.###R
...........#.#.#.#.......#.....#Q#.
.#######.##a#T.#.#######.#####.#.#.
...c...#.#...#.....#.....#...#.#.#.
.#.#.#.###.#.c.#s###.#####.#.#.#.#.
.#...#.#...#.#...#...#.....#...#...
.#####.#.###.#####.#####.#######.##
.....#.....#.............#.....R...
35 35
.#.....#...#.........#...........#.
.#.###.#.#.#.###.###.#.#.#####S#.#.
.#.#.#...#.#.#...#...#.#...#...#.#.
.#.#.#####.#.#.#.#####.###.#.###.#.
.#.#.....#!#.#.#.#.....#...#.#...#.
.#.#.#.#.###.#.###.#####.###.#.###.
...#.#.t.#...#.......#...#...#...#.
.#####.###.#c#######.#.###.#S###.#.
.#...#.....#.......#.#...#.#.....#.
.#.#.###a#.#.#####.#.###.S.#.#####.
.#.#.....#.#...#.#.#..@#.#.#.R.....
.#.#####.#.###.#.#.#####.#.#######.
.#...#.#.#.#...#.........#.....#...
.###.#.#.###.###a###T#.##R##.#.Q.##
.....#.#...#.#...#..c#.#...#.#.#Q..
###R##.###.#.#.#.#.#.#.#.#.###.###.
.......#...#.#.#.q.#...#.#...#.#...
.#####.#.###.#.#.#####.#.###.#.#.##
.#.....#.#...#.#.....#.#...#.#..s#.
.#.#####.#.#.#.#####.###.###.#.###.
.#.#...#.#.#...#...#...#.#...B...#.
.###.#.#.#.#####.#.###.#.#.#####.#T
.#...#...#...#...#...#...#.....#...
.#.###########.#####.#####.###.###.
.#.#.....#...#...#.#.....#...#.#...
.#.#.###.#.#.###.#.#####.###.#.#.##
...#...#...#.....#...#...#...#.#...
.#####.b##########.#.#.#######.###.
.......#.#.....#...#.#.......#.#...
########.#.###.#.###.#######.#.####
..C....B.#...#...#...#.......#.....
.###########.####a.###.A##########.
.#..b#.....#.#...#.....#.....#.....
.#.#.#.#.###.#.#.#########.#.#.###.
...#...#.T.....#...........#...#...
35 35
!....#...#.......#.............#...
#A##.###.#.s##.###.###.#######.#q#.
...#...#.#...#.......Q.#...#...#.#.
.#.t##.#.###.#########BA.A.#.####A.
.#.#...#...#...#.......#.#.#.#@....
.#.#.###.#####.#.#######.#.#.###.##
.#.#.#.........t.........#.#...#...
.#.#.#.###############.###.##S.#t#.
.#...#.#...#.#.......#.#.#...#.....
.#####.#.#.#.#.#####.#.#.###.#####.
.#...#.#.#...#.#.....#.....#...#...
.##s.#.#.###.#.#####.#####q###.###.
.q.#.....#...#.....#...#.....#...#.
##.#.#####.#######.###.#.###.#.#.##
.#.#.#...#.#.......#T..#.#...#B#...
.#.###.#.#.#.#########.#.#.###t###.
.#...#.#.#.#.#.......#...c...#...#.
.###.#.#.#.#.#.#####.#######.#####.
...#...#.#.#...#...#...#..t........
.##B####.####B##.#.##C.###########.
.......#.......#.#...#...#...#...#Q
.###.#########.#.###.#.#.#.#.###.#.
.#...#.........#.#...#.#...C...#.#.
.#.###.#########.###.#.#######.#.#.
.#...B...#...#.....#.#.#...#...#...
.###.###.T.#.#.###.#.#.#.#.#.#####q
.#.....#.#Q#...#...#.R...#.#.....#.
.#.###.#.#######.###.#####.#####.#.
.#...#.#.........#...#.........#.#.
.###.#.###########.###########.R.#.
...#.#.#...#.....#...........#.#.#.
.###.#.###.#.#.#############.###.#.
.#...#....R#.#.....#.......#...#.#.
.#.#####A###.###.###.#####.###.#.#.
.#.............#.........#.......#.
35 35
.......#....b........#...........#.
.#####.#######.#Q###.###.#######.#.
.#...#.......#.#.#...S...#.....#.#.
.#.#.#######.#.#.#.###.###.###.#.#.
..S#.....#.#.c.#.#AB...#.#.#.#...#.
.#######.#.#.###.#.###.#.#.#.#####.
.....#...#.......#.....R...#.....#.
.#####.###.s############.###.###.#.
.#.....#...#!..#...#.....#.#...#...
##.#####.####t.###.#.#####.#.#.####
...#........@#...#..t#....t..#.....
.###############.#.##s.####R######.
.#...........#...#.#...........#...
.#.#####R###.#.###.#.#######.###.#.
.#.#.......#...#.#.#...#...#.#...#.
.#.#.###.#######.#.#.###.#.###.###.
...#.a.#.....#.#...#.#...#.#...#...
####.#.###.#.#.#.###.#.###.#.###.Q#
.......#...#...#...#.#.#.#...#...#.
b#######.#####.##a.###.#.#####.###.
.#...#...#.....#...#...#.#...#...#.
.###.#.#########.###.###.#.#.###.#.
.....#.#.......#..R..#...#.#.....#.
.#####.#.#####.###a#####.#.#######.
.#.....#.....#...........#.......#.
.#.####Br###.##b##.#.###########.#.
.#....a..#.#.#...#.#.#.....#...#.#.
##C###.#.#.#.###.#.##t.#.###.T.#.#.
......B#...#S..#.#.....#.S..Q#...#.
.#############.#.####C##.#.#######.
...B.#...#...R.#B......#...#S......
.###.#.#.#.####b.#####.###########.
...#...#s..#.....#.......#.....#...
##.###############.#####.###.#.#.#.
...................#...Q.....#...#.
35 35
.#.......#...#r#............C#.....
.#.#.#####.#.#.#.######B.#####.###.
...#.......#.#.....#...#...#...a...
.###########.#####.#.#.###.#.###.#.
.#a........#.#...#...#.#.#...#...#.
.#.#####.#.#.#.#.#####.#.#####.####
.#.#.....#.#...#.#...#.......#.....
.#.#.#####.####s.#.##A######.#####.
.#.#.#...#...#.#!#.....#.....#...#.
.###.#.#####.#.###.#.#.#.#######.#.
.....#.......#.#...#.#.#...#.....#.
######.#######.#.###.#####.#Q#.#.#.
.....#...#...#.....#.......#...#.#.
.#.#.###.#.###.#######c#.###.#.###.
.#.#..@#.#.....#.......#.....#.#...
.#.#####.###.###.#####.#.#######.#.
.#.....#...#.#...#.#...#.#...#...#T
.#####.###.###.###.#.#####.#.#.###.
r..b.#...#...#.A...#...#...#...#...
####q###.a##.#.#.#.###.#.########c#
...#...#...#...#.#...#.#........t..
##.###.###.#####.###.#.#######.###.
...#.....#........c#.#...#...#.#.#.
.#.#.#############.#.###.#.#.#.#.#.
.#.#...#...........#.C.#...#.#.C.#.
.#.###.#.###########.#######.#####.
.#...#.#.#...........#.....#.......
.#.a##.#.#.##R######.#.#.#########.
.#.#...#.#.#...#...#.#.#A......#...
.###.###.###.#.#.#.r##.#####.###.##
.#...#...#...#...#.....#t..#.R...#.
.#.###.#.#.##b##########.###.#.###S
...#.#.#.#.#...........t...#.#.....
.###.#.###.###############.#.#####.
.t.t.#.....................#.......
35 35
...#...#.....#.......#...#.........
.#.###.#.#.###.#.###.Q.###.###.###.
.#...#...#...#.#.#...#.....#...#...
.###.#######.#.#.#.####q####.#####.
...#...#...S...#.#.........#.....#.
##.###.#.#.#####.#########C#s###.##
...#.....#.......#.#.......#...#.#!
.#.###############.#.###########.#.
.#.#...........#@#...#...........#.
.#.#.#########.#.#.#########.###q#.
.#.#.......#...#.#.a......C..#.....
.##t###R.###.b##.#.###########.####
.#.......#...#...T.#.....#.....#...
.#.#######.#####.#.#.###.#.#######.
...#.....#.#...q...#...#...#....A..
.###.###.#.#.#.#.#####.########C.#.
.#.....#.#.#.#.t.#...#.......#...#.
.#.#####.#.#.#.###.#.##s####.#.#R##
.#.#.....#.#.#.....#.........#..c..
.###.###.R.#.#################.###.
.....#...#.#...#...........#...r.#.
######.###.###.#.#######.#.#######.
...#...#.#.#...C.#.......#..a#.....
.#A#.###.#.#.###.#.#########.#.###.
...#.#...#...#...#...#.....#.#.#.#.
.#.#.#.#######.#####.###.#.#.#.#.#.
.#...#.#.....#...#...#...#.#.#S#.#.
.#####.#.#.###.###.###.#####.#.#.#.
.#.......#.....#...#...#.....#B#.#.
.#.#############.#####.#.#####.#.#.
.#...#.........#.....#.#.#.....#...
.#####.#Q#####.#####.#.#.#.###.###.
...#...#.#...#.#.....#.#.A...#...#.
#q.#.###.#.#.#.q.#####.#.#####S#.#.
.....#.....#.....#........A......#.
