abcdefghijklmnopqrstuvwxyz-=[];/
ABCDEFGHIJKLMNOPQRSTUVWXYZ_+{}:?
OOOOOOOOOOOOOOOOCCCCCCCCCCCCCCCC
9
17 17
.....#.b.#.......
.#.#.#.#.#.#.###.
.#.#.#.#...#.#.#.
##.#.#######A#.#.
...#.........#...
.q############.##
.....#.......#.#@
.###.###.###.#.#.
...#...#...#.#...
######.###.#.###.
.......#...#...#.
.###.####R####.#.
.#...#......!#...
.#####.#######.##
..r..#.....#...#.
.###.####R.#.###.
...#.......#.....
17 17
.................
.#.###b#########.
.#.#...#.......#.
.###.#.#.#####.#.
.#...#...#...#.#.
T#.#######.#r#.#.
.#...#.....#...#.
.###.#.###.#.###.
.....#.#.#.#...#.
.#####.#.b.###.#.
.#.......#...#.#@
.###.#####.#.#.##
...#.#.....#.#...
##.###.#.###.###.
...#..s#.#!#.#...
.###.###.#.###.#.
.....#...#.....#.
17 17
...........#.....
.#####.###.###.#.
.#...#.#.#.....#.
.#.#.#.#.#######.
.#.#.#.#.........
.#.#.c.##########
.#.#.#.#.........
.#.###.#.#######.
...#!#.........#.
##.#.####Q####.#.
...#.......#...a.
.###s#####.###.#.
.#.....#.#...#.#.
.#.###.#.###.###.
.#.#@#...#.#....Q
.#.#.###.#.######
...#.............
17 17
.............#..@
.###########.#.##
.#.........#.#...
.c.#######.#.###.
.#.......#.#.....
.#####.###.#####.
..b#...#!..#...#.
.###.#######.#.#.
...#.....#...#.#.
##.#####.###.#.#.
.......#.....#.#.
.#####.#######.#B
...#...#.....#...
.#.###t#.###.###.
.#.....#.#.#.....
.#####.#.#.######
.....#...........
17 17
.c.....#.b.#.#...
.#.###.#.#.#.#.#.
.#...#...#...#!#.
.###R###########.
.#.#..S..#.....#.
.#.#####.#.###.#.
.#.#....S#.#.#...
.#.#.#####.#.####
...#.....#....R#.
.#######.#####.#.
.#.....#.T...#.#.
.#.###.#.#.#.#.#.
ra...#...#.#.#.#.
.###.###.#.T.#.#.
.#.#...#@#.#...#.
.#.###.###.#####.
.....#......a...q
17 17
.......#!....#...
.s####.#####.###.
.#.....r.....#...
.#.#####.##t##.#.
s#...#...#...#.#.
.r##.#.###.#.#.#.
...#...#...#...#.
##.#s###.#.#####.
.#...#...#...#@#.
.###.#####.#.#.#.
...#t....#.#.#.#.
a#######.###.#.#.
.#S....b.#...#.#.
.#.#.#.#.#.##Q.#.
...#.#.#.#...#.#.
.###.###.###.#.#.
...#.........#...
17 17
.Q.B.......#!#...
##.#.###.###.#.##
...#.#.#...#.#...
.#.a.#.#C#.#.#.#.
.#.#.#...#...#.#.
.#.#.#T#.#####.#.
.#.#.........#.#.
.#####c###Q#.###.
...........#...#.
.Sc###S#.S.C##.#.
..c#.....#...#...
##.#.###########.
...#.........#...
.###########.#.##
.#.....C...#.#...
.###.#####.#.##r.
.....#@....#.....
17 17
...#.....#.......
.#.#.###.T.#.##c.
.#.#...#...#...#.
.#####.#######.#.
.#...#.#...#...#.
.#.#.#.###.#.##tB
.#.#.......#.#...
.#.#####.###.#.##
...#...#R#...#...
####.#.##A.#####.
.....#...#.#.....
.###A###.#.###.##
.#.....#...#!#...
.#.###.#####.###.
.#.#.#.....#...#.
.#.#.#####.###.#.
........A#.q...A@
17 17
.#T....#.........
.#.##AT#.#####.#.
S..#.#.#.#...#.#.
.###.#.Q.###.#.##
B#...#.......#...
.###.#####.####q.
.....#...#.#.....
.#####.#.###.###.
.#.....#.....sr#.
##.###########.t.
...#...........#.
.#########.###.#.
...#r......#...#.
.#.#.###########.
.#.q...#.........
.#.###.#.#R######
.#..!#..........@
