abcdefghijklmnopqrstuvwxyz-=[];/
ABCDEFGHIJKLMNOPQRSTUVWXYZ_+{}:?
OOOOOOOOOOOOOOOOCCCCCCCCCCCCCCCC
15
17 17
.....#.....#.....
.#####.#.#.#.###.
.......#.#.#...#.
.c######.#.####s.
.......#.#.....#.
##.####C.#####.#.
.#.#.....#.....#.
.#.#.#.#####.###.
.#.#.#.#...#...#.
.#.#.###.#.###.#.
...#.....#.#.....
.#########.#####.
.....#...#.....#.
####.###.#####.#.
..@#...#...#!#.#.
.#####.###.#.#.#.
...........#...#.
17 17
.........#.......
######.#.#.#####.
..q....#...#.#...
.B##########.#.##
.#.....#.......Q@
.###.###.#b#####.
...#...#...#.....
T#.#.#.###.###.#.
...#.#...#...#.#.
.###.#.#####.#.#.
.#...#.#.....#.#.
.#####.#.#####.##
.#.....#.#.#.....
.#.#####.#.#.###.
!#...#...#...#...
##.#.#.#######.#.
...#...........#.
17 17
........a....#...
.###########.#.##
.#.....r!....#...
.#####.#########.
.#.........#.....
.#.#######.###.#.
...#.....#...#.#.
######.#.###.#.#.
.#.....#...#.#.#.
.a.#.#####.#.#.#.
...#...#...#...#.
.#####.#.#######.
.#.....#.......#.
.#.#######.#####.
.#.#...#@..#.....
.#.#.#.#####.####
.#...#...........
17 17
.........#.....#.
######.#.###.#.#.
.......#..t..#.#.
.##########s##.#.
.....#.......#.#.
.###.#.#.#####aa.
B..#.#.#.........
##.#.###########.
...#.#.........#.
####.#.#######.##
.....#.#.....#.#!
.#.###.###.#.#.#.
.#.#...#...#.#.#.
.###.###.###.#.#.
.#...#...#...#...
.#.#####.#.####r#
...Q.....#.T....@
17 17
...#.....#.......
.#.#.###.#.#####.
.#.#.#.#.#.#...#.
.#.#.#.#.#.#.#.#.
.#.#...#...#.#.#.
.#.###.#####.#.#.
.#.#...#...#.#...
.#.#.#B#.###.###C
.#@#...#...#.....
.#####.###.##q##.
.....#...#...#...
.#.b.###.C##.#.##
.#.#.#.#.....#.#.
##.T.#.#####.#.#.
...#...#...#.r!#.
.#######.#.#.###.
.........#.......
17 17
..@#...r...#.....
.###.#.###.#.##B.
...#.#...#.#.#!#.
.#.#.r##.#.#.#.S.
.#.....#.#.#...#.
.#######.#.#####.
.#.......#.#.....
Q#.#.#######.t###
..B#.#.....#.#...
.#.###.###.#.#.##
.#.#...#...#.#...
.###.###.#.#.###.
.#...#...#.#.....
.#.###.########s.
.#.#.#...#.......
.#.#.###.#.#####q
.......#.........
17 17
...........#r....
###s.#####.#.#.##
.....#.....Q.#...
.#####.#########.
.#.....#.......#.
.#.#######.###.#.
.#.....#...#...#.
.#####.#.###.###.
.#...B...#...#...
.#.#######.#####.
.#.#...#.#.#...#.
.###.#.#.#.#.#.#.
.....#.#.#...#...
#C####.#.#####Q#.
.#...#!#......@#.
.#.#.###.#######.
...#..S..........
17 17
.......#.#.......
.####s.#b#.#####.
.#.....#...#.....
.#.#####.###.###.
.#...#...#.#...#.
.###.###.#.###.#.
...#...#.#.#...t.
##.#Q#.#.#.#.###.
.#!#...#...a.#...
.###.#####.#.####
...#.....#.#.....
##.#####.#.#####.
...#...#.#.#.....
.#.#.#.#.#.#.###.
.#.#.#.#.S@#.#.#.
.###.#.#.###.#.#.
.....#.......#sA.
17 17
...........#.....
.###.#####.#.#.#.
.#!#.....Q...#.#.
.#.#####.#####.#.
.#.#...#.....#.#.
##.#.#.#####.#.#.
...#.#...#...#.#.
.###.###.#####.#.
.....#.#.......#.
######S#########.
.............#...
.#####.#####.#.##
.#...#.#...#.#...
.C.#.###.#.#.###.
.#.#.....#...#...
.#.###########.##
@#..........c....
17 17
...............#.
.#######.#####.#.
.#.....#...#.#...
.#.##c.S##.A.###.
.#...#.#.#.#.....
.###.#.#Q#.###.##
.....#...C...#...
########.###.####
....a#.....#.....
##t#.#.#########.
...s.#.#..!#...#.
.###.#.#.#Q#.#.#.
...#.#.#.#...#.#.
.#.###.#.#.#.#.#.
.#.....#.#.#.t...
.##R####.###.###.
......@#.....#..b
17 17
...#...#.....#...
.#.#.#.#.###.#.#.
.#...#...#.#...#.
.#########.#####.
.#...#...#.......
.#.#.#.#.###.####
...#...#...#...#!
.#########.#####.
...#...#.#.......
##.#.#.#.########
.#.#.#.......#@..
.#.#.#######.###.
.#.#.#...#...#...
.#.#.#.###.###.##
.#.#.#...C.#.....
.#.#.#.t########.
.....#...........
17 17
.........#.....#.
.###.#####.#.#.#.
...#.#.....#.#...
.###.#.#####.r###
.#...#...#.#.....
##.#####.#.#####.
...#.........#...
.###.#######.#t#.
.....#...#@..#.#.
######.#.#####.#.
.......#.T...#.#.
.#######.#.#.#.##
.......#.#.#.S...
######.#.#.#.###.
.....#!#.#.#.#...
.#.#####.#.#.#.#.
.#.S..Q....#...#t
17 17
@t...#.......#!..
.#.#.#.#.#######.
.#b#...#.........
.#.##############
.#.#.#.......#...
.#.#.#.#.###.###.
.#.#..q#.#...#...
.#.#####.#.###.S#
.#...r...#A..#...
.###########.###.
...........#.....
.######B##.#####.
...#.......#...#.
.#.#########.#.#.
.#.......#...#...
.#A###B#.#.######
.......#.........
17 17
.#...#...#.......
.#.#.#.#.#.#####.
.#.#...#.#.....c.
.#.#####.#.###.a.
...#...#.#...#.#.
.#####.#.###.#.##
.#.....#...#@#...
.###.#.###.###.#.
.....#...#...#c#.
###Q##.#####.#.#.
...#...#.....#.#.
.#.#.###.#####s#.
.#.#.#.#!#.......
.b##.#B###.#####.
...#.#...#...#...
b#.#.#.#R###.#.##
.#.....#.....#...
17 17
...#.........#...
.#.#.#######.#.#.
.#.#...#.....#.#.
.#####.R.##b##A#s
.#...#.#.#....s..
.#.#.#.#.#.#####.
.#!#...#...#.#...
.#####q#####.#.##
.#.............#s
.a.###T######S##.
...c.............
.###.###########.
.#.......#...S.#.
.########B.###.#.
.#...#.....#.#...
.#.#.#.#####.R##.
...#...#@........
