abcdefghijklmnopqrstuvwxyz-=[];/
ABCDEFGHIJKLMNOPQRSTUVWXYZ_+{}:?
OOOOOOOOOOOOOOOOCCCCCCCCCCCCCCCC
7
25 25
.......#.....#...#...#...
.#.###.#####.#.#.#.#.###.
.#...#.......#.#...#...#.
.###.#####.###.#######.#.
...#...#...#...#.....#.#.
##.#a#.#####.#######.#.#.
.#...#...#...q.....#...#.
.###.###.#.###.###.#.###.
...#.#...#...#.#!..#.#...
.#.#.#.#####.R.#####.#.#.
.#...#.....#.#.#...#...#.
.#########.#.#.#.###B###.
.#.....#...#...#...#.....
.#.###.#.#######.#.#.####
.#.#...#.........#...#...
.##A.#.##############s.#.
.....#.#......t....#...#.
######.#########.#.###.#.
...#.#.......#...#...#@#.
.#.R.#######.#.#####.###.
.#...S...#...#.#...#.....
.#####.#.#.S##.#.#######.
.....#.#...#...#.#.....#.
.###.#.#####.###.#.###.#.
...#.........#.......#...
25 25
...#.....#...............
.###.#.#.##r##########.##
.....#.#.........#...#...
####.#.##S######.#.#.###.
...#.#...#!#...#...#..q..
.#.A.###.#.###.#########.
.#.#.#...R.#...........#.
.#.###.#.#.#.#####.#####.
.#.....#@#.#.#...#.#.....
.#########.#.#.#.#.#.####
.....#.....#.#.#.#s#.#...
.###.#.#####.###.#.#.#.#.
...#.#.#...#.#...A.#...qQ
####.#.#.#.#.#.###.#####.
.....#.#.#...#.....#...#.
.###.#.#c#.#A#######.#.#.
.#...#.#.#.#.........#.#.
.###.#.#.###.#########.#.
...#.#.#.#...#...#...#...
##.###.#.#.#b#.#.###.####
...#...#.#.....#.....#...
.###.###.###########.###.
..r#...#.SQ........#.C...
.#.###.#.#######.###.#.#.
.#.....#.......#.......#.
25 25
...R.........#...........
.#.#.###.#####.#.#######.
.#...#.#...#...#.#.....#.
.#####.###.#.A##.#.#r#.#.
...#.....#.#.#.#.#.#...#.
##.###.###.#.#.#.#.#.###.
.#...#.#...#...#...#.#...
.###.#.#.#.###.###C#.#.##
.#...#.#.#.#...#.....#.#.
.#.###.#.###.###.#####.#.
...#...#.....#...#...#...
.###.#.####t##.###.#.###.
.#...#.......#.....#...#.
.#.#######.#.#########.#.
.#@#.......#.....#...#.#.
.###.###########.###.#.##
.#...#.#.......#...#.#...
.#.###.#.#.#######.#.###.
.#.#.....#.#...#...#.#!#.
.#.#####.#c#.#.#.###.#.#.
.#.....#.#...#.#.#...#...
.#####.#.#####.#.###.##S#
.....C.#.#.#...#...#.....
##R#.#.#.#.#.#####.####T.
.......#...#.............
25 25
.#.............#.........
.#.###.c###s##.#####.###.
.#.A.#...#...#.#.....#.#.
.#.#.###.#.#.b.#.#####.#.
s......#.#.#...#.#.#....T
.#######.#.#####.#.#.####
.#.....#.#.s.....#.#.#...
.#q###.#.#.###.###.#.#.#.
.#.#.....#.....#@....#.#.
.#.#######.#######.#####.
.#.....#...#.....#.#.....
.#####.#####.s##.#.#.###.
.....#......b..#.B...#.#.
####.###########.#####.#.
...#.#.......#...#.....#.
.#Q#.#####.#.#.#####.###.
.#.#.....#.#.#....A#S..#.
.#.#####.#.#######.###.#.
.#.....#.#.......#...#...
.#.#####.#.#.#.###.#.####
.#.......#.TR#.#!#.#.....
.#########.#.#.#.#######.
...#.....#.#.#.#.#.......
##.###.#.###.#.#.#.###r#.
.......#.....#.#...#.....
25 25
.....#...#...#.......#...
####.#.#.#.#.#.#####.###.
...#.#.#...#...#...#.....
.#.#.#.###########.###T#.
.#...#a..#.....A!#.....#.
.####r##.#.###.#.#.###.#.
.......#...#.#...#.#...#.
.#####.#####.#####.#####.
.....#.........#.........
.#######.#####.#.########
.s.......#...#.#.#.......
##.######b##.#.#.#####.#.
...#...#.....#.#.#...#.#.
.###.#.###.###.#.#.#.##A.
.....#...#.....#...#.....
.#######.#.#############.
...#...#.#............@#.
.###.#.#.#######.#######.
.#...Q...#...#...#.......
.#.###C###.#.#Rc##.######
.#...#.#...#.#.....#.#...
.###.###.###.#.####c.a.#.
...#.....#...#.#.......#.
##.#q#####.###.#B#######.
.........#...............
25 25
.........#...............
.###.#a###.#.#B#########.
.#...#.....#.#...#...#...
.###Q#.a####.###.#.#.#.##
.#..B#.....#...#.#.#.#...
.#.#.#####.##A.#.#.#.###.
...#.......#.#.#.#.#.#...
.#######.###.#.#.#.#.#.##
.Q.....#.....#.#...#...#.
##.###.#######.#.######B.
...#s#...#.....#.#...#...
.###.###.#.#####.#.#.#.##
...#.....#...#C..#.#.#...
.#.#.#######.#.###.#.###.
.#.#.#.......q.....#.#...
##.#.#.###b#########.#.#.
...#.#...a.#!....#R....#.
.###.#.#.#B#####.#######.
...#.#.#.#.....#...#..@#.
##.#.###.#.#.#.###.#.###.
...#.....#.#.#.#...#.....
.#A#####.#.#.###.#####.##
...#.....a.#...#.....#.#.
.#.#######.###.#####.#.#.
.#...........#.......#...
25 25
.q.#...........#.....#...
.#.#.#######.#.###.###.#.
.#.s.#.....#.#.t.#.....#.
.#.#.#.###.#.###.#######.
.#.#.#.#.#.#.#.#.#.......
.#.#.#.#.#.#.#.#.#.#####.
.#.#.#b#.#.#.#...#.#...#.
.###.C.#.#.#.#.###.#.t.#.
.#...#.#...#.#.....#.#.#.
.#.###.#.###.#######.#.#.
.#.....#.#.#.......#.#@#.
.#######.#.#######.#.###.
.........#.#...#...#.....
.####T####.#.#b#.###S#A##
.........#..A#.#...#.#...
########.####T.###.#.#.##
...#...........#...#.#...
.###.###########.###.#.#t
...#.....#.......#.#.#.#.
##.#####.#.#######.#.###.
.......#.#.#.............
.#######.#.#.#######C###.
.#.......#.#...#.....#...
.#.#c#####.TR###.###.####
.........#.........#....!
