abcdefghijklmnopqrstuvwxyz-=[];/
ABCDEFGHIJKLMNOPQRSTUVWXYZ_+{}:?
OOOOOOOOOOOOOOOOCCCCCCCCCCCCCCCC
13
17 17
...#.............
.B.#.#######.###.
.r.#.#.....#...#.
.###.#.###.###.##
.....#...#...#...
.#######.###.###.
...#@#...#.#.#...
##.B.#.###.#.#.#.
.....#...#.#.#.#.
####.###.#.#.#.#.
...#...#.#.#.#.#.
.#.#####.#.#.#.#.
.#.....#.#.....#.
.#####.#.########
...#.....#......!
.#.#######.######
.#............b..
17 17
@..............#.
############.#.#.
...........#.#.#.
.#########.#.#.#.
.#...#.......#...
.Q.###.#########.
.q...#.#.#.....#.
.###.q.#.#.###.Q#
...#.#...#q#.#...
##.#.#.##b.#.###.
...#...#...#.#!#.
.###.###.###.#.#.
.#.....#...#.#.#.
.#########.t.#.#.
...........#.#.#.
.###A#######.#.#.
B.......b....#...
17 17
...#.t...#.#.....
.###.#.#.#.R.B##.
.....#.#.#.#.#.#.
.#####.#.#.#.#.#.
...s.#.#...Q.#...
.#####.#####.#.#A
.#.....#.....#...
.#.#####.###A###.
.#.#...#!#...#...
.#.#.#.#####.#.##
.#...#.......#.#.
######.#####.#.#.
.......#.#.T.#.#.
.#######.#.##T.#.
.#...#@......#.#.
.#.#.#########.#.
...#.............
17 17
...#..a..#.......
.###.###.Q.#####.
...#.#!..#.#...#.
.#.#.#####.###.#.
.#.#...#.......A.
.#.###.#.#######.
.#...#.#...#...#.
##.#.#.###.#.#.#.
...#.#.#...#.#...
.###.#.#####.a##.
.#...#.......#.#.
.##########C##.#.
.........#...#...
.#######.#.#.#.##
.#@....#.#.#.#.#.
.###.#.#.#.#.#.#.
.....#c#...#.....
17 17
.......#.........
.#####.#####.###.
.....#.#...#...#.
###t.#.T.#.#.#.##
...#.#...B.#.#.b.
T#.#.####r.#####.
.#.#....!#.......
##.#############.
.....#...s.....#.
.#.###.#####.###.
.Q.#...#...#.....
.#.#.###.########
.#.#.#...........
.###.#.#########.
.....#@#.........
.#######.#######.
........B#.......
17 17
.#!#.........#...
.#.#.#####.#.#.#.
...#c#.....#...#.
.###.#.#########.
...#.#.#.......#.
##.###.#.#####.#Q
@#.....#.#...#.#.
.#######.#.#.B##.
.....#.....#.....
.###A#.####C#####
.....#.#.........
.##T.#.#.#######.
...#.#...#.......
##.#.#####.######
...#.......#.....
.########R####.#.
.C.............#.
17 17
.....#.....#...#.
##.#.#.#.###.#.Q.
C..#.#.#.#...#.#.
.#####.B.#.###.#.
...#...#.#!#...#.
.#.#.###.###.###.
R#.#.#.#...#.#...
#B.#.#.#.###.#A#.
...#...#.....#.#.
.#####.#B#######.
.....#.........#.
.#.#.#########.#.
.#.#........@#.#.
.#.#.#######c#.#.
.#.#.#.......#.#.
.#.###.#####.#.#.
.b...S.....#.....
17 17
...#.c...#.......
.#.#.#.#.#####.#.
.#.A.#.r...#...#.
.###.#.###.#.####
.....#.#.....#...
######.#.#####.#.
.......#.#.....#.
.#######.#.#####.
...#.#...#.#.#...
##.#.#.###.#.#.##
...#....@#!#...#.
.#.####b####.###.
.#.#.........#...
.###.s###q####.#.
...#...#.......#.
.#.###.#.#######.
.#....r..#.......
17 17
.....#.......#...
.#.#.#.###.#.#.#.
.#.#.#@#...#...#.
.#.#.###.#######.
.#.#.#...#.....#a
.c.#.#.###.###.#B
.#.#...#...#.#...
.#.#.#####.#.####
.#.#.#!..#...#...
.#.#C###.#.##C.#.
.#.#...#.#.r...#.
.#.#####.###.###.
.#.#...#.....#.#.
.#.#.#.##t####.#.
.#.#.#.......#...
.#.#.###.#####.##
.#.....#.........
17 17
.........#.......
.c.#####.#.#####.
.#.s...#.#.#@....
.###.#.#.#.######
.#...#.#.#.......
.#.###.#.#.#####.
.#...#.#.#.....#.
.###.#.#tc######.
...#!#.#...#.....
.#####.###.#.####
.#...#...#...#...
.#.#.###.#####.#.
...#...#.......#.
.###a#.r########.
.#.....T.#.......
.#.#######.######
.#...............
17 17
..@#...........#.
.###.#######.#.#.
.........#...#.#.
.#########.###.#.
...#...#...#...r.
.###.#.#.###.###.
.#...#.#.#...#...
##.###.#.#.#####.
...#...#.#.......
.###.#T#.#######.
.#.#!#...#.#.....
.#.#####.#.#.####
.#.......#...#...
.###.#####.###.#.
.....#..s#.....#.
######.#########.
.................
17 17
...#........R....
.###.#######.###.
.B...#.....#.#.#.
.b.###.#c#.#.#.#.
.#.#.#.#.#.#..A#.
.#.#.#.#.#.###.#.
.#...A.#.....#.#.
.###.#.#####.###.
...#.#....!#.#...
##.#.#######.#.##
...#...#.....#...
.#.###.#.#######.
.#...#.#...#.....
.#####.###.#.###.
.....#...#.#...#.
.###.##R.#.c##.#.
..@#.....#.....#.
17 17
.................
####B#######.###.
.............#...
.#######.#######.
.....#.#.#.....#.
####.#.#.#.###.#.
@#...#...#!#.#.#.
.#.###.#####.#.#.
.#...#...#.....R.
.###.###.#.#####.
...#...#.#b#.#...
.#####.###.#.#.##
.....#.....#.#...
.###.#######.###.
.q.#.......#...#.
.#.#####s#.#.#.#.
.........#...#...
