abcdefghijklmnopqrstuvwxyz-=[];/
ABCDEFGHIJKLMNOPQRSTUVWXYZ_+{}:?
OOOOOOOOOOOOOOOOCCCCCCCCCCCCCCCC
1
17 17
@...C..#........a
####.#.#.#a###.#.
..B..#.#a..#...#.
.#####.###t#.###.
T#...........#...
.#############.##
.#...#.......#...
S#R#t#.###.#####.
.#.#.#.#!#...#...
.#.#.#.#.#.#.#.##
.A.#c#.#.#.#...#.
.###.###q#####.#.
.#.#..b#...r.#...
.#.###.#####.A##.
..T..#...#.Q.#.#.
####.#.###.###.#.
.....#a...s#.....
