abcdefghijklmnopqrstuvwxyz-=[];/
ABCDEFGHIJKLMNOPQRSTUVWXYZ_+{}:?
OOOOOOOOOOOOOOOOCCCCCCCCCCCCCCCC
5
17 17
.....C.......#...
.###.#.#####.#.#.
..@#.#...#.#...#.
####.###.#.Ta###.
.......#...#!....
.#########.######
.........#.......
####.###.#######.
...#.#.....#...#.
.#.###.#####.#.#.
.#.....#.....#...
.#######.########
.#....r..#.....#.
.#.#C#####.###.#.
.#.#......R#.#...
.#.###Q#.###.###.
.........#.......
17 17
.........#.......
.#######.#####.#.
...#...T.......#@
##.##########C###
...#.....#...a...
.###.###.#.#.#.#.
.#....q#...#.#!#.
.#.######t##R###.
...#.......#...#.
####.##t##.#.#.#.
.....#..A....#.#.
.r####.#######T#.
...#...#.....#.A.
.#.#.###.###.###.
.#.#...#.#...#...
.#.#####.#.###.##
.#.......#....q..
17 17
S........#.....#.
.###.###.#.###.#.
...#.#...#.#.#.#.
##B#.#.###.#.#.#.
....t#...#.B...#.
.#######.#.###.#.
...#.....#...q.#.
##.#.#######.#.#.
...#@#.a.....#.#.
.#####.#######.#.
...#...s...#...#.
.#.#.#A###.#.###.
.#.#!#.....#.#...
##.###.#.###.#.#.
...#...#.#...#.C.
.###.#.###.##C##.
.....#...A.......
17 17
.#...#!#...s.....
.#.#.#.#.#.######
...#...#.#.#.....
.#######.#.#B###.
.#...#...#.....#.
.#.#.#.#########.
.#.#.#...#...#...
.#.#.###.#.#.#.#.
.#.#.....#@Q.#.#.
.C##.#######.#.##
...#.........#...
##.#############.
.#b.......Q#.....
.########S.#.###.
......t#...#...#.
.#####.#.#####.#.
.....#....c....#.
17 17
.#...........#...
.#.#.###Q###.###.
...#.....#.#...#.
.#######.#.###.#.
.......#.t.a.#...
####C###.###.###.
.....#...#Q..#...
.###.#.###.#.#.##
.#.....#...#.#.#.
.#########.#.#.#.
...#..s....#.#.#.
##.#####.###.#.#.
...#..!#.#...#.#C
.###.###.#####.#.
.....s....C#...#.
######.###.#.###.
........@#.......
