abcdefghijklmnopqrstuvwxyz-=[];/
ABCDEFGHIJKLMNOPQRSTUVWXYZ_+{}:?
OOOOOOOOOOOOOOOOCCCCCCCCCCCCCCCC
7
17 17
...#...#...#.....
.#.#.#.#.###.#.##
b#.#.#.#.....#...
.r##.#.#########.
.....#..!#.....#.
.b########.###.#.
...#.......#.#...
##.#.#######.###.
...#.....#.......
.###.###.###.####
.#.....#...#...#@
.#####.###.###.#.
...#...#.#.#...#.
##.#r###.#.#.###.
.#.#...b.#.#...#.
.#.#######.###.#.
...........#.....
17 17
.a...............
.#####.#B###R###.
...#...#.......#.
.#.#.###.#####.##
.#.#c..#...#@#..a
.#.#######.#.###.
.#.#.......#...#.
.#.#.#########.#.
.#.#.#B....#...#.
.#.#.###.#.#.###.
.#.#.....#.#...#.
.#.#####Q#.###.#.
.#.......#.#...#!
.##t##.#T#.#.####
.#...#.....#.....
.#.#.#########.#.
...#...........#.
17 17
.#.......#...#..q
.#.###.###.#.#.#.
...#...#...#...#.
##a#.#R#.#.#####.
.....#...#.Q!#...
.###.#.#.###.#.##
.#..T#.#.#...#.#.
.#####.#.#.###.#.
...#...#.#.#.....
##.#.###.#.#####.
...#.#@..#.....#.
.#.#.#########.#.
.#.#.#...#.....#.
.###.#.#.#.#####.
...#...a...#.....
.#.#########.####
.#...............
17 17
.....#.....#..S..
.#####.#.###.#.##
.....#.#.....#...
####.#.#########.
...#...#...#!..#.
.#.###.#.#.###.#.
.#...#...#@#...#.
.###.#######.###.
...#.........#...
##.#######Ra####.
...#r........#...
.#########.#.#.#.
.A.....#...#.#.#.
######.#.###.#.##
.......#.#.#.#...
.######C.#.#.C##.
.........#.......
17 17
...#@#...........
.#.#.#.###.#####.
.#...#...#.....#.
.#######.#####.##
.t...#...#...#...
.###.#.####q.###.
.#.#...#..R....#.
.#.#####.#.#####.
.....#...#...#Q..
####.#.A####.#.#.
..!#.#....t#.#.#.
.###.#######.#.QA
...#...#...s.#...
##.###.#.####T.#.
.#...#...#...#.#.
.###.#####.#.###.
.....c.....#.....
17 17
...........#.....
.s.#########.###.
.#...s.......#...
.#############.r#
.#..C....#...#...
.###.###.###.###.
.....#.#...#...#.
######.###.#.#.#.
...#Tt.....#@#.A.
.R.###.#######.#.
.#...#.........#.
.###.#######a#.#.
!#.#...#.....#.#.
##.###.#.t##.#.#.
.#.....#.#...#.#.
.#.####T.#.#####.
.........#.......
17 17
...........#.....
.#r#####.#.###.#.
.....#...#.....#.
####.R.#########.
.....#...#..@#...
.#######.#.###.A#
.......t.#.......
.#b#####.########
.#...#..R#...#...
.#.#.#.###.#.#.#.
.#.#.#.....#...#.
##.#.#######.###.
...#......!#.#...
.####T########.T#
.#.....#.....#...
.###.#.#.###.###.
.....#...#.......
