abcdefghijklmnopqrstuvwxyz-=[];/
ABCDEFGHIJKLMNOPQRSTUVWXYZ_+{}:?
OOOOOOOOOOOOOOOOCCCCCCCCCCCCCCCC
15
17 17
.................
.######r######.##
.#..........!#...
.#.#############.
.#.#...#.....#...
.#.#.#.###.#.#.##
.#...#.....#.#...
.###########.###.
.#.........#.....
.#####.###.######
.....#...#@#.....
###T.#.#.###.###.
.#...#.#.......#.
.#.###.#########.
...#...#.......#.
.#######.#####.#.
.........#.......
17 17
...#.......#.....
##.#.#####.#.###.
...#.....#.#...#.
.###.#r##r.###.#.
.....#..!#.....#.
.#####.#########.
...#...#.........
.###.###.#######.
.#...#...#...#...
.#.###.###.#.#.##
.#.#...#...#.#...
##.#.###.#.#####.
...#...#.#.......
.#####.#.####T###
.c...#.#.#@......
.#.#.S.#.#####.#.
...#...#.......#.
17 17
...#.......#.....
.###.#.###.###.#.
.....#.#...#...#@
.#####.#.###.#r##
...#...#...#.....
####.#####.#####.
.....#...#..R#...
.#.###.#.###.#.#.
.#.#...#...#...#.
.#.#.q####.#####.
.#.#.....#...#...
.#######.###.###.
.........#.#...#.
########.#.###.#.
...#...#.....#.#.
.#.#.#.#######.#.
!#...#...A.....#.
17 17
.......#....@#...
.#####.#.#####.#.
.#..!#.#.......#.
.#.###.##a#b####.
.#.#...#.........
.#.#.###.#####c#.
.#.#...#.#.....#.
.#.###.#.#.##c.#.
.#.#...#.#.#...#.
.#.#.###.#.#.#.#.
.#...#...#.#.#.#.
.#######.###.###.
...#.....#...#...
##.#.#####.###.##
...#.#.#...#...#.
.###.#.#.#.#.###.
.....#...#.......
17 17
....!#...#.......
.#####.###.#####.
.#...#.#.....#...
.#.#.#.#.#####.#.
...#.#...#.....#.
####.#####.#####.
...#.......#.....
.#.#########.####
.#...#...#...#..@
####.#.#.#.###.##
...#.#.#...#.....
.#.#.#.#####b###.
.#...#.#.........
.#####.###.t####.
.#.....#...#.#...
.#.#####.###.#.Q#
.........#.b.....
17 17
@......t.....C...
######.#####.c.#.
.....#.....#.#.#.
.###.#####.#.#.#.
...#.......#.S.#.
##.#############.
...#.....#...#...
.###.b#s.#.#.####
.......#.#.#.....
#Q######.#.#####.
.......#.....#...
.#####.#.#####.##
...#...#...#!#...
##.#.#######.#.#.
.#.#.........#.#.
.#.#############.
.................
17 17
.#...........#...
.#.###.#####.#.#.
...#.#.#.......#.
.###.#.#.########
.#@..#.#.#.......
.###.#.###.#####q
.....#.....#...#.
.###########.#.#.
.#...........#...
##.############Q.
...c.#.....#.....
.###.#.###.#.####
.#.......#.....#.
.#####.####B##.#.
.....s.#.....#.B.
R###.#t#.###.#.#.
...#.....#!..#...
17 17
...#.....#...#...
.###.#.#.#.#.###.
.....#.#...#.....
######.#########.
.....#.#.......#.
.###.#.#.###.###.
...#..B#.#!#...#.
##.#.#####.#.#.#.
...#.#.....#.#.#.
.#####.#####.#.#.
.......#@..#.#...
##########.#.####
...#B......#.....
R###.###.#######.
.....#.#.......#.
.#####.###.#####.
.......a.#.......
17 17
.#.....#.........
.#.###.###.###.##
.#.#.#...#..T#...
.#.#.###.###.###.
.#.#...#!#.#.#.#.
.#.###.###.#.#.#.
.#.....#.......#.
.#####.#####b#.#.
.....#.......#.#.
.###.#######.#.#.
...#.#...#...#@#.
##.#.###.#.#####.
...#.#...#......c
.#a#.#.#########.
...S...#...#...#.
.#r#####.#.#.#.#.
.#.......#...#...
17 17
...#.............
.###.#######.##s#
...#.#...#...#...
.#.#.#.r.#.###.#.
.#.....#.#.....#.
.###############.
.#.#..........!#.
.#.#.###########.
...#...#.......#.
##.###.#.#####.#.
.#.#.#...#...#...
.#.#.#####.#.####
.#.#.....#.#.....
.#.#####.#.#####.
.C.#...#....@#...
.#.#.#.#######.#.
.....#.........#.
17 17
.............#...
.##########s.#.#.
.#.......#!#...#.
.#.#####.#.#####.
...#.....#.#.....
.###.###.#.#.T###
...#.#...#.#.....
.###.#.###.#####.
.#...#...#.....#.
##.#####.#####.#.
...#.q.....#...#.
.###.#.#####.###.
.#.....#...#.#...
.#.#####.#.#.#.##
.#...#...#...#...
.#####.######Q##.
.......#@........
17 17
.........#.....#.
.#####.#.#.###C#.
.#@..#.#.#.#.....
.###.a.#.#.######
...#.#.#.#......s
##.#.#.#.##a##a#.
...#.#.#.....#.#.
.###.#.#####.###.
.#...#.....#.#...
.#.#######.#.#.#.
.#.......#.#...#.
.###.###.#.#.T###
...#...#.#.#.#...
##.#.#.#.#.###.#.
.#.#.#.#.#.....#.
.#.###.#.#######.
.......#.#!......
17 17
.#.........#...#.
.#.#####.#.#.#.#.
.#.#.....#...#...
.#.#.###########.
.#.#.....#.......
.#.#####.########
.#.#...#........C
.#.###.#########.
.#.....#..!#.....
.###.###.###.####
.#...#...#.......
.#.###.#########.
c#.#@#.#.........
.#.#.#.r.#.#####.
...#.#.#b#...#...
.###.B.#####.#.##
.....#.......#...
17 17
...............#.
.#############.#.
.#.....#!......#.
.b.###.#########.
...#.#.#.....#Q..
####.#.#####.#.#.
.....#.#...#...Q.
.#.#.#.#.c.#####.
.#.#@#...c.#...#.
.#.###Q###.#.#.#.
.#.....#.#...#...
.###.#.#.#######.
.#.#.a...#...#...
.#.#.###.#.###.##
...#.#.....#...#.
##.A.#####R#.###.
...#.............
17 17
...#.......#!#...
.###.#####.#.#.#.
...#.....#.#...#a
.#.#####.#.#####.
.#.....#.#.....#.
.###.###.#####.#.
...#...#.#...#...
##.###.#.a.#.####
...#...#.#@T.#...
.###.#.#.###.#.#.
.q.#.#.#.#...#.#.
.#.#.#s#.#.###.#.
...#.....#...#.#.
##.#######.#.#.#.
...#.....#.#...#.
.#####.#.#######.
.....s.#.........
