abcdefghijklmnopqrstuvwxyz-=[];/
ABCDEFGHIJKLMNOPQRSTUVWXYZ_+{}:?
OOOOOOOOOOOOOOOOCCCCCCCCCCCCCCCC
15
17 17
.#.............#.
.#.#.###q#####.#.
...c...#.........
.#####.#.#######.
...#...#.#....!#.
##.#.###.#.#####.
...#...#.#.#.#...
.#####.###.#.#.##
.#...#...#.#.#...
.#.#.###.#.#.###.
.#.#.#...#.#.....
.#.#.#.#.#.###.##
.#.#.#.#.#...#.#@
##.#.#.##r##.#.#.
...#...#...#.#.#.
.###s###.#.#.#.#.
.........#...#...
17 17
.....#...........
.#####.###S#####.
.#...#.#...#..@#.
.#.#.#.Q.#s#.###.
.#.#...#...#.#...
.#.T#####A.#.#.##
.....#.....#.....
######.#.########
.......#.#.......
.#c###.###.#####.
.#.....#...#.....
.##s.##R.###.####
...#C#!#...#.....
.#.#.#.###.#####.
.#.#.#.....#...#.
.#.#########.###.
.#...............
17 17
.....#...#.......
.#.#.#.#.#.#.####
.#.#@#.#...#.#...
##.###.##B##.#.#.
...#...#.....#.#.
.###.###.##s##.#.
.#.....#.#...#.#.
.#.#####.#.b.#.#.
.#.#.....#.#...#.
.#.S.#####.##r##.
...#...........#.
########.#######.
...#...#.#.......
.#.#.#.###.#####.
!#...#...#.#...#.
########.#.#.#.#.
...........#.#...
17 17
.....#.....#.....
.###.#.###.#.###.
.#.....#...#...#.
.#######.#######.
.#...#@#.#.a...#.
.#.#.#.#.#.#.#.#.
...#.#.#.r.#.#.#.
c###.#.#.###.#.#.
.....#.#.....#...
.#####.A########.
.#.......#.......
.###.#.###.######
...#.#...t...#...
.#.#####.###.###.
.#.....#.........
.#####.#########S
.....#........!#R
17 17
.#.......#.....#.
.#.#####.#.###.#.
.#...#...#...#.#.
.###.#.#####.#.#.
.....#...#...#...
.#######.#.#####.
...#...#.#.....#.
##.#.#.#.#.###.C#
.#.#.#.#.#...#...
.#.#.#.#.###.###.
...#.#.#!#...#@#.
.#####.###.###.#.
...#....B#.....#.
##.#.###.#####Q#.
.#.#...#.........
.#.###.#########.
.......#.........
17 17
...#.........#...
.#.#.###R###.#.##
.#.#.....#.#!#...
.#######.#.#####.
.#...#...#.......
.#.#.#.#c###.#.#.
...#.#.....#.#.#.
.###.#####.###.##
.#...#...#...#...
##.#.#.#.##b.#.#.
...#...#.#..r#b#.
.#######.#.#####.
.#...#@..#...#...
.#.#.#######.#.#.
...#.#.....#...#.
.###.#.###.#####.
...#.....#.......
17 17
.......#!......#.
.#####.#######.#.
...#@#.....#...#.
##.#.##B.###.###.
.#.#.#...#...#...
.#.#.#.###.#####.
.#...#...#...#.Q.
.#.#####.###.#.##
.#.S.......#.#...
.#.#.#######.#.#.
.#.#.......#.#.#.
.#.#######.#.###.
...#.#.....#...#.
.###.#.###.###.#.
.#...#...#.#...#.
.###.###.###.###.
.......#.........
17 17
.......#.........
.#####.###.#####.
.#...#...#.#.....
.###.B#q.##C.###.
.a.....S.....#...
.#.#.#########.##
.#.#.#.......#.#.
.#.###.#####.#.#.
.#.......s...#...
.#.#######.#.###.
!#...#.....#...#.
##.###.#######.#.
...#...#......a#.
.##B.#########.#.
.#.#.#.......#b#.
.#.#.#.#####.###.
...#......@#.....
17 17
!......#.....#...
######.###.#.###.
.....#.....#.....
.###.#####b#####.
...#.....#.#...#.
##.###.#.R.#.#.#.
...#...#...#.#.#.
.###.#######.#.#.
.#.#.......#.#...
.#.#######.#.####
.#...#...#.#.#...
.#.#.#.#.#c#.###.
...#.#.#...#.....
####.Q.#.#######.
@#..T#.#.#.....#.
.#.###.###.###.#.
.....#.......#...
17 17
...#.........#...
.#.#.#.#####.#.#.
.#.#.#.#@..#.#.#.
.###.#.###.#.#.S.
....R#...#.#...#.
.#######.#.#####.
...#.....#...#...
##b#.#####.#.#.##
...#.#.....#.#.#.
.###.#####.#.#.#.
.#.#.#...#.#.#...
.#.#.#.#.#.#.###.
...#...#.#.#...#.
######.#.###.#.#.
.....#.#..A#.#.#.
.###.#####.#.#.#.
..!#.......#.#...
17 17
...#.....#.......
.#.#.###.#.###a#.
.#.S..@R.#...#.#!
.#.#.###.###.#C##
.#s..#.....#.#...
.#####.#####.#.##
.#.#...#.....#...
.#.#.#.C.#####.#.
...#.#.#...#...#.
##.#.#.###.#.###.
...#.#.#...#...#.
.###.###.#######.
.#...#...#.......
.#.#.#.#####.####
.#.#.#.....#.....
.#.#######.#####.
.#...............
17 17
.....#.......#...
.###.#.#####.###.
...#.#...#.#.....
.#.#.###.#.#####.
.C.#.#...#...#...
.#.#.#.###.###.##
.#q#...#.....#.#.
##.#####.###.#.#.
...#.....#...#...
.#####S#.#.####C.
.......A@#t....#.
.s####.#####.#.#.
.#...#...#...#.#.
.#.#####.#.#####.
...#!..#.#.......
##.###.#.#.#a##S#
.....#...#.......
17 17
.#.......#.......
.#.###.#.#.#####.
...#...#.#.....#.
.###.###.###a#.##
...#.#.#.....#...
####.#.#####.r.#.
.....#.......#.#.
.#####.#########.
.#@....#...#.....
.#c#.###.#.###.#c
...#.#...#.....#.
##.#.###.##T####.
...#.....#.....Q.
.#########.###.##
.....#...#.#...#!
.###.#.#.#.#.###.
...#...#...#.....
17 17
.......#.........
######.#.#####.T.
.....#.....#@#.#.
.###.#####.#.#.#.
...#...#.....#.#.
##.###.#######.#.
.#.#.#.#...#...#.
.#.#.#.#.#a#.###.
...#.#...#.#...#.
.###.#####.#.#.#.
.......#...#.#.#.
######.#.###.#.##
.....#.#!#...#...
.###A#.#####.###.
.#.....#...#.#...
.#.#####.R.###.#.
.........#.....#.
17 17
.....#.........#.
.###.#.T######.#.
.#.#.#.#.....#.#.
.#.#.#.#.#####.B.
.#...#.#.....#...
.#.###.#.###.###.
!#.....#.#.....#.
r#########.##Q##.
.....#.....#...#.
.s##.#.#.#.#.#.#.
...#...#.#.#.#.#.
##.#r###.#.#.#.#.
...#...b.C.#.#.#.
.###.#.#.###.#.#.
...#.#.#.....#.#.
#B.#.#.#######.#.
.....#......@#...
