abcdefghijklmnopqrstuvwxyz-=[];/
ABCDEFGHIJKLMNOPQRSTUVWXYZ_+{}:?
OOOOOOOOOOOOOOOOCCCCCCCCCCCCCCCC
13
17 17
.#.......#...#...
.#.##b##.#.#.#.#.
.#.#s..#...#...#.
.#.###.#########.
.#...#b..#.....#.
.#b#.#.#.#.#####.
...#...#.#.#...#.
.#.#####.#.#.#.#.
.#.........#.#...
.########q.#.###.
...#...#...#...#.
####.#.#####.#.#.
.....#.....#R#.#.
.#####T###.###.#.
.#.....#...#...#.
.###.#.#.###.###.
..!#.#.......#@..
17 17
.#...#.........#.
.#.#.#.#####.q.#.
...#.#.#...#.#...
.###.#.#.#.#.###.
.#.#.#@#.#!#.#C..
.#.#.S##.###.####
.#.#.....#.......
.#.#########.###.
.#.......c.#...#.
.#.#######.#####.
.#...#...#.....#.
.###.#.#.#####.#.
.....#.a.......#.
######.#########.
...#...#.........
.#.#.#########.t.
.#.........C...#.
17 17
.......#.........
Q###.#.#####.#.##
.#...#..B#...#.#!
##.#####.#.#.###.
...#...#.#.#.#...
.###.#.#.#.#.#.##
.#Q..#.....#.#.#s
.#############.#.
.............#.#C
.###########.T.#.
.#.....#.....#...
.#.#.###.#######.
.#@#.#...#...#...
.###.#.###.#.#.##
.....#.....#.#.#.
r###.#######.#.#.
.........b.#....c
17 17
.....#@#.........
.#.#.#.#.#######.
.#.#...#.....#...
.#.#####.#####.##
.#.......#...#...
.#########.#.###.
.q.......#.#.....
.###.#####.###T#.
.#...#.....#..r#.
.#.###.#####.###.
...#...#...#.....
##.#.###.#.#####.
...#.#...#.....C.
#R##.#.#######.#.
.....#.#.#...#.#.
.#####Q#.#.#.#.#.
.........#!#...#C
17 17
.#q..........#...
.#.##C######.#T##
.#...#.......#...
.#.###.##q####.#.
...Q...s@......#.
.###.###########.
...#...#...R...#.
##.###.#.#####.#.
...#.#.#.#.......
.###.#.#.########
...#.#!#.....#...
##.#.#####.#.#.#.
.#.#.....#.#.#.#.
.#.#.###.#r#.#.#.
...#...#...#...#.
.#####.###s##R##.
.......#.........
17 17
.......#.........
.#####.#.#######.
.#.#...#.#....@#.
.#.#.###.#.#####.
...#...#.#.#.....
#Q.###.#.#.#.###.
.#.#...#...#.#.#.
.#.#.#####.t.#.#.
...#.....#.#b#.#.
.#######.#.#.#.#.
...#...#...#.#...
##.#.#.#####.#Q#.
...#.#.C...#...#.
.###.#########.#.
...#...#!R.....#S
##.###.#.#.#####.
.......#...#.....
17 17
.R.......#...#!..
.#.#.###.#.#####.
...#.#...#.....#.
####.#.t######.#.
...s.#.........#.
.#############.#.
.......#.......#.
.#####.#.#######.
...#...#.....#A..
##.#.#######.#.##
...#.......#c#.#@
.##s######.#.r.#.
...#.....#.#.c.#.
c#.#.###.#.R##.#.
...#.#...#.....#.
.###.#.#########.
.....#...S.......
17 17
...#.........#...
.###.#####.###.#.
...#...#.#.....#!
.#.###.#.########
.#...#.....#.....
####.#####.#####.
.........#.#.....
.###.#####.#.###.
.a...#.....#...#.
.#####.q######.##
.....#.#.....#...
.###.#.#.###.###.
..@Q.#...#...#...
.###.#####.##t.#A
C#...#...#.#.....
.#.#c#.#.#.#####.
.#.....#.........
17 17
.#.......#!......
.q.###.#.#a#####.
...#...#.#.....#.
#s##t###.###.#.#a
.....#.....#.#@#.
.###.####a.#.###.
.#...#...#...#...
.#####.#.###.#.##
.#.....#...#.#.#.
.#.#######.R##.#.
.#.#.....#.#...#.
.#.###.#.#.#.###.
.......#.#.#.....
.#####b###.#####.
...#.......#...#.
##.#.#######.s.#.
...#.........#...
17 17
.#.......#.......
.#.###.###.###.#.
.t.#.#.....#...#.
.#.#.#######.###.
.#...#.....#...#.
.###.#####.###.#.
..@#.#.......#.#.
.###.#.#####.#.#.
.......#...#.#.#.
.#######.#.###.#.
.#.S.....#.....#.
.#.#.#.#########.
.#.#.#.#!..#...#.
.#.#.#.###.###.#.
.#.R.#...#...#.#r
.#.#.ar####q.#.#.
..R#.........#...
17 17
....r........#...
.#######.###.#.s.
.#.......#...#!#.
.#.##t.#########.
.#...#.#.......#.
.###.###.###.#.#.
...#.....#.#.#.#.
##.#######.#.###.
...#.#.b...#...#.
.###.#.###.###.#.
.#.....#...#.#...
.#######.#.#.###A
.........#.#.....
##########.#####.
@#.......#...#...
.#.#.#######.#.#.
...#...........#.
17 17
...#.........#...
.#.###.#####.###.
.#.....#...#.#...
.#######.#.#.#.##
.#...#...#...#...
.#.#.#####.###.#.
.#.#.....#...#.#.
.#.#####.###.b##.
.#.#...#.B@#.....
.#.#.#.#.#.#.####
.#...b.#.#...#...
.#b###.#.###.#.#.
.....#.#...#.#!#.
##.#.#.###.#####.
...b.#.#.#.......
.#####.#.###s####
.................
17 17
.....#.....#.....
##.#.#.###.###.#.
...#...#.#.....#.
.#######.#######.
...#!..#.....#...
##.###.#.#.###.##
.#...#.#.#.....#.
.#.#.#.###.#####.
.#.#.c...#.......
.#.#####.rq####q.
.#.......#...#...
.#########.###.##
.......#.....#...
.###.###.###.###.
...#.#...#.....#.
R#.#.#.###.#####.
@..#.....#.......
