abcdefghijklmnopqrstuvwxyz-=[];/
ABCDEFGHIJKLMNOPQRSTUVWXYZ_+{}:?
OOOOOOOOOOOOOOOOCCCCCCCCCCCCCCCC
7
13 13
...#.....#...
.#.#.#.###.#.
.#.#.#.#...#.
.#.#.#.#.###.
.#.#S#.....#.
.###.#######.
.....#.#...#.
.#####.#.#.#.
...#...#.#...
##.###.#.###.
@#...T.#.#!#.
.#####.#.#.#.
.......#...#.
13 13
@....#...#...
##.###.#.###.
..C#...#.R...
.#.#.#######.
.#.#.#.#....s
.#.#.#.T.####
.#.#.#.....#.
.#.#.#####.#.
.#.#.#!#...#.
.###.#.#.###.
...#...#...#c
.#.#######.A.
.#...........
13 13
.s...........
##.#########.
..b#.....#...
.###.###.#.##
.A.#.#...A.#.
.#.#.#.###.#.
.#.#.#.#.....
.#.#.#r#.###.
.#...#.#.#!#.
.#####.###.##
...#.#...#...
##.#.###.###.
......@#.....
13 13
.........#..B
######.#.#.##
...Q...#t..B!
.#.#.#####.#.
.#...#.....#.
.#####.####q.
.#.....#.....
.#.#####.####
.#.#.....#...
.#.#.###q#.#.
.#@#...#...#.
.#####.#.C##.
.........#...
13 13
.....#.......
.#.Q##.#.####
.#...#.A.#..!
.###.#.#a#.##
.#.#...#.#.#.
.#.#####.#.#.
.#...#...#...
.#.C.#.#.###.
.#.#.#.#...#.
.#.#.#.#####.
...#.#.#.....
A###.#.#.q###
@....#.......
13 13
.........#...
.#########.#.
...........#.
#aT#.#######.
!..#.#.....#.
##.#.#.###.#.
...#...#@..#.
.#C#########.
....Q......#.
###a##a###.#.
.#...a.....#.
.#.A.#.R####.
...#.........
13 13
.......#!..#.
.#.#A#.###.#.
.#.#.#.#.q.#.
.#.#.#.#.###.
.#.#.#.#...#.
##.#.#.###.#.
...#...#.#.#.
.###.c##.#.b.
.#@#.....#...
.A.#####.###.
.#.......#...
.#########.##
.............
