abcdefghijklmnopqrstuvwxyz-=[];/
ABCDEFGHIJKLMNOPQRSTUVWXYZ_+{}:?
OOOOOOOOOOOOOOOOCCCCCCCCCCCCCCCC
7
21 21
.........#.#.....#!..
###s##.#.#q#.#.#####.
.......#...#.#.......
.#######.###.#######t
.#@......#...#.......
.######Q##.###.#####.
.#.......#...#Q#.....
.#.#####.###.#.#.####
.......#...#a#.#....c
.#######.#.#.t.#####.
.#...#...#.#.#.#.....
.#.#.#.#Q#.#.#.#.###.
.#.#...#...#.#.#...#.
.#.#####.###.#.T##.#.
.#...#.#...#.#.#...#.
.c##.#.#.###.#.#.###.
...#.#.r.#...#.#.#.#.
##.#.#.###.#####.#.#.
.#.#.#..Tt.#.....#.#.
.#.#.#####.###.###.#.
...#.........a.#.....
21 21
............A#.....#.
.##r##.t####c#.#q#.#.
...#.#.........#...#.
##.#.###s#######.###.
...........#.T...#...
.#########.#.#.B####.
.#.....#.....#.#.....
.#.###.#######.#.####
.#...#.........#.....
.###.###############.
...#...#.............
#r.###.#####.#a#####.
.....#.....#.#...#...
.###s#####.#.#.###.##
.#!..s.....#.#.#...#.
.###.#.#####.#.#.###.
.#T#...#.a...#...#...
.#.#####.#.###.#####.
...#.....#...#.#@....
##.##B#####a.#.a##.#.
.............#.....#.
21 21
........t..#.......#.
.#########.#.###.#.#.
...#.....#.....#.#.#.
##.###.#########.#.#.
.......#...#.....#.#.
.#####.#.#.#.#####.#.
.#!#...#.#...#b..#.#.
##.#.###.#######.#.#.
...#.#.#..r....#.#.#.
.###.#.#######.#.#.#.
.#.....c@....#.#.....
.#####.c####.#.#.####
.....#T......#.#.t...
####.#########.###.#.
...#.#.........#...#.
.#.#.#.#########.###.
.#t#.#.............#.
##.#.###############.
...#...#.......#...#.
.#####.#.#####.#.#.#.
.........#.......#...
21 21
...#.b.q.#rs.#.......
.A.#.###.#.###.###.##
.#...#.....#...#.#...
.###.####T##.###.###.
...#.#.......#.....#.
#a.#.#.#######.#.s##.
...#.#.#....c..#.#...
.###.#.#####t#.#.#.##
.#@..#.....#...#.#...
.###.#####.#.###.C##.
...#...#.#.#...#.#...
.#.###.#.#.###.#.R.#.
.#.#b....#...#.#.#.#.
.#.#####.C##.#.#.#.#.
.#...#.....#..B#.#.#.
c###.#####.R##S#.#.#.
.#...#.C.#.#.....#.#.
.#.#.#.#.#t#.####aq#.
.#.#.#.#...#.#.....#.
.#.###.##b.#.#.######
.#.......#...#......!
21 21
.#...#...............
.#.#.#.###########.#.
...#.#.#.........#.#.
.###.#.q.B##.#a###.#.
.#.#...#..@#.....#.#.
.#.#####.#######.#.##
.....B...#...#...T...
####.#.###.#.#.#####.
...#R#...#.#...#...#.
.#.#.#.###.###.#.#.#.
.#!#.#s#...#...#.#.#.
.###.###.#######.#.#.
...#.....#...#...#...
##.#S#####.#.#.#B##A#
.#.........#.#.#.....
.###########.#.#.###.
.....#.....#Q#.....#.
.#.###.###.#.#.#####.
.#.....#...#.#.#.....
.#######.###.###.###.
.......#.........#...
21 21
.#.............r.....
.#.####T##.###.#.##T.
...#.#...#.#...#@#...
.###.#.#.#B#.#####.#.
.#...#.#.....#.....#.
.r.###.#######.######
.#...#.....#...#.....
.#.#.T####.#.#.#.###.
.#.#...#.#.#.#...#.#.
.###.#.#.#.#.#####.#.
b..#.#...#.B.......#.
##.#.###.#.#.#######.
...#.#...#.#.#.....#.
.###.###.#.#.#.###.#.
.#.#...#.#!q.#.#...#.
.#.#.a.#.#####.###.#.
.#...#.#.#...#...#.#.
.#c#.#.#.#.#.###.#.#.
...#.#.#.#.#.#...#.#.
##.###.#.A.#.#.###.#.
.......#..s#...#.....
21 21
.#!..#.#..S..........
.###.#.#.#######Q#.##
...#.#.......#...s...
.#.#.#########.#.###.
.B.r...#.......#.#...
.#.###.#.#######.#.##
.#.#...#.#.....#.#...
##.#.###.#.#.###.###.
...#.....#.#.#...#...
.##a#A####.###.###.##
.........#.....#.....
.#######.#.#####.###.
.#...#.#...#@..#.#.#.
.#.#.#.#######.#.#.#.
...#.#.#.....#.....#.
####.#.#.#.#.#######.
.#...#...#.#.#.......
.#.C######.#.#.#####.
.#.........#.#.#...#.
.###########.#.#S###.
...............#.....
