abcdefghijklmnopqrstuvwxyz-=[];/
ABCDEFGHIJKLMNOPQRSTUVWXYZ_+{}:?
OOOOOOOOOOOOOOOOCCCCCCCCCCCCCCCC
9
17 17
.......#.....#...
.#t#.###.###.#.#.
.#.#...#.#.#...#.
.#.###.#.#.#####.
.Q.#...#.#..c..#.
.#.#.###.#.R.###.
...#.#...#.#.#...
##.#.#.###.###.#.
.#.#.#.....#...#.
.#.#.#.#####.###.
.#.#...#.....#...
.#.#####.#####.##
.......#...#...#.
.#########.#.###.
.#!..#...#.#.b.#.
.###.#.#.#.###.#.
..@#...#...#.....
17 17
.......#...#.....
.#.#A#.#.#.###.S#
.#.#...#.B...#...
.S.#.###.###.###.
@#.B...#...#.....
##.###.###.#.####
!#...#.....#.#...
.#.#.#########.#.
.#.#...#.......#.
.#####.#.#######.
.....#.......#.#.
####q#######.#.#.
...#.#.....#...#.
.#.#.#.###.#.###.
.#...#.#...r.#...
.#####.#.#####.#.
.......#.......#.
17 17
......@#...#.....
.######a.#.#####.
.......#.#.#!..#.
.#####.#.#.###.#.
...#...#.#...#.#.
b###.#.#.#.###.b.
.#...#.#.#.....#.
.#.###.#.##A####.
.#.#...#.....#...
##.#########.#.#.
...#.......#.#.#.
.s.#.###.#.#.###.
.#.#...#.#.#...#.
.#####.#.#####.#.
.#...#.#...#...#.
t#.#.#.###.#.###.
...#.....#.......
17 17
...#.............
.#.#.###.#.#####.
.#.#...#.#.b...#.
.#.#####.###.#.#.
.#.....#.....#.B.
.#####.#.Q####.T.
...#...#.....R.#.
.#.#.#########.#.
.#.#.#.......#.#.
##.#.###.###R#.#.
...#.....#.#...#.
.###.#####.#####.
.#...#...#.......
.#####.#.#.###.##
Q#...#.#.#@#!#.#.
.#.#.#.#.###.#.#.
...#...#.....#...
17 17
...........c.....
.#########.#Q###.
!#.........#...#.
##.#########.#.#.
.#...#.......#.#.
.###.#.#######.#.
.#...#.#.....#.#.
.#.###.#.#.###.#.
.#...#.#@#...#.#.
.###.#.#####.#.#.
.....#...#...#.#.
.#Q#####.#.###.#.
.#.....#...#..s#.
.#.###.#.###.###.
.#...#.B.#...#...
.#########.###.##
...........#.....
17 17
.........#.......
.#######.#s#.####
...#...#.#...#...
.#.#.#.t.#.#.#.#.
.#.#.#.....#.#!#.
.#.#.######s####.
.#.#...T.#.......
.#.###.#.#.######
@#.#.#.#.#.#.....
#q.#.#.#Q#.###.#.
...#...#.#.#...#.
.###.###.#.#.###.
.c.......#.#.#...
.#######.#.#.#.##
...#.....#.#.#...
.#.#####B#.#.#C#.
C#...........#...
17 17
....A............
.T######.#.#####.
.#.....#.#.#...#.
.###.q.#.###.#.##
.....#.a...S.#...
######.###.#.###.
...#r..#@#...#!..
.#.#.###.########
.#.#.#.....#...S.
.#.#.#c###.#.###.
C#.#.....#.....#.
.#.#####.######T.
.#.#aQ.#.......#.
.###.#.#######.#.
t..#.#.#.....#...
.#.#.#.#.t##.###.
.#...#.....#.....
17 17
.#.......#.......
.#.#####.#.#####.
.#...#...#...#...
.###.#.#####.#T##
...#.#...a.#.#...
.###.S####.#.R##.
...#.#...#.#.#@..
##Q#.#.###.#.####
...#.#.#...#.....
.###B#.#.#s#.##R.
...#.#.R...#.#...
##.#.#.###.#.#.#.
...#.....#!#.#.#.
.#.#####.#####.#.
.#.....#.......#.
.##############A.
......a..........
17 17
@#....C#.....#...
.#.###.#.#.#.#.#.
.#...#...#.#...#.
.a##.#####.a#####
.....#...#.......
.#######.#######.
.......#..r#.....
######.###.#.#.##
.....#.....#.#.#!
.########B.#.###.
.......#...#...#.
.#####.#.#####.#.
..A#.#.......#.#.
##.b.#########.#.
...#...#.#.....#.
.###.#.#.#.#####.
r....#...#.......
