abcdefghijklmnopqrstuvwxyz-=[];/
ABCDEFGHIJKLMNOPQRSTUVWXYZ_+{}:?
OOOOOOOOOOOOOOOOCCCCCCCCCCCCCCCC
7
17 17
..........@#....c
t###.####R##.###.
...#...........#.
################.
.......#.......#.
.#####.#.#####.#.
.....#A..#...#S..
.###.#####.##u##.
.#..s#.........#.
.#.###.#######.#.
.#.#...#.....#...
.#.b##.###.######
t#...#...#..t.U..
.###.###.#####.##
.#.#...#.....#...
.#.###.#####.###.
B....U..!#.......
17 17
.........#.....r.
.#######.###.#.#.
.#.....#.#...#...
.#.#####.#.#####.
.#...u.#.#.#...#.
.###.#.#.#.#.#.#.
...#.#...#...#.#.
##.#.####B.###.#.
..a#.#.....#...#.
.###.##T####.###C
.#...........#...
.#############.##
.#...#...#@#...A.
.#.#.#.#.#.#.###.
.R!#.#.#...#.....
.#s#q#.#########.
.....#...T.......
17 17
...Q.....#U......
##.#####.#.###.##
...#.....#...#...
.###.#######.###.
.#.#.#.....#..@#.
.#.#.#.c##.#####.
.#.....#.#.#.....
.#######.#.#.s###
.#.....#...#.#...
.#.###.#.###.#.#.
.#.#.#.#.#.#.d.#.
.#.#.#.#b#.#.###.
.#.#.#!#.#...#...
.#.#.###.#.###.#.
.#.#...#.#.#...#.
.#.R.###.###.###.
...#.........#...
17 17
.....C.#.........
.#######.###q#.#.
.#.....#.#S..#.#.
.#.###.#.#.#.#.##
...#@#...#.#.#...
.###.d####.#.###.
...#.......#...#.
##.#.c.#.#######.
.#.#.#.#.#...S!..
.B.###.###.#.####
.#.R.#.....#.....
.###.#######.###.
...#.......#...#a
.#.#######.###.#.
.#.......#.#...#.
.###Q#.###.#.###.
.....#.......#...
17 17
...............#.
.###########.#.#.
...#.........BD..
##.#.###########.
...Q.#...........
.###.#.###a######
.#.#.#......@#!..
.#.#.###.#######.
...#...#.S.....#.
.#####.###.###.#.
.#.....#...#...#.
##.#.###.###.###.
...#.#...#...D...
.###.#.###.S##.##
.#...#.#.A...#...
.#####.#.###.##a.
...........#.....
17 17
.....#...#.......
.#####.#.#.###.#.
.......#.t...#.#.
.###########.#.#.
.....#.#!r...b.#T
###u.#.#.#####.r#
...#...#.....#...
.#A##Q.####a.###.
.....#.....#...r.
.###u#####.######
.#.....#...#.....
.#.###.#.###.###.
.#.u.#.#.#...#@#.
.###.###.#.###.#.
...#...#.#.#...#.
##.###.#.#.#.#.#.
.....#.....#.#...
17 17
.#...............
.#.#.#.#####u###.
.#.C.a.#.......#.
.#.#.#Ar.#####.#.
...#..B#.#.q...#@
.#####.#.#.#.####
.#...#.#...#.....
.###.#.###.###t#.
...#.#...#.#...#.
##.#.#.###.#.###.
.....#.T.....#...
####.#.#.#S###.#.
...#.#...#.....#.
.#.###.##q.#####.
.#...#.#...#.....
.###.##C.###.####
..!#.....#.......
