abcdefghijklmnopqrstuvwxyz-=[];/
ABCDEFGHIJKLMNOPQRSTUVWXYZ_+{}:?
OOOOOOOOOOOOOOOOCCCCCCCCCCCCCCCC
7
25 25
.....#...........#.......
.#.###.###.##q##.#.#.####
.#.#...#.#.#...#.#.#.....
.#.#.###.#.#.#.#.#####.#.
.#.#.#...#...#.#.#...#.#.
.R.#.#.#.####A.#.#.#.#.#.
.#...t.#.#.....#...#.#.#.
.#######.#.#########.###.
.#.....#.#.#.......#.....
.#.###.###.#.#####.#####.
.#.#.#a..#.#...#.......#.
.#.#.###.#.#####.#######.
@#...#.#.#.#.....#...#...
#q##.#.#.q.#.###.#.#.#.##
.....#.#.#.#...#.#.s...#.
.#####.#.#.#.#.###.#a###.
.#.....#.#.#.#.....#.#...
.#####.#.#.#.#######.#.#.
.......#.#.#.A.#.#.....#.
.##C####.q.###.#.b.#####.
.#!......#...#.#.....#...
.###########.#.#T#####.#.
.......#.....#...#...#.#.
######.#.#######.#.#.#.#.
.........#.........#...#.
25 25
.#...........#...#.......
.#.#######.#.#.#.#.#.###.
...#.....#.#.#.#.T.#...#@
.###.###.###.#.###.###.##
...#.#A......#.....#.#...
.###.#########.#####.###.
.#...#.....#.........#...
.#.###.###.#####.#####.#.
.#.#...#.#.....#.#.....#.
.#.#.###.#####.#.#.#####.
.#...#.....#...#.#.....#.
.#####.#####.#########.#.
...#.......#........!#.#t
##.#.#####.###########.#.
.#.c.#...#...........#.#.
.#.###.#.#####.#####.#.#.
.#...#.#.....#.....#.#.C.
.###.#.#####.#.###.#.#.#.
.R.#...#.#...#.r.#.#.#.s.
.####A##.#.#######.#.#.##
.........#.#a......#.#...
####.#####.###.#####.###.
.....#...a.#...#a#...#...
.#####q#.#.#.###s#.###.#.
.......#.....#.........#.
25 25
.......#.#.........#.....
####.#.#.#.#####.#.#.#.##
!#...#.#.......#.#bt.#...
.#.###.#.#######.#.#####.
...#.#.#...#.....#.......
####.#.###.#.###########.
...Q...#@..#.#.....#...#.
.###.#######.#.#####.#.#.
.T...#.......#.......#.#.
.#.###.#.#####.#######.#.
.#.#...#B....#...#...#.#.
.#.#########.#####.#.#.#.
...#.......#.#.....#...#.
.###R#####.#.#.#Q###.B##.
.r.#.#...#...#t#.....#.R.
##.#.#a#.#####.#####.#.##
.#.#.#..S#.........#.#.#.
.#.#.A.###.Ccq####.#.#.#.
...#.#...#.#.....#.#.#.#.
.#s#.###.#.#C###.#.###s#.
.#.#...#.#.#.#...#...#.#.
.#.#.#.#.#.#q#.#.###.#.#.
.b...S.#.#.#.#.#.#.#.#...
.#####.#.#.###.#.#.#.###.
......Q#.....Q.#...#....t
25 25
.#...#.................#.
.#.#.b####.###########.#.
...#.....#...#@#...#...#.
.#######.###.#.#.#.#.###.
...#...#...#.s...#...#...
##b#.#b###.#.#####.###.#.
...#.#...#!#.#...#..S..#.
.###s###.###.#.#.######S.
.#.....#...#...#.....#...
.###.#.#.#.#########.####
.....#.#.#.........#.....
###r##.#.#########.#####.
.s...#...#.#..B..#.....t.
.#########.#.#.#.#####.#.
......r..#..S#.#...#...#.
.#####A#.##B#R.#####.###.
.#...#.#.......#.....#...
.#.#.#.#.#####.#.#####.#.
.#.#...Q.#...#.#.#.....#.
.#.###.###.#.#C#.###T###.
.#...#.#...#...#.....#...
.###.###.#####.#####.#.##
.#.#.#...#.......#...#...
c#.#.#.#t#.####R##.#####.
...#.....#...............
25 25
...#.....A.#...#...#.....
.#.#.###.###.#.#.#.#.#T#.
.#.....#...C!#...#.#.#.#.
.#########.#######.#.#.##
...#C..........#...#.#...
####.###C####C##.###.###.
.....#.#.#...#...#...#B..
.#####.#.#.#.#.###.###.##
...#.....#.#...#.....#...
##.#######.#############.
...#.....#.........#...#.
.###.###.#########.#.#.#.
.#.....#...#@#...#...#.#B
.#.#####.#.#.#.#.#####.#.
...a.....#...#.#.....a...
.###.####Q.###.###.#####.
...Q.#.#...#...B.#.....#.
####.#.#.###.###.#####.#.
.....#.#.#.#.#.......#...
.#####.#.#.#.#######.####
.#...BC#.#.#.#...#...#...
.#.a.#.#.#.#.#.#.#.#.#.#.
.#.#.#.....#.#.#.#.#.#.#C
.#.#.######A.#.#.#.#.###.
...#...........#...#.....
25 25
...#...R.#...c.........#.
.###T#.#.##R##.#######.#.
.....#.#.#.....#C....#...
.#####.#.#.#####.###.###.
..@#...#.#.#...#...#...#.
####.###.#.#.#####.#.#.#.
...#.#.....#.......#.#.#.
.#.#.####b##.#c#A###.#.#.
.#.#...#..c#..A#.....#.#.
.#.###.#.#.###.#.#######.
.#.....#.#...r.#.........
.######b.#####R##########
...#...#.#...#.#.........
##.#.###.#.#.###.#####.#.
...#...#.#.#.....#...#.#.
.###.#.#.#.#####a#.#.###.
.#...R...#.......#!#...#.
.#.###########A#.#####.#.
.T.....#.......#.#...#.#.
.#######t#####.#.#.#.#.#.
.#.....#.#.....#.#.#.#.#.
.#.###.#.#.#.###.#.###.#.
...#...#.#.#.#...#...#...
.###.###.#.###.#####.####
...#.....#...............
25 25
.#...#s..........#...#...
.#.#.#.#######.#.#.#.#.#.
...#...#.#.....#.#.#...#.
.#######.#.#####.#.######
.....#...#.....#.#.......
#q##.#.#######.#.#####.#.
...#.#.#.......#.....#.#.
.#.#.#.#.###########.###.
.#.#...#.#....q..#.#.....
.###.###.#.#####.#.####s.
.....#...#...#...#.....#.
.##A##.###.###.#####.#.#.
.....#...#.#...#.....#.#.
####.###c#.#.###.##T####.
.#...#.#.#.#...#.........
.#.###.#.#.###.#.########
.#.#...#...#...#.#@......
.#.###.#####.###.###s#.#.
.#...#.#.....S.#.#.....#.
.###.#.#.#####.r.#.#.####
.....#.#.#.....t...#.#..!
.#####.#.#.#########.#.B#
...#...#.#.#...#.....#.#.
##.###.#.###.#.#######.#.
.......#.....#...........
