abcdefghijklmnopqrstuvwxyz-=[];/
ABCDEFGHIJKLMNOPQRSTUVWXYZ_+{}:?
OOOOOOOOOOOOOOOOCCCCCCCCCCCCCCCC
7
21 21
.........#...........
.#####.#.#####.B#####
.#.....#.....#.#.....
.#.###Q#####.#.#.###.
.#...#.....#.#.....#.
####.B.#####.#######.
C..#.#...............
.#.#.#.##############
.#...#.#.....b...#...
.a####.###.###.#.#.#.
...#.......#...#.#.#.
.#.#######.#.###.#.#.
.#...#.#...#.#...#.#.
.###.#.#.###.###.#.#.
...#.#.....#...#...#.
##.#.#q###.###.#####.
.#.#...#@..#!..#.....
.#.###.#########.####
B..#.#.r...#...#...#.
.###.#.#.#.#.#.###.#.
.....#...#...#.......
21 21
.........#.......#A..
##.#####.#.###.###.#.
...#...#.#...#.#...#.
.###.###.###.###.###.
.#...........#...#.#.
.#.###########.###.#.
.#.#...#...a...#..b#.
.#.#.###.#######.#.#.
.#...#...#.....#.S...
.###.#.###.#####.####
.#...#.#.........#...
.###.#.#.###########.
...#.#.#...........#.
.#.#.#.###########.#.
.#.#@#!#.#.....#...#.
.#.#####.#.###.#.###.
.#.#.........#.#...#c
.#.#.#########.###.#A
.#.#...#...#.....#...
.#.###.###.#.#######.
.#.........#.........
21 21
.........#....S#.....
.#######.#.#T#.#####.
...#.......#.#...#...
##.#######t#.#T#.#.#.
...#.....#.#...#...#.
.#S#.###.#.#.#.#####.
.......#.#...#.....#.
.#######.#.ab#####.#.
.#...#...#...#...#...
.#.r##.#####.#.#.####
.#.#...#q....#.#.....
.A.#.#.#####.B.#####.
.#.#.#.#...#.#.....b.
.#.#.##q.#.#.#####.#.
...#.#...#!c.#.....#.
.###.#.#######.#####.
.#...#.#.......#.#...
##.#.#.#.#######.#.##
...#.#...#...#.....#@
.###C#####.###.#####.
.....................
21 21
.......#...#.........
.#.#####.#.#####.#R#.
.#.#.....#.....#.#.#.
.#.#.#########.#.#.##
.#.#...#.....a.#.#...
##.###.#.#.###.#####.
...#...#.#...#.....#.
.###.###.###.#####.#.
...#.#...#...#...#.#.
.#.#.#####.#.###.R.#.
.#.#...#...#T#...#.#.
.#.###.#.###.Q.#.#.#.
.#.#!..#.#.....#@#.#.
.#.#####.#########.#.
.#.....#q..........#.
##.#.###.###########.
...#.#...c.....#.....
.#####.###.###.#####.
.#.....#...#.#.......
.#.#B###.###.#A##c#T.
..Q......#...........
21 21
.#.....#.......#.....
.#.s##.#.###.#.#.#.##
.#...#...#...#.#.#...
.#.###.###.#####.###.
.#.#!#.#...#.....#...
R#.#.#.#.#.#.#####.#.
.#.#.#.#s#.#...#.#.#.
.#.#.###.#####.#.#.##
.#.#...#...#...#.#...
.#.###.#.#.#.###.###.
.....#.#.#.......#...
.#####.#.#########.#.
.#.....#.#.........#.
.#.#####.#.#########.
.B.....#.#.c.#...#...
.##s##.#####.###.#.##
..@#...#...#...#.C...
.###.###.#.###.#.###.
.#...#...#.....#.....
.#.###.#A#######.####
.#.....#......S......
21 21
...............#.r...
.####S########.#t##s.
.......#.....#...#...
######.R.###.#####.#.
.#.....#...#.......r.
.#.#####t#.#########.
.#.#.....#.#.........
.#.#.###.#.#.########
...#.#...#.#.....#...
.###.###.#.#####.###.
...#...#.#.#...#.....
##.#T#.#.#.#.#.#####.
.#...#.#.s.#.#.....#.
.###.#.#.#.#.#A###.#.
....bt.#...#...#@Br..
######.#######.#.####
!#.....#.......#.....
.#.#####.#########.#.
.#.#...A.#.......#.#.
.#.#.#.#.#####.#.###.
...#.#.........#.....
21 21
...#.....#...........
.#.###.#.#####.#####.
.#.....#.#...#...#.#.
.#######.#.#.###.#.#.
.#.........#...#...q.
.#######.#####.#####.
...#...#.#..!#.#...#.
##.#.#.###.##r.#.#.#.
...#.#...#.#.#...#...
.###.###.#.#.#######.
...#.#.#.#.#.......#.
##.#.#.#.#.#.###.###.
@#...#.#...#.a...#...
.#####.#####.#####.##
.....#.........#...#.
.#####.#######.#.###.
.q.....#..t....#.B...
.#.#####.#####.#.#.#.
.#.#.#...#...#.#.#.B.
.#.#.#.###.#.###.#.#.
.....#.....t.......#.
