abcdefghijklmnopqrstuvwxyz-=[];/
ABCDEFGHIJKLMNOPQRSTUVWXYZ_+{}:?
OOOOOOOOOOOOOOOOCCCCCCCCCCCCCCCC
7
17 17
.#...S@#.........
.#.#.#.#.###.###.
.#.#.#...#.#...#.
.#.#.###.#.###.#.
.c.#...#...#.#.#.
.#.###.###.r.#.#.
...#.#!#.....#.#.
.###.###.####s.#.
.#B....#.B...d.#.
.###.#.###.#####.
.....#..c..#...#.
##########a#.#.#.
.....#.#.....#...
.#.#.#.#.########
.#.#...#.#...#...
.#.#####.#.#.###.
.#....t....a.....
17 17
...#.......#.....
.#.#.#.###.#.#.#.
.#...#...#.#.#.#.
.######s.###.#.#.
...c...#.....#.#@
##.###.#####.#.##
.......#...#.#...
####.##Q.#.#####.
...#.#...#...#...
.#.#.#.##D##.#.##
.#!#.#.#.#...#...
.###.#.#.#.#####.
.#.b.#.#...#...#.
.#.###.###.#.#.#.
.#...#..Q#...#...
.#######.######r.
.........#.......
17 17
..@#.......#.....
.###.#####A#C#b#.
..U#.#...#.....#.
##.#.#.#########.
...#!#.....#.....
.#.C####.#.#.####
.#.......#.#.#...
.#######.###.#.#.
.#.....#.#...#.#.
.#.#T#.#.#.#####.
.#...#...#.#.....
.#####B###.#.###.
.#...#...#...#.#.
.#.#.#.#.#####.#.
.#.#...#.#.......
.#S#####.#.######
.......R.........
17 17
...#.....#.s...r.
.#.###.#q#.#.###.
.#...#.#.#.#...#.
.###.#.#.#.###.#.
..!Q...#.#...#.#.
########.###.#.##
.......#.#...#...
.#.###Tb.####c##.
.#s..#.#.....#...
.###.#.#####.#.#.
.#.d.#...#@#...#.
.#.#.###.#.#####.
...#.C.#.U.....#.
.###.#.#.#.#####.
.#...#Q....#.....
.#.#########.####
.#.r.............
17 17
.......#.........
u#.#####.######t.
.#.....#.#.....#.
####B#.#.#.#c#.#.
...#d#...U...#...
.#.#.#######.####
.#.#.#.......#...
.#D#Q#.###.###.#.
Cu.....#...#...#.
.#######.###.###.
.#...#...#@#.#!..
.#.#.###.#.#.####
...#...#...Q.#...
.#####.#####.#.##
.#...#.......#...
.r.#.#A#########.
...#.............
17 17
.#...#...........
.#.#.#.#######.#.
.#.#...#.....#.#.
.#.#####.###.#.#.
.#.#...#.#.#.#.#.
.#R#.#.#.#.#.A.##
.#.#.#.#.#.#!#...
.#.#.#.#.#.###U#.
.#.#.#@#.a.......
.#.#.###.#.###.##
.#.#...#.#...#...
.#.###.#.##D.###.
.#...#.#...#.R...
.###.#.###.###.##
..U#.....#.....#.
.#.#####.#######.
.#.B.q...........
17 17
.......#.........
.###.#.#u#.#t###.
.#...#.#.#.#...#.
##.###.###.#.R##.
!#.#.......#...#.
.#.####U######.#.
.#...#@........#.
.###.#####.####B.
..a#.#...#.#.....
##.#.#.R.#.#.####
.#.#...S.#...#...
.#.#####.u.#####.
.a.#.....#.#.....
.#.#.#####.#.#.#.
.#...d.#...#.#.#.
.#####.#.#####.#.
...............#.
