abcdefghijklmnopqrstuvwxyz-=[];/
ABCDEFGHIJKLMNOPQRSTUVWXYZ_+{}:?
OOOOOOOOOOOOOOOOCCCCCCCCCCCCCCCC
3
17 17
t......#.........
.#.####Q.S.#####.
.#.......#.#...#.
.#########.#.###.
.......#.#.#...#.
######.#.#.###.#.
@#.......#...#...
.#.#q#######.###.
.#.#.#!....#...#.
.#.#.#####.#.#.#.
.#.....#.#.#.#.#.
.#####.#.#.###.#.
...B...#.#.#...#.
.###.###.#.#.###.
..T#.#...#.#.#...
.#.#.#.#.#.#.#.##
.#.....#.#...#...
17 17
...#.......#.....
.###.#####.#.#.#.
.#...#!#..b#.#.#.
.#.#a#.#.#####.#.
.#.#...#....c#.#.
.#.#.######b.#.#.
.#...#B......#.#.
.####c.#######.##
....C#.#...S...Q.
.###.#.#.#######.
...#...#.#...#...
##.#####.#.#.#.##
.#.....#...#.#...
.#####.#####.###.
.#...#.r...#@#...
.#.#.#####.###.#.
...#.........s.#.
17 17
.......#.........
.#####.#.########
.#.....#.#.......
.###.###.#.#####.
...#...#...#.....
.#.###.#####.###.
.#.R.#.......bT..
.###.############
..@#.............
.##########c####.
.#!..a...A.#...q.
.#########.#.####
...#...#...#.#..q
##.###.#.###.#.#.
.#...#.#.....#.#.
.###.#.#######.#.
........B......#.
