abcdefghijklmnopqrstuvwxyz-=[];/
ABCDEFGHIJKLMNOPQRSTUVWXYZ_+{}:?
OOOOOOOOOOOOOOOOCCCCCCCCCCCCCCCC
7
17 17
.........#.......
.###.#####.#.###.
.#...#.....#.T...
.###.#.#####.####
..r#.#.#...#.#...
.#.###.###.#.#.#.
.a.#...#.D.#...#.
.#.#.###.#######.
.#.#.#.........#.
##.#.#S#.###.#.#.
...#...#@#...#.#.
.#.###.###.#####.
.#.#...#...#.....
.##r.###.###.###.
.#.......#...#.#.
.#.#######.###.#c
..v..q!....#.....
17 17
...........#.....
####.U####.###.#.
.....#...#...#.#.
.#####.#.###.#.#.
.....e.#.#RD...#.
.#######.#.#####.
.#.#...#.#...#...
.U.#.#.#.#.#.#.##
.#.#.#...#@#.#.#.
.#.#.#######.#.#.
...#.#..U....#.#.
.###.###.#####.#.
.#...#!#.#...#...
.#.#.V.#.#.#.###.
.#.b.#.s...#...#.
.#.###.#.#####.#.
.#.....#.....#...
17 17
.......#.......#.
####.###.###.#.#.
...#.#...e...#.#.
.#.#.#.###.###.#.
.#...vB#...#.#...
.#####.#.###.###.
..C....#.#u....#.
#u######.#.#.###.
.......#.#.#.....
.B####.#.#.######
...#.#...#.......
.#.#.###########.
.#.#.......#.S.#.
##.#.###.#.#.#.#.
...#..@#.#.#.#...
.#######.###.####
......!#.........
17 17
...............#T
.#####.#######.#.
.....#.....#...#.
##.#######.###.#.
...#.....#...#...
####.###.###.##v#
.....#q....#.....
.###v#####.#####.
.....U!#.#.....#.
####.#.#.#####.#.
..u#...#....S#...
##.#####.#.####B.
u....q...#.....#.
.#####.####V.###.
.#.....#@..#.#...
.#.#######.c.#.c#
...........#....c
17 17
...T.............
.#####.#####.###.
.#...#c#...d..d#.
a#.#.###.#.#####.
!..#.....#...#...
############.#.#.
.......#.....#.#.
####.#.#.#####.#.
...#.#.#.#.....#.
.#.#.###.#.######
.#...e...#.......
.d##.#.###V#####.
.#...#.#......@#.
.#####.###t#####.
....EB...#E#r..#.
.###.###.###.#.#.
...#.........#...
17 17
.#...............
.#.#########.v##.
...#.R.......#@..
####.#U#.########
...#.t.#.#!......
.#.###.##V######.
.#.....#.....b...
.#B###.Q.########
.u...#.#.#.......
.#.C.###d#.V####.
...#.....#.#.#...
.#########.#.#.##
.#...........#...
.###############.
.#.....R...#.....
.#.Q###u##.#.###.
...#.........#...
17 17
@................
############.####
...........b.....
.#########.#.###.
...#.....#.S...#.
.#.#.###s#.##A.#.
.#.#...#.#...#.#.
.#.###.#.###.#B#.
.#.#...#...#.....
.d.#.#####.#T###.
.#.#.#...QQ....#.
##.#.#Dt.#####.#.
...#...#.#...#.#.
A######R.###.#.#.
.#a..#.......#...
.#.#.######v.####
...#..!#..R.....E
