abcdefghijklmnopqrstuvwxyz-=[];/
ABCDEFGHIJKLMNOPQRSTUVWXYZ_+{}:?
OOOOOOOOOOOOOOOOCCCCCCCCCCCCCCCC
7
9 9
..s......
.###.###.
...#...#.
##.##abt.
@#.#.#.#.
.#.#.#.##
.#...#..!
.###.####
.........
9 9
r#...#..!
.#.#.#a##
...#...#.
.#######.
.#.......
.#.#.###.
.#.#.#...
.b##.#.##
.....#..@
9 9
..T......
####.###.
...#@a.Q.
.#.###.##
.#...#...
.###.#.#.
.#...#R#.
.#.##Cs#.
!#......c
9 9
@........
####.#.##
!..#.#...
##.#####.
.#.....#.
.#####.#.
.......#.
B#######.
........C
9 9
@........
####.###.
..!#.#...
.###.#.s#
.#...#...
.#.#####.
.#.#...#.
.#.#.#.#.
...#.#...
9 9
.........
####.#.##
..A#t#...
q#.#####.
.#.......
.#######.
...#...#R
##.#.#.#.
!..#@#...
9 9
.....#...
.###.###.
...#.....
##.#####.
@#!#.....
.###.###q
.#...#.S.
.#.#####.
.........
