abcdefghijklmnopqrstuvwxyz-=[];/
ABCDEFGHIJKLMNOPQRSTUVWXYZ_+{}:?
OOOOOOOOOOOOOOOOCCCCCCCCCCCCCCCC
7
35 35
!#.......#.............Q...........
.#.#####.###.#########.#.###.#####.
.#.#.#...#...#.....#.#.#@#...#.#...
.#.t.a.###.#.#.###.#.#.###.###c#.##
.#.#...#...#.#.#...#.......#.....#.
.#.#.###.#.###.#.#.#########.####b.
...#.#.#.#...#.#.#.#.......#.....#.
####.#.#.###.#.#.###.#####.#####.#.
...#.#.....c...#.....#.....#...#.#.
.#.#.#B###.#####A#####.#####.#.#.#.
.#.#...#.#.#.....#...C.....#.#.#.#.
.#####.#.#.#C#.#.###.#####.###.#.#.
.....#.#...#.#.#...#.#...c.#...#...
####.#.###.###.##c.#.#.#.#.#.#####.
.....B...#...#...#...#.#...#.......
.#######.##q.##t.##T.#.#####.######
.....#...#.#.#...#.c.#.....#.......
.###.#.###.#.#.#A#.#######.#######.
.#...#.#.T.#.#.#...#.......#...Q...
##.###.#.###r#.#.###.#########.#.##
...#...#.#.....#...#...#.......#.#.
.#.#.###.#.###########.#R#####.#.#.
.#.#.#...#.#.#.....#...#.....t.#...
.#.#.#.###.#.#.###.#.###.##R.#####.
.#.#.#.......#.#...#...#...#.....#.
.#.#.#####T###.#.#c##c.###.###.###.
.#.#...........#.......#...#...#...
.##s############t#######s###.###.##
.....#.............#.........#...#.
.#.###.#######.###.#.#######.#.###.
.#...#...#...#...#...#.#.....#.....
.###.###.#.#####.#####.#.###C#####.
.#.#.....#.....#.....#...#.......#.
.#.###CC####.#.#####.#c###.#.####t.
....b........#.....#.......#.......
35 35
.......#.....#.#.........#r......#s
.#####.#.###.#.#.#.#####.#.#####.#.
...#.#.#...#.#...#.#..@#.#.#.....#.
##.#.#.#.#.#.##ar#.#.###.#.#.#####.
...#.#.#.#.#.#...#.#.....#.#.#...#.
.###.#.#.#.#.#.#.#.#.#####.#.#.#.#R
.#.#...#.#.#.q.#...#.#.....#.t.#...
.#.#.#####.r.#.#####.#.#.#########.
.#.........#...#.......#.#...#...#.
.####r########.###########.#.#.#bA.
.....#.....#...#...B.......#.#.#.#.
.###.#.###.#.###.#.#.#######.###.#b
.#...#.#!#...#...#...#.....#...B...
##.#####.#####.#######.#.##S##.#.##
...#...#.....#.#...#...#.....#.#...
.###.#.#####.#.#.###.#######.#.###.
.#...#...#...#.#...#...#.#...#.#...
.#.#####.#.###.#.#.###.#.#.###.#.##
.#.#.#...#.....#.#B..#...#.#...#.#.
.#.#.Q.#########.###.#.###.#.###.#.
.#...#.#.......#...#...#...#.#...#.
.###.#.#.###.#.###.##R##.#.#.#.###.
...#.#...#.#.a.#...#...#.#.#.#.....
##.#.#####.#.###.###.#.#.###.##a##.
...#...#...#...#.#...#.#.....#.#...
.#####.#.#####.#.#####r#######.T.##
.......#.....#.#.....#.........#...
.###C#######.#.#####.q.#.#####.###.
...#.....#...#.r...#.b.#.#...#...#.
##.###.#.#.#.#.#####.###.#.#.#####.
.#.....#.#r#.#.#.....#...#.#.....#.
.######t.#.#.#.#.#####.#.#.#####CS.
...#.....#.#.#.#...#...#.#.....#.#.
.###.#####.#.#.###.#.#########.#.#.
...........#.Q.....#...........#...
35 35
...#...........#.............#.#...
.#.#.#########.#.#########r#.s.#.#.
.#.#!#.......#...#.......#.#.#...#.
.#.c##.###.#######.#####.#.#.#.###.
.#.#.....#.....#.......#...#.#.#...
.#.#.#########.#.#####.#.###.###.#.
.#.....#.....#.#.#...#.#.#...#...#.
.##r##.#.###.#.#.#.###.###.###.###.
.#...#@#...#T..#...#...a...#.....#.
##.#.#####.S.#####.#.###.######a.##
...#.......#.#...#.#.....#..t..#...
.##s####.#####.#.#.#######.#.#.###.
.......#.#.....#.#.#.......#.#.....
.#####.###.#####.#.#.##b##t#.######
.....#....S....#.#.#.......#.....c.
.##B##c#########.#.###############b
.#...#.......#...#.......#.......#.
.#.Q.#.#####.#.#.q######.#.#####.#.
.#.#...#.#...#.#...#...#...#b..#.#.
.#.#####.#.###.###.###.#####.#.#.#R
.#...#.........#.#...#.....#.#.b...
.#c#.##A########.###.###Q###.#.###.
.#...#.....#.......#...#.#...#...#.
##.#.#.#Q#.#R#########.#.#.###.###.
...#.#.#...b..S#.........#.B.#.....
.#A###.#.###c#.#.#########.#.######
.#.....#.....#.#...#.......#...#...
.#.#########.#.###.#.r######.###.#.
.#.....a.....#.#...#.#...#.......#.
.###.###.#####.#.###.#.#.#####.###.
.....#...#...#...#.#...#.....#.#...
.#####.###a#.#.###.#########.###.#.
.#.....#...#.........#.......#...#.
.#.#####.#.###########.#######.###.
.#.......#.....................#...
35 35
.......t.#.......#................@
.#######.#.#####.#.#######.#.r#####
...#.....#.#...#.#B....#...#.#.....
.#.#.#####.#.#.#.###R#.#.#####.###.
.#.#B#.....a.#...#.#...#.......#...
.#.###.#####.###.A.#.###########.#.
.#.......#...#.....#...#.....#...#.
.#########.##c.#######.#####.#.####
.#c#...#...#...#.....#.....#.#.....
.#.#.#.#.#.#####.#.#.#####.#.#####.
.#...#.#.#.#.....B.#.#.a...#.....#.
.#####.#.#q#.q#t##.###.#A##b####.#.
.....#.#.....#...#.....#.........#.
####T#.#########.######b.#.#T#####.
...#.#...............#...#.#.....#.
.#.#.###.#S#########.#.A##.#.###.#.
!#.#.....#.......#...B.#...#...#...
##.###c###.#####.###########c#.###.
.#...#.....#...#..a........#...#...
.###.#.#####.#############.#.#####.
...#.#...#...T...........R.#.#...#.
##.#.###.#.###.#####.#####.#.s.#.#.
...#.....#...#.#.....#.....#...#.#.
.#S#######.#.#.#.###.#.###R#####.##
.#.#...#...#...#...#.#.#.c.....#s..
.###.#.#.#########.###.#.###.#.###.
.#...#.#.........#.....#.#...#.....
.#.###.#########.#########.#######.
..R#.#.....#.....#.......#.#.....#.
.###.###.#.#.#####.#####.#.#.#.Q##.
.#.....#.#.#.#...#...#.#...#.#.R...
.#####.#.#.#.###.#.#.#.#####.#.#.##
.......#.#.#...#...#.#.....#.#...#.
######.#.#####.#####.#.###.#.#####.
T......#..........c..#.q.#.........
35 35
.........#.......#.....#.....#...#.
.#######.###.###.#.#.#.#.###.#.#.#.
.#!#...#.#...#...#.#.#...#.#...#.#.
.#.#.###.#.###.###.#.#####.#####.#.
.#.#...#...#...c.c.#.#..@#.....#...
.#.#.#.#####.###.#.#.#.###.#.#t###.
.#.#.#C....#...#...#.#.....#.....#.
.#.###.###.###.#####.#####.###.###.
.#...#.#.....#......A#...#...#.#...
.###.#.#.#############.#.#####.#.##
.....#.#.........#.....#.#...#.#...
T#####.#########.#.###.#.#.#.#.###.
..A..#...#.....#...t...#...#.....#.
R#q#####.#.###.#####.#######q###.#.
...#...#...#...#...#.......#.....#.
.###.#.#####.###.#.#######.#.##b##.
...s.#.....#.#...#.#.....#.#.#...#.
.#########.#.#.###.T.#.###.#.#.#.#.
.#..r....#.....#.....#.#...#.#.#..Q
.#.#####.###c#########.#.###.#.####
...#.....r.#.........#.#...#.#...#.
####.#####.#.#######.#.###.#####.#.
....S#.....#.......#.#.B.#.....#...
.##B####.#########.#.#######.#.###.
....q..#.#.........#.....#...#.#.#.
######.#.#.#############.#.###.#.#.
.....#.#.#.......#.......#.#.#...b.
.#.#.#.#.#######.#####.###.#.#.c##.
.#.#.#..a#...s.#.....#...#.#..q#...
.#.#####.#.###.#####.###.#.#b###.##
.#.......#...#.B.#.#.#.....#..C#...
.#############.#.#.#.#############.
.#.....BB#.....#.#.#.#...#...#.....
.###.###.#.#####.#.#.#.#.#.#.#.####
.....#.....#.......#...#...#.......
35 35
.......#...#...#.......#...#.......
.#.#.###.#.#.#.#.###.#.#.#.#.###.##
.#.#.#...#...#.....#.#.#.#.....#...
.#.###.####A##A#####.###.#####A###.
.#...#.#.......#..!#...#.#.#.......
.a##.#.#.#####.#.#####.#.#.#.#####.
.#.#.#.#.#@....#.#...#...T.#...#...
.#.#.#.#.###.###.#.#.#.#######.#.##
...#.#.#...#...#...#.#.#.....#.#.#.
.###.#.###.#########.###.###.#.#.#.
.#...#...#......a#.#.....#.#.#.#...
.#.S####.###.#.#.#.####B##.#.#.###.
.#.....#...#.#.s......R#.#...#...#.
####.#####.###.#####B#.#.#.###.#.#S
...#.#...#.#...#.....#B..#...#.#...
.#.#.#.#.#.#.#.#.###.#######q#.###.
.#...#.#...#.#.#.#.#.........#...A.
.#.###.#####.###.#.###############.
.#.#...#.....#...#.......#.......#.
.###.#######.#.#####.###.#.#####.#.
.....#...#...#.....#.#.T...#...#...
.#####.#.#.#.#####.#.#.#######.##Q#
...#...#...#.#...#...#..Q..........
##.#.#######.###.###########.#####.
.#.#.....#.................#.#.....
.#.#####.#####.###########.#.#.####
...#...#.....#.#...#.....#...#...#.
.###.#.#####.###.#.#.###.#######.#.
.....#.#...#.....#.#.#.#.....#.#.#.
######.#.#.#######.#.#.#####.#.#.#.
...#...#.#.#.....#...#.....#.#.#...
##.#.###.#.#.t##.###.###.#.q.#.###.
...#.#...#.#.#.#...#c....#.#.#...#.
.###.#.###.#.#.###.#########.#.###.
.......#.....#...............#.....
35 35
.#.......#...........#...#.........
.#.#.#.###.#####.##A.#.###.#.#####.
...#.#.#...#...#.#...#.#...#...#...
.###.###.###.#.#.#.###.#.#####.####
...#...#.#...#.#.#...c...t...#.....
##.###.#.#.###.#.###.###########.#.
.#.#...#.#...#.#...#.#.........#.#.
.#.#.#.#.#####.###.#.#.######S.#.#.
.#.#.#.#.#...#...#.#...r.....#.#.#.
.#.#.###.#.#.###.#.T####.#.###.#.#.
...#.....#.#...#.#.#.....#...#.#.#.
.##A##C#.#.#b#.#.#.#.#######.#.#.#.
...#...#.#.#.....#.#.#.....#...#.#.
.###.#.#.#.#.#####.#.###.#.#######.
.#...#.#...#...#...#.....#.#t......
##.#S#.#######.#.#########.#.#####.
...s.#.#.#...#.#.......#.#.#.#...#.
.###.#.#.#.#.#.#######.#.#.#.#.#.#.
.#.#...#...#.......#...#.#.#.#.#...
.#.#.###.#######.##q.###.#.#.###.##
.#...#.#...#...#.#...#.....r...#.#@
.#.###.a.###.#.###.###.#####.#.#.#.
.#...#...#...#.....#...#...s.#.#...
.###.#.###.#########.##r.#####.####
.#.#.#...#.#.......#...#.....#.....
.#.#.#####.#.###.#####.###########.
.#.........#...#Q#.....#...#.......
.#####R#######.#.#.#####.#.#.#####.
.#....!#.......#.#.#.....#.#.....#.
.#.#####.#########.s#T##.#.#####.#.
...#....C..........#.....#.......#.
####.###############.#############.
...#.....#.......#.......#.#.......
.#######.#.#####.#######.#.#.######
...........#.............#......r..
