abcdefghijklmnopqrstuvwxyz-=[];/
ABCDEFGHIJKLMNOPQRSTUVWXYZ_+{}:?
OOOOOOOOOOOOOOOOCCCCCCCCCCCCCCCC
7
17 17
.........#.....#.
#d##.##T.#.###.#b
.r...#...#.#...#.
.#####.###.#.#V#.
.....#.C...#.....
.###.#.#.R######.
.#...#.#.#.......
.e.###.#.#.#####D
.#.#.#.#.#.....#@
##.#.#.#.#####.#.
...#.#...#.....#.
.###.#####.#####.
!#...#.....#...V.
##.#.#.########a.
.#T#...#.........
.#.#####.#######.
.........#.......
17 17
.................
.#######RR######.
S......r@......#.
.#####.###r#.###.
.....#...#.#.....
####.###.#.######
.....#.R.#...#..!
Q#####.###v#.t.##
.....#.#...#.#...
.###.#.#.#.#####.
.#.....#.#.....#.
.#######.##e##.#.
.#.....#...#..A#.
.#.###.###.#.###.
.#...#...#.#.#...
.###.#.###.#.#.##
.....#.....#.....
17 17
...#.......#.....
.#.#.###.#.###.##
.#...#...#...#...
.#####.#####.###.
.#...#.#.........
.#.#.#.##E##u####
...#.#...#......a
####.###.#.#####.
..@#.#...#.#!....
.###.#.###.######
.#...#..d#.#.....
.#.#####.#.###.#.
.....#...#.....t.
.##d##.#.#######.
.U.....#.#.....d.
.#.#######.###.#.
.#...........#...
17 17
...#.....#.......
.###.#t#.#.#####.
.....#...#...#@d.
.D####.#####.#.#.
.#...#.....#.#.#.
##.#.#.###.#.#.#.
...#.#...#...#.#.
.###.#u#.#####.#.
.#.#..!#...#...ue
.#.t######U#.###.
.#.......#.#.#...
.#.###rb.#.#.#.##
...#T..#.#...#...
####.###.#tC.###.
.........#...#.Q.
.#############.#.
...............#.
17 17
....q..r.D...#C..
####.###.#V#.###.
...#...#...#.#...
.#.#######.#.#.a.
.#.C.......#...#.
.#.s############.
.#.#.......#.V...
.###.#####.#.#.##
...s.e.....#.#...
####V#.#####.###.
.....#...#....@#.
q#######.#.#.###.
.#..q#!#.#.#.#...
.#R#.#.#.###.#.##
.#.#.#...#...#.E.
.#.#.#####.#####.
...#....t........
17 17
.......#...#...#.
.#.###.#.B.#.#.#.
.#.#.#.#!#..q#.#.
.#.#.#d####T##.#.
.#.#...#.....#.#.
.#.#.###.###.#.#.
.#.#...#.#...#.#.
.#.#####.#.###.#.
.#.......#...#...
.###########.###B
...#.......#.....
##.###B##########
@#...#..RA.......
.###.########E##.
...r...#..t..v...
.#####.#.#######.
.....v...#.......
17 17
...#.............
t#.#.###.###.####
.#...#.#...#.#...
.#####.###.###.#.
.....#...#.....S.
####.#.#.#######.
.....#.R.....#..c
.#####.###.###.#.
....u..#.#.#...#.
########.#.#.####
@#.........#.....
.#.#######.#Q###.
...b.....#.#.....
####.###.###b##B.
.....#...#...#.#.
.#####.A##.###.#.
....!#.....#.....
