abcdefghijklmnopqrstuvwxyz-=[];/
ABCDEFGHIJKLMNOPQRSTUVWXYZ_+{}:?
OOOOOOOOOOOOOOOOCCCCCCCCCCCCCCCC
9
17 17
.#....q#...#.....
.q.#.#.#.#.###.#.
...#.#.#.#...#@#.
.##T.###.###.###.
.#.#.....#.#..!#.
.#.#######.#####C
.#.......#.#.....
.###.##S.#.#.#.##
...#.#...#...c...
##.#.#.###.#####.
.#.#.#...#b....#.
.#.#.###.###.###.
.#.#...#.#...#...
.B.#r#.#.#.###.#.
.#.#.#.#.#.#...#.
.#.###.#.###.###.
.......#.....#...
17 17
...#!....#.....#.
.b.#####.#.###.#.
.#.#.....#.#s#.#q
.#.#.#####.#.#QA.
.#.#.....#.#...#.
.#######.#.#.###.
.......c...#.....
.#####.#########.
...#...#......@#.
b#.#.#.###.#####.
...#.#.....#...#.
b###.#######.t.#.
.#.#...#...#.#.#.
.#.###.#.#.#.#.#.
...#.#.#.#...#..s
##.#.#.#.########
.....#.....c.....
17 17
.....#...........
.s##.#.#########.
.#...#.#...#@#...
.#.###.#.#.#.#.#.
.#.#...#.#...#.#.
.#.#.###.###.#.#.
.#.#.#.....#.#.#.
.#.#.###.#.###.#.
.#.#...#.#.#...#.
.#####.#.#.#.###.
.#.....#.#.#.#...
.#.#c###.#.#.####
.#.#.....#.#.....
.Q.#C#.###.#####.
.#...#.#...#.S.#!
.###.###.#.#.#.##
.........#...#...
17 17
.#...........#...
.#.###.#####.#.#.
.#.#@#.....#...#.
.#.#.#####.#R###.
.....#...#.#.....
.#####.#.#.#####.
.#.....#.R.#...#.
.#.#####.#.#.#.q#
.#...#...#.#!#...
.###.#.###.#####.
.#...#.#...#.....
##.###.###.#.####
...#.......#.....
.q####.#########.
.#...#.#.......q.
.#.#.###.#####.#.
...#.....Q...#...
17 17
.....#...........
.###.#.#########.
.#.....#.#...#...
.#######.#.#.#.##
.......#.#.#...#.
######.#.#.#####.
...#...#.#...#...
.#.#.###.###.###.
!#.#.b.....#.....
##.#.#.#########.
.#...#.......#...
.##########q.#.##
.............#...
.#####.#########.
.#...#....S..#...
.###.#######.#.##
..........@#.....
17 17
.......#.....#...
.#.#####.#.#.#.#.
.#.#.....#.#.#!#.
.#.#.#####.#####.
.#.#...#...#.....
.#.###.#A###.####
.R.#.#.#.....#...
.#.#.#.###sA##.#.
.#.#.#.........#.
.#.#.###########.
.#...........#...
.###########.#.##
...#@........#...
.#.#############.
.#..b............
.################
.................
17 17
.........#b......
######.#.#####.#.
.......Q.....#.#.
.###########.#.#.
.#!#.......#.#t#.
.#.#.####T.#.#.##
.#.#...#...#.#...
.#.###.#.###.###.
.#.....#.#.......
.#######.########
.#.....#.#.......
.#.###.#.#.#####.
.....#.#.#.#.#...
.#####.#.#.#.#.##
.#@#...#...Q.#.#.
.#.#.#######.#.#.
...#.........R...
17 17
.........#.#.....
.#######.#.#.###.
.#...#.#...#...#.
.#r#.#.#.#s#.###.
...#.#.#.#...#...
.###.#.#.#.###a##
...#.#...#...#.#@
##.#.#####.###.#.
...#.......#...#.
.###########.###.
.#.........#..!#.
.A##.R.###.###b#.
...#.#...#.#.....
##.###c#.#.#####.
.#...#...#.......
.###.#.#########.
.......#.........
17 17
.......#...#...#.
.#####.#.#.#.#.#.
.#...#...#...#.#.
.#.#.#b#######.#.
.#.#...#.....#.#.
.#.###.#.#.###.#.
.#.#...#.c.....#.
.#.#####.#######.
.#.......#.....T.
.###.#########.#B
...#..t........#.
.#.########T####.
.#...#...#...#...
####.#.#.#.#.#.##
.....#.#.#.#.....
.#####.#.#######.
.......#....!#@..
