abcdefghijklmnopqrstuvwxyz-=[];/
ABCDEFGHIJKLMNOPQRSTUVWXYZ_+{}:?
OOOOOOOOOOOOOOOOCCCCCCCCCCCCCCCC
1
17 17
..r..c.#.....#...
.#######.###A###.
C..#..a..#...#...
.#.#.#####.###.#c
.#.#.#...#....b#.
.#.#.###.#######.
.#.#..!#.#B......
.#.#####.#.######
.#.q.......#.....
.###########.####
.r...#.....S.#..s
#S##.#######.#.#.
@..#....Q..#...#.
##.#######.#####.
...#...r.#.#.....
.###.#.###.#R###.
.T...#t......#.S.
