abcdefghijklmnopqrstuvwxyz-=[];/
ABCDEFGHIJKLMNOPQRSTUVWXYZ_+{}:?
OOOOOOOOOOOOOOOOCCCCCCCCCCCCCCCC
15
17 17
.......#.......#.
.#####.#.#.###.#.
...#...#.#...#...
.#.#####.###.#S##
.#.........#.....
##########.#####.
.........#.#...#.
.Q######.#.#.#.#.
.#.......#...#@#.
.#.#########A###.
.#.......#.......
.#######.#.#####.
.....#!..#.#...#.
####.#####.#.#.#.
...#.#.....#.#.#.
.#.#.###.###.###.
.#.......#.......
17 17
..s..#.........#.
.###.###.#####.#.
...#...#...#.#.#.
.#.##T.##t.#.#.#.
.#...#...#.#.....
.###.###.#.##A##.
.#.#...#.#.....#.
.#.###.#.#####.#.
.....#.#.......#@
######.##########
.......#.........
.#######.#######.
.......#.#.#...#.
.#####.#.#.#.#.#.
.#...#.#!#.#.#...
.###.#.###.#.####
.....#...........
17 17
...#.........#...
.#.#.#.#####.#.#.
.#...#@#...#...#.
.#####R#.#.#####.
.........#.....#.
#a############.#.
...#...........#r
.###.###########.
...A.......#.....
.#.#######.#.####
.#.....#...#...#.
##B###.#.#####.#.
.......#...#...#.
.#########.#.###.
.#.......#!#.#...
.#.###.#####.###.
.....#...........
17 17
!..#...#.........
##.###.S.######c.
...#...#.#.......
.###.###.#.#####.
.#...q...#...#...
.#.#.#.#####.###.
.#.#.......#...#.
.#.###########.#.
.#...#....c#...#.
.#####.###.#.###.
.#...#...#.b.#.#.
q#.#.###.#.#.#.#.
...#.....c...S.#.
##############.#.
.....#...#.....#.
.###.#.#.#.#C###.
..@#...#...#.....
17 17
..........@#!#...
.#.#########.#.#.
.#.#.........#.#.
.#.#.###########.
.#.#.....#.R.....
##.T####.#s#.#.#.
...#.#...#...#.#.
.#.#.#.###.###.#.
.#.#.#...#...#B#.
.#.#.###.###.#.##
.#.#.#...#...#...
.#.#.#.#####q#.a.
.#.S.#...#...#.#.
.c##.###.#.#.###.
...#...#.#.#.....
.#.#####.#.#####.
.#.........#.....
17 17
.A.#.......#....a
.###.#.#####.###.
.....#.......#.#.
.#############t#.
...#@..........#.
##.#########.##c.
.#...#...#...#!..
.###.#.#.t.######
T..#...#.#.......
##.#####.#.#.###.
.......#.#.#.#...
.#####.#.#.#.###.
.#...#.#.#.#...#.
.#.#.###.####T.##
...#...#.....#...
.#####.#####.###.
.....#...........
17 17
.#...#.#.........
.#.#.#.#.#####.##
.#.#.#.......#...
.#.#.####B##.###.
...#.......#...#.
.#######.#.#.###.
.#.....#.#.#.#...
.#.###.###.#.#.##
.#.#.#.....#@#...
.#.#.###########.
.#!#.....#.......
.###.###.#.#####.
.b...#.#.#.....#.
.#.###.#.#.###.#.
.#.#.....t.#...#.
.#.#.#######.###.
...#.........#...
17 17
...#...#.......#.
.###.#.#####.#.#.
.#...#.#.....#...
.#.###.#.########
.#!#...r.#.......
.###.###.#.s####.
...#...#...#...#.
.#.###.#.###.a.#.
.#...#.#...#.#.q.
##.###.A##.t.###.
...#b..#@....#...
.###.#########.s#
.#...#.......#...
.#.###.#####.#.#.
.#.#...#...#.#.#.
.#.###.#.###.###.
.......#.........
17 17
.........#.......
.#####.###.#####.
.#.....#...#.....
##.###.#.###.####
...T.#.#.#!..#@..
.###.#.#.#######.
...#...#.#...#...
r#.##t##.#.#.#.#.
.#.....#...#.R.#.
.##A##.#########.
...#.......#...#.
####.#####.#.###.
.....#...#..S#...
.#####.#.#.###.##
.#...#.#.#.#...#.
.#.#.#.#.t##.bA#.
...#...#.....rt..
17 17
.........#.......
.#####.###.#####.
.....#.....#!....
####.#########T##
...#.#...........
##.#.###.#.#####.
...#...#.#.....#.
.###b#.#######.#.
.....#...#.....#.
.#.#####.#.#####.
.#.#...#...#...#.
##.#.#.#####.###.
.C.#.#.........#.
.###.#########.#.
...#.#..T....#...
.#.#.###.###.##c#
.#.......#@......
17 17
.#.....#.q.....#@
.#.#.###.#.###.#.
...#...#.#.#..S#.
.#####.#.#.###.#.
.#...#...#...#...
.###.#######.###.
.....T.......#...
####.#.###.######
.....#.#.#.#.....
.#####.#.#.#.###.
.....#.#...#..!#.
.#####.#.#######.
.#.....#...#...#.
##.#.#s##B.#.#.#.
...#.#...#...#.#.
.#####.#.####T##.
.......#.........
17 17
...#.........#...
.#.#.#####.#.#.#.
.#.#.#...#.#...#.
.#.#.#.#.#######.
.#...#.#..!#...#.
.#####.#####.#.#.
.#...#.#.....#...
##.#.#.#.#.#####.
...#.#.#.#.#.....
.###.#.###.####C.
.#...#.#...#...#.
.#.###.#.###.#.#.
.#.....#.....#.#.
.#######.#####.#.
.....#.....#...#.
####.#######.###.
.............#@..
17 17
.#...#...........
.#.#.#.#######.#.
...#.#...#...#.#.
.###.###.#.#.#.#.
..@#.....#.#...#.
##########.#.###.
...........#.#!#.
.#######r###.S.A.
.#.........#.#.#.
.#.#######.#.#.#.
.#.#.....#.#.#.#.
.#.#.#####.#t#.##
.#.#.#.....#.#...
.#.#.#.###.#####.
.#.#.#...#.#...#.
.#.#Q###.###.#.#.
.......#.....#...
17 17
......@#.....#...
##.#####.###.#.#.
...#.......#...#.
.#.#.###########.
.#.#...#.....#...
.#####.#.##A.#.#.
.......#.#.....#.
####.###.##q####.
!..r...#.#.....#.
##.#####.#.###.#.
...#.....#.#.#.#.
.#Q#.###b#.#.#.#.
.#...........#.#.
.#####.####r##.#.
.#...#.....#...#.
.#.#.#######.###.
...#.........#...
17 17
.S........t..#...
.#R###.#####.#.#.
.#...#.#.....#.#.
##.#.#.#.#####.#.
B..#...#.#.....#.
.#.#####.#.#.####
.#.#...#.#@#.....
.###.#.#.#######.
...#.#.#.........
#A.#.#.#######q#.
...#.#.#B......#.
.###.#.#.###.#.#.
.#...#.#...#.#.#.
.#.###.###.#.#.#.
.#.#.#.#...#.#.#.
.#.#.#.#.###.Q##.
.....#!#...#.....
