abcdefghijklmnopqrstuvwxyz-=[];/
ABCDEFGHIJKLMNOPQRSTUVWXYZ_+{}:?
OOOOOOOOOOOOOOOOCCCCCCCCCCCCCCCC
7
17 17
...#.....#.....V.
.#.V##.#.#####.#.
.#.....#.#...#.#.
.#######.#.#.#.#.
c...R#.#...#.#.#.
####.#.#####.#.##
...#.#.......#...
.W.#.#.#######.#.
.#...#...#.X...#.
.#######.#.#####.
...#.....#..@#...
.D.###.#######.#.
.#...#........gC.
##a#.############
.....#...........
.#####.#########q
.......#!........
17 17
.....#...#.......
#A.v.C##.#.###.#.
...#.....#C#...#.
.#######.#.#.###.
.#...#...F.#...#.
.#.#.b####.E##.#.
F..#.........#.#.
.###########.#.##
.......#...#.#...
####.###.#.#####.
@#...#...#.......
.#.b##.#########.
.A.#.#.#.Q.#.....
.#.#.#.#.#.###r#.
.#...#...S.#..!#.
.###.#####.#.###.
.........#...#...
17 17
...#@............
.#.##A#d####.####
.#.....C....W#...
.#V###.#.#####.#.
.#...#...F.....#.
.#.#t###.#.#####.
.#.#.....#..!#.#.
.#.#.#####C###.#.
.#...#.......#.#.
.#.###.###.#.#.#.
.#.e...#...#...v.
.###.###.###.#b#.
.....#...#...T...
.#####.#r###.#.##
...#.u.#...#.#.#.
##q#.###.#.###.#.
.D.#.....#.......
17 17
.....#...........
.###.#.#.#.#####T
...#.#.#.#.#.....
##.###.#.###.###.
...#...#.....#...
.###.##S###ud#.##
.....#.......s...
.#####.#####.###.
.......#...#...#.
########.#.#E#.#.
.......#.#...#.#!
.#####.#.##B.#.##
...#@..#.#.#.#...
T#.#####.#.#.###.
U..#...#...#.....
.##f.#.###.######
.....#...........
17 17
.....#.......#!..
.###.#.#.###.###.
..@#.#.#...#.#...
####.#.###.#.#.##
.....#.#...#.#...
T#####.#.####ca#.
.....#.#.f...#...
.#q#.#.#.#.#.#.#q
.#.#...#.#.#.#...
.#.####g.#.#.###r
...#.#...T.#.....
##.#.#.#b#.######
...#v#.....#.u...
.###.#######.#.##
.#.........#.#...
.#.#######.#####.
...#..........sc.
17 17
.....S...........
.#.############d.
.#.#.....#E....e.
##.#.#.#q#.C#####
...#.#.#.#.#.....
.###.Ex###.#.#.##
.s.#.#...#.#@#...
#q.#####.#.#####.
...#...#.#.....#.
.###.#.#.#####.#.
.A...#.#.....#...
######.#.###.###.
q..#!..#.t...#...
.##T####.#.#.#.##
..f#..V#D#.#.#.#.
.#.#.#.#.#.###.#.
.b...#...#......b
17 17
.#..W.....T#.f...
.#.######q.#.###.
.....#t..#.v.#...
######.#v#.###.#.
.a!#.B.#.#...#.#.
.###.###.b##.R.#d
..b..W.#.#...#.#.
###Ar#.#.###T#.##
....V..#..w#.#...
.###.#.###x#####.
.#...#.#.#.#D..f.
##.###.#.#.#.###.
e..#.....#.d.#.#.
.#############.#.
...........T....G
.#####F###.#.####
.........#......@
