abcdefghijklmnopqrstuvwxyz-=[];/
ABCDEFGHIJKLMNOPQRSTUVWXYZ_+{}:?
OOOOOOOOOOOOOOOOCCCCCCCCCCCCCCCC
7
33 33
...T...#.........#...............
.#####.#.#######.#.######sB#####.
.#...#.#.#.....#.#.....#.....#...
.#.#.#.#.#.###.#.###b###.##C.S.#.
.#.#.#.#.....#.#.......#.#.#...#.
.#.#.#.#######.#######.#.#.#####.
...#.#.#......a#.....#.#.#.......
.###.#.#.#######.####c.#.#######.
..A#.#b#.#...#.........#...#...#.
####.###.#.###.###########.#.#.##
.....#...#.....#.........#.#.#...
CQ####.#####.#######q#.#.#.#.###.
.....#.....#.......#.#.#.#.....#.
.#B#.#b###.#######.###.#.#######.
.#.#.....#.....c.....#.#.........
.q.#####.####c.#####.#.#########.
.#...#.....#.#..!#T#.#.#.......#.
.#.###.###.#.B####.#.#.#.T.#####.
.#.#...#...#....ba.#.#bt.#.#.....
.#.#.###.#######.###.#.#.###.##Q#
...#...#.#.....c...#...#.....#...
##.###.#.#.###.###.#####.#####.##
.#...#.#...#.#.........#.#.....a.
.###.#.#####.###.#######.#.#####.
...#.#.....#...#.#.......#.#.#.a.
.#.#.#####.#.###.#.#######.#.#.#.
.#...#.#...#.....#...#...#...#.#.
.#####.C.###.#####t#.#.#####.#.#.
.#@....#.#...#...#.#.#.a.....#.#.
.#####.#.#.###.#.#.#B#.#####q#.#.
.....#.#.#.....b...T.#...#...#.#.
####.#.#.###########.#####.#.#.#.
.......#...................#b..#.
33 33
.......t.#...........#..........@
.#.##R####.#R##T#a##.#####.#.##q#
.#.........#...#...#.....#.#.#...
.###########.#.#.#.#####.#.###.#.
.#.........#.#...#.....#.#.#...#.
.#.#########.###a#####.#.#.#.###.
...#.....#...#.......#...t.#...#.
.###.###.#.###.###.#######.###.#.
.#...#.#...#...#.#...#.........#.
.#.###.#####.###.###.#.#########.
.#..!#...r.#.....#...#.#.......#.
.#####.#########.c.#.#.#.##A.#.#.
...#...#.......#.#.#.C.#A#...#.#.
##.###.#.###c#.#.#.#.#.###.###.#.
.#...#.......#...#.#.#.....#...#.
.###.##b####.#####.#.#######.###.
...#.....#...#...#.#.......#...#A
##.#####.#.#####.#.#.#########.#.
.......#.#...#...#.#.#.........#.
.#####.#.###.#.###.###.#########.
.#...#.#...#.#...#.....#.........
.#.#.#####.#.###.t##Q###.#B#####.
.#.#.....#.#.........#...S.#...#.
.sT###.###.#####.#####.#####.#.#.
.....#.#...#...#.#...#.#.....#.#.
######.#.###.#.###.#.#.#.####R.#.
.....#A#.#...#.....#.#...c.....#.
.###.#.#.#.#########.B.###.#####.
.#.....#...#.....#...#.#...#.#...
.###########.###.#.#####.###.#.##
.....#.s.....#.#.#.#.....#...#.#.
.###.#.#######.#.#.#.#####.#.#.#.
...#...........#.....#.....#.....
33 33
.#.......#.........#......s..#...
.#.#.b####.###.###.#####.###.#.##
...#.......#...#...#.....R.#.#..a
.#########.#.#q###.#.#####.#s#.#.
.#...#...#.#.#...#...#...#...#.#.
.#.###.#.#.#.#.#.#####.###.c####.
.#.#...#.#.#...#...#.#...#.......
.#.#.###.#######B#.#.#.#.#######.
...#...#..R.t..#...#.#.#.......#.
######.#######.#.###.#.###.#####.
..C....#.....q...#.....q.#...#...
.###.###################.###.#.##
...#.#...#...........#.#.#...#.#.
.#.###.#.#.#########.#.#.#.#.#.#.
.#.....#...#.#.......#.#.#.#.c...
.###########.#.#######.#.#.#####.
.#.....#.....#.......#...#.#.....
.#.#####.a##.#t####t.###.a.#.####
.#.........#.#.....#...#.#...#.b.
.#.#######.#.#.###.###.###c###.##
.#.#...#...#...#.....#...#...#...
.#.#.#.###.#####.#######.C##a###.
.#.#.#...#.#.a.#.#....!#...#.....
.###.###.###.#.#.#.#####.#.#####.
...#...#.....#...#.#.....#...#...
##.###.#.#######.#.#########.####
.#...#.#@s...#...#.#.......#.#...
.###.#.###.#.#.###.#.#####.#.#.#.
...#.#.....#.#.#...#...#...#.#.#.
.###.#######.###.#####.#.#Q#.#.#.
...#...#.....#...#....q#...#...#.
.#.###.#.###.#.#####.#####.#####.
.#.......#...#.......#...........
33 33
.................#.........#.....
.#q##R##.#######.#.#######.#.###.
...#...#...#...#...#...#...#.#.#.
####.#.###.#.#.#####.#.#.###.#.#.
.....#.....#.#.......#.#...#.#...
.#####R#####.#########c###.A.####
.#.........#.#...#.#...#...#.....
.#.#######.#.#.#.#.#.###.###.###.
.#...#...#.#.#.#...#...#.#...#s..
.###.#.#.#.#.#.###.###.#.#.###.##
...#.#.#.#.....#.#.#.#...#...#...
##.#.#.#########.Q.c.##C##c#.###.
...#...#...#...#...#...#...#.#...
.#######.#.#.###.###.#.#.#.#.#.#.
.........#.#.....#...#.t.#...#.#.
.#########.###.###############.#.
...#.#...#...#.......#.....#...#.
##.#.#.#.###.###C###.#.###.#.###.
.#.#...#...#...#.....r.#...#...#.
.#.#.###.S####.#.#####.###.###.#.
.#.#...#.#.....#.......#!#.....#.
.#.#.###.#.###.#########.#######.
...S.#...#.#...#.........#.#.....
.#####.#.#.###.#.#########.#.####
.#.....#.#...#.#...#.....#...#...
a#.#.###.###.#.###.###.###.###.#.
.#.#...#.#...#...#.#...#...#...#@
.#####.#.#.######T.#.###.#####.##
.#.....#q#.....#...#...#.....#...
.#.###########.#.###.#.#####.###.
.#...........#.#...#.#.#.....#...
.###########.#.###.a.#.#.#####.#.
......t...c..#.....#.#.........#.
33 33
...................#.............
.#################.#.#########.##
...#.A.....#...#...#.#B#.....#...
##.#.#.###.#.#.#.###.#.#.###.###.
...#...#.#...#.#.....#.#...#...#.
.a##.###.#####.#######.###.###.#.
...#...#.....#...........#...#...
##.###.#.#.#########.#.##S##.###.
...#...#.#.#...#...#.#.#...#.#.#.
.###.#####.#.#.T.#.R.###.#.#.#.B.
.#.#.#.....#.#...#.#.....#.#.#...
.#.#T#.###.#.#q###.#######.#.####
.#.#.#.#...#...#.#...#.....#.....
.#.#.#.#.#####.#.#C#.#.###.#####.
.#.....#..@#...#.#...#.#.#.#...#.
.###########.###.#.###.#.#.###.#.
...#...#...#.#...#.....#.#.#...#.
##.#.#.#.#.#.#r#.Q######.#.#.#.#.
.....#...#...#.#.........#...#.#.
.#T########T##.#####.#.###.####a.
...#.........#...#...#.#...#.....
.###.S#####T.###.#.#.###.###.###.
.#...#...#...#...#.#.#...#...#...
.#.###.#.#.#######.###.###.Q##.##
.#.#...#.#.......#.#...#.#.#tT...
.#.#.###.#######.#.#.###.#.#####.
.#.#...#.......#.#...#...#...#.#.
.#.###.#########.#.#####.###.#t#.
.#...#.....#.....#.........#.#.#.
R###.#####.#.###########.###.#.#.
...#!#...#.#...#...#...#.#...#.#R
##.###.#.#.###.#.#.#.#.###.###.Q.
.......#.....#...#...#.....#.....
33 33
.....#.....#.............S...#...
.##b.#####.#.#.###########.#.#.#.
...#...#...#.#.#...#.......#...#.
.#.###.#.#.#.#.#.#.#.###########.
.#.#.....#.#.#.#.#.r.#.#.......#.
.#.#####.###.#.#.#####.#.#####.#.
.#...#...#...#.#.#.....#.....#...
.###.#.###.###.#.#.#########.##s.
...#.#...#.#@#.#.#.Q...#Q..#.#.#.
.###.#####.#.#.#.#.#.#.#.#.#.#.#.
.#...#...#.#.#...#...#.#.#...#...
##.###.#.#.#.#####.###.#.#####.##
...#...#...#.......#...#.#...#...
.###.#r#####.#######.###.#.#.###.
.....#...#...#.#...#...#...#...#.
.#######.#.###.#.#.###.#######.##
.....#...#...#.#.#.#...#...#.#...
####.#.#.###.#.#.#.#.#.#S#.#.###.
...T.#.#...#...#.#...#...#...#.#.
.###.#.###.###.#.#####.#####.#.#.
.#...#.#...#...#...#.#.#...#...#.
.#.###.#####.#####.#.#.#.#.#####.
...#c......#.#...a.#...#.#.....#.
.###.#####.#.#.#.#.#####.#####.#.
.#...#...#.....#.#...#...#...#...
.#.###.#.###########.#.###.#.###.
.#...#.#.......#.....#...#.#.....
.#####.#######.#.#######.###.####
.....#...#.#.....a.....#...#.....
####.###.#.#.#####.###.#.#.######
...#.....#.#.#.#!..#...#.R.......
.#q#######.#.#.#####.###########.
...................#.............
33 33
.......#.....#.....#...#.........
.#####.#.#.#.#Q#.#.#.#.#.#######.
.#.....T.#.#...#.#...#.#.#.#.....
.##A##.###.###.#.#.#####.#.#.###.
.....#...#...#...#.#.....#.#.#...
.###.###.###.#R###.#.#####.#.###.
.#...#...#...#...#.#...#...#...#.
##.###.###.###.#.#.###.#.#####.##
...#.......#...#.#..C#.#.#...#...
.###########.#####.###.a.#.#.###.
.#...#..@#...#.....#...#...#.#...
.#C#.#.###.#.#.#####.#####s#.#.#.
.#.#.#.....#.#.#...#.B.....#.#.#.
.R.#.#######.#.#.###.###.#.#.#.q.
...#.......#.....A.......#.#.#.#.
.#########.#######.#######.#.#.##
.#.#.....#...#.....#...#.....#...
.#.#.#.#.###.#.#####.R.#####t###.
.#...#.#...#...#.....#.#.......#.
.#.###.###.#q###.#####.#.#####.#.
.#.#...#.#...#.#...#.....#...#.#.
.###.###.###.#R###.######t.s.#.#.
.#...#...........#.......#.#.#...
.#.###.#################.#.#.###.
...#.#...#.#...........#...#...#.
####.##S.#.#.##t######.###.###.#.
...#...#.#.#.....#...#...#c#...#.
.#.#.#.#.#.#####.#.#.###.###.###.
.#...#.#.#...#...#.#...#..!#.#.#.
.#######.#.#.#.###.###.#####.#.#.
.........#.#.#.#...#.#.#...#.#...
.##B########.#.#.###.#.#.#.#.#.##
.............#...#.......#...#...
