abcdefghijklmnopqrstuvwxyz-=[];/
ABCDEFGHIJKLMNOPQRSTUVWXYZ_+{}:?
OOOOOOOOOOOOOOOOCCCCCCCCCCCCCCCC
7
29 29
.....#.....#.......#.........
.###.#.###.#.#####.#.#######.
...#.#.#...#.#...#.#.....#.#.
.#.#.#.#.###.#.###.#####.#.#.
.#.#...#.#...#...........#...
.#.#####.###.#C###########.##
.#.....#...#.#c#...#.....Q...
.#####.###.#.###.#.###.#.###.
.#...#...#.#.#...#...#.#...#.
.#.#.#.#.#.A.#.#####.#.##S##.
.#.#.#.#.#...#.#.....#.......
.#.#.#.#.###.#.#.#####.###c##
.#.#.#.#.#...#.#...#.........
##.#.###.#####.###.#########.
...#.....#.....c.#.....#...#.
.#######.#.#####.#####.#.#.#.
.#...#...#.s@......#...t.#.#.
.#.#.#.###.#######.#.#.#.#.#.
...#.#.#.#...#.....#.#.#.#.#.
####.#.#.###.#.###.#.#.#.#.##
...#.#...#...#...#.#.#.#.#...
.#.#.S.###.#####.t##.###.###.
.#...#.#...#...#...#.#...#...
.#######.###.#.###.#.#.##A.#.
.............#.....#...#...#.
.#a############c########.###.
.#.....R.....#.....#.....#...
.###.###.###.#.###.#.#####.##
.....#!..#.....#.....#.......
29 29
.#.......#...#.............#.
.#.#####.###.#.#########.#.#.
.#.#...#..!#...#.........#.#.
.#.###.#######.#.###r#####.#.
.#.......#...#.#.#......@#...
.#######.#.#.###.#.#.###sQ##.
.....#...#.#.....#.#.#.....#.
.###.q.###.####c##.###.##t.S.
.#...#.#...#.........#.#.#.#.
.#####.#.###.#######.#.#.#.#.
.#...#.#.#...#.......#...#...
.s.#.#.r.#####.B##R#####.####
...#...#.#.....#.........#...
.#######.#.###.#.#########.#.
.#.......#.#s..#...#.....#.#.
.##a.#####.#######.###.#.###.
...#.#.....#.....#.#...#...#.
##.t.###.#.#.#.S.#.#.Q####.#.
.#.#...#.#...#.#.#...#.#...#.
.#.#.#.###.###.#######.#.###.
...#.S...#.#...#...#...#...#.
.#s#.###.###.#.#.#.#.#.###.#.
...#.#.#...#.#.#.#...#...#.r.
##.#.#.c##.#.###.#####.###.#.
...#...#...#.#...#.....#...#.
.#####.#.###.#.###.#.###.###.
...#...#.#.....#...#.#...#...
##.#####.#.#####.#####.#####.
.........#.....T.............
29 29
.........#.........#.....#...
.###.###.#.###.###.#.###.#.#.
...#.#...#.#.#...#.#.#.....#.
##.#.###.#.#.###.#.#.#######R
...#...#.#...#...#...#.....#.
.#####.#####.#.#######.###.#.
.....c.......#...#.....#...A.
####.###########.#.#####.#s##
.#...#...#...a.#...#...#.....
.#.###.###.###.###.#.#.#####.
.c.#.....#.#.....#...#.....#.
.#.#.###.#.#####.#######.###.
...#...#.#.....#...#.#...#...
.#######.#####.###.#.#.##R.#Q
.........#...#...#.#.#.#...#.
########.#.#.###.#.#.#.#.c#q.
.......#...#.#...#.#...#.#...
C###.#####S#.#.##Q.#.###.###.
...#.........#.#.#.#...#...#.
##.###########.s.#.#####.#.##
...#.........#.#.#.....#.#...
.##B.#####.###.#.B#a##.#####.
.....#@....#...#.....#...#...
####.#######.#######.###.#.#.
.....#.....#.....#.....#...#.
.#####.###.#####.#.#########.
.#.A!#.#.#.#.q.#.#.....#.....
.#.#.r.#.#.#.#.#.#.###.#.####
...#...#.....#...#...#.......
29 29
...#.................#.....#.
.#.#####.#############.#.#.#.
.#.....#.........#.....#.#.#.
.a####.###.#####.#.#####.#.#.
.#...#...#@#.....#...#...#.#.
.#.#.###.###.#####.###.###.#.
.#.#...#...s...#...#...#.....
.#.###.###.###.#.###.########
...#...#.#...#...#.#.........
####.###.###.#.###.#########.
.....#...#...#.#.......#.....
.#####.#.#.###.#.#.#####.###.
...#...#.#.#.....#s#...#...#.
##.#R#.###.#######.#.T.###.##
.#.#.#.#...#.....#.#.#...#...
.#.#C#.#.###.###.###.###.###.
...#.#.#...#...#.....#...#...
.#####.###.#.#.#######.###.#.
...#.....#!#.#.#.....#.#...#.
##.#.#######.#.###.###.#.#.##
...#b#.......#...#.....#.#...
.###.#.#########.###.#######.
...#..r....#...#...#.........
##.#.#####.#.#.###.#########.
...#.#...#.#.#.#...#...#...#.
.#####.#.#.#.#.#.###.#.###.#.
.#..c#.#.#.#.#.#...#.#.....#.
.#.#.#.#.###.#.##q.#.#######.
...#...#.....#.....#........q
29 29
.....#.....#...#.....#.....#.
.#tB.#.###.#.#.###.#.#.###.#.
.#.#...#...#.#.#...#.#...#...
##.#S#####.#.#R#.###.#.#.#q##
...#.....#...#...#B..#@#.....
.###.###.#########.#######.#.
...#...#...#.......#.....#bb.
##.###.###.#.#########.#.###.
...#...#.#.t.....#...#.#...#.
.#.#.A##.#.#####.#.#.#.###.#.
.#.#.....#.....#.S.#...#.#...
.######c.#####.#########.###.
s#...r.#.#.....#.......#.#...
.#.#.#.#.#.#######.###.#.#.##
...b.#.#.#...#...#A..#...#.#.
####.#.#.###.#.#.#.#.#.###.#.
.....#.#...#...#.#.#.#.#...#.
.#####.###.#####.#.#.###.###.
.....#...C.#...#.#.#.S.#.#...
####.#####.#.#.#.#####.#.#.#.
...#...#...#!#...#.....#...#.
##.###.#.#########.B.#######.
.....#...#...#.....#.#t....#.
.###.#####.#.#.###.###.#.#.#.
...#...#...#.#...#.#...#.#.#.
.#.###.#.#.#####.#.#.###.#.#.
.#.#...#.#.....#.R.S.#...#.#.
.#.#####.###.###.#####.#####.
.#.........#.........#.......
29 29
.#.......C.#.........#.......
.#.#S###.###.#####.#.#####.#.
.#...#.#.....#.....#.....#.#.
.###.#.#######.#########.###.
...#.#.......#.#C......#...#a
.#.C.#.#.#####.#####.#####.#.
.#.#.#.#.#.....#...#.....#...
.#.#.###.#.###a#.#.###.#.###S
.#@#.....#A......#...#.#.....
.###.###########.###.###.####
.....#b........#...#...#.....
.#####.#######.###.###.##b#bT
.....#...#...#...#.#.#.#...#.
##.#####.#.#.###.#.#.#.###.#.
...#.....#.#.#...#.#.#...#...
####.#####.###.###.#.###.#.##
.....#.....#...#...S.#...#...
.#####.###.#.##C####.#.#####.
.....A.#..t#.#.....#.#.#...#.
.###.#.#.###.#.###.###.###.#.
.#...#.#...#...#.#.....#...#.
.#.###.#########.#######.#.#.
.#.#.#...#...#.........#.#.#.
.#.#.#.#.#.#.#.###.###.#.###.
.#.#...#.#.#...#.#...#...#...
.#.#####.#.#####.###.##r##.##
.C.....#..t.......T#...c...#.
.#####.#R#########.###.#.###.
.....#....!#........A#.......
29 29
.......#...#...............C.
####.#.#.#.###.#####.###.T.#.
.....#.#.#...sB#...#...#.#...
.#####.#.###.###.#.###.#.###.
.....#.#...#...#.#.#.#.#.#...
.###.#####.###.#.#.#.#.#.###.
.c.#.....#...#...#.#C#.#...#r
.B.###.#####.#####.#.#.###.#.
.#..R#.....#Q....#!#...#...#.
.##r.####R.#####.#####.#.###.
.....#...#.....#.....#.#...#.
####.#.#.#####.#####.#####.#.
..@b.#.#.....#.s...#.#.....#.
.###.#.q####.#.#####.#a#####.
...#.#..A..#.#.......#...s.#.
##.#.#######.#########.#.#.#.
...#.....#...#.......#.#.#...
.#.#####.#.#.#.###.#.###.#Q##
.#.#...#...#.#.#...#...#.....
.#.###.#####.###.#####.#####.
.#.#..T....#...#...#...#...#.
.#.#.###.#####.###.#.###.#.#.
.#...#...#...#.....#...#.#.#.
.##Q.#####.#.#########.#.#.#.
.#.#.#...#.#.#.......#...#...
.#.#.#.#.#.A.#.###.#.#######.
.#...#.#.#.#...#.#.#.#.......
.#####.#.#.#####.T.###.#####S
.......#.........#...........
