abcdefghijklmnopqrstuvwxyz-=[];/
ABCDEFGHIJKLMNOPQRSTUVWXYZ_+{}:?
OOOOOOOOOOOOOOOOCCCCCCCCCCCCCCCC
5
17 17
!..........#.....
##########.#.#Q#.
.......#.#.#.#...
.###.#.#.#.#.#.##
...#.#..B#...#Q#.
##.r.###.#####.#.
.#.#.A.c.....r...
.#.###.#########.
...#.t.......#...
.###.#######.#b##
.#.........#.#.#.
.#.######t.#.#.#.
.#.#.......c.#.#.
.#.#.#####TC.#.#.
.#.#.#.....R.c...
.###.#.#####.###.
.....#....@#...c.
17 17
...........#.....
.#####.#####.##Q.
.#...#...#...#.#.
.#.#.#.#.#.###.#.
.#.#.#.#.#...#.#.
##.#.###.###.#.#.
...#.s.#S..#.#...
.#####.#.#.#.#.##
...#.....#.#.A...
.#.#####B#.#.###.
.#.....#...#..!#.
.q####.#.#######.
.....T.#.#.......
##.###.###.######
@A.#...#...S.....
.#.#.###.#####.#.
...#........r..#.
17 17
...#...#.........
.###.#.#.#####.#.
.....#.#...#...#T
.#####.###.#.####
.T...#.....#....!
.###.#######c####
.......#.........
###r##.#.#######.
.....#.#.#...#...
.###.#.#.#.#.s.##
.#.#.#.#.#.#.#...
.#.#.#.#.#.#.###.
.#.#...#@#.#...#.
.#.#######.###.#.
.#.........#.#.#.
.#####.#####.#.#.
.......#.........
17 17
...#.......#.....
.#.#.#####.#.###.
.#...#...#.#..q#!
.#B#####.#.###.##
.#.......#.#...#.
.###.##T##.#.t##.
...#....t..#...#.
##C#.#########.#.
...#...#.....#.a.
.#######.###.###.
.#.....#.#.#...#.
.#.###.#.#.#.###.
....@#.#.#.#...#.
######.#.#.###.#.
.......#.#...t.#.
.#######.#.#.#.#.
...........r.#...
17 17
.............#Q..
##.#########.#.#.
!#.#.......#...#.
.#.#.#####.#.###.
.#.#...#...Ta#...
.#####.#.#####.##
.......#.....#..r
##########r#.###.
@#....B....#...#.
.#.#.#########.#.
.#.#.........r.#.
.#.#######.#.#.#.
.#...#...#.#.#...
.###.#.#.#.#####.
...#.#.#.#R..#...
.###.#.#.###.#.##
.......#...#.....
