abcdefghijklmnopqrstuvwxyz-=[];/
ABCDEFGHIJKLMNOPQRSTUVWXYZ_+{}:?
OOOOOOOOOOOOOOOOCCCCCCCCCCCCCCCC
7
13 13
....c#.......
.#.#.###.####
.#.#.....#...
.#.#######.#.
.#......Q..#.
.###########.
...#...#!....
##.#.#B######
...#.......#@
.#####.###.#.
.#...#.#.#.#.
.#.#.#.#.#.#.
...#...#.....
13 13
...#.....#...
.###.###.#.#.
...#...#...#!
##.###.######
.....#.#...#.
.#####.#.#.#.
...#...#.#...
##.#.###.##b.
...#...#.#.#.
.#####.#.#.#.
.#...#.#.#...
.#.#.#.#.#.##
...#.....#..@
13 13
.....#.......
.###.#.###.#.
...#.#.#...#.
##.#.#.#.###.
...#@#.#...#.
.##Q##.###.#S
S#.....#.#.#.
.#.##T##.#.##
...#.....r...
.###.#####.#.
.#...#!..#.#.
.#.#.###.###.
...#...#a....
13 13
..r#.b.....#@
.###.#####.#.
.....#...#.#.
.#####.###.#.
...#...#q..#.
##.#.###.###.
.....#...#...
.#####.###.##
...#...#.q.C.
##.#.######C.
.#.#!S.....#.
.#.a##.###.#.
.......#....B
13 13
...#...#.....
.#.#.#.#####.
.#...#...s...
.###########.
.#...#...#...
.#.#.#.#.#.##
...#.#.#.#.#.
####.#.#.#.#.
...#...#!#...
.#T#########.
.#...#.....#.
.#.###.###.#.
@#.......#...
13 13
.............
######.#####.
.......#...T.
.#######.###.
.C.....#.....
.#.T##.#.###c
.#t..#.#.#...
.###.###.#.#.
..!#.....#@#.
#s##.#######.
..R..s.....#.
.##B####.B.#.
.........#...
13 13
.......#@....
##.###.#####.
...#t#....c#.
.###.#####.#.
...#.....#.#.
##.###.#.#.#.
...#!#.#...#.
.###.#.#####.
.....#.#.....
######.#.###.
.......#.#...
.#a#####.#.##
A........#...
