abcdefghijklmnopqrstuvwxyz-=[];/
ABCDEFGHIJKLMNOPQRSTUVWXYZ_+{}:?
OOOOOOOOOOOOOOOOCCCCCCCCCCCCCCCC
3
17 17
.......#.....R...
.#######.#.#####.
.....#...#...#...
.###.#.#####.#.##
.#.#...#...#.#...
.#.#####.#.#.####
t......#.#.#.S...
######.#.#T#####.
....@#...#...#...
.#q#####.#####.#.
.........#.....#.
S#########.#####.
.........#Q#...#.
.#C#####.#.t.###.
..!#...#...#.#...
####.##r##c#.#.##
.................
17 17
...#.............
.#C#.###########.
.#.#.....#...b.#.
.#.#####A####B.#.
.#.#...a.......#.
.#.#.#.#######.#.
.#.#.#...B.....#.
.#.#.#########.#.
@#.#.#.......#.#.
##.#.#.####C.T##.
...#.#.#..Q#...#.
.###.#.###.###.#.
.#...#.#...#.#...
.#.###.#.#.#.###.
...#!#.#.#.....#.
.###.#.#.#######.
...#...#........r
17 17
.#.......#.......
c#.#####.#.#####.
.#q....#...#@..#.
.#####.#######.#.
.....#..!#.....#.
.#########.#####.
.#...#...#.....a.
.#c#.#.#.#.###t##
...#.#.#.#..s#...
.###.#.#.###.##q.
.#.#...#...#.....
.#.#######.###t#.
...#...........#R
##.#.#########.#.
.#.#...#...#...#.
.#.###.#.#.#####.
.....#...#.......
