abcdefghijklmnopqrstuvwxyz-=[];/
ABCDEFGHIJKLMNOPQRSTUVWXYZ_+{}:?
OOOOOOOOOOOOOOOOCCCCCCCCCCCCCCCC
7
29 29
.........#.........#......r..
.a###R##.#.###.###S#.#.#####.
.#.....#.#.#.#.#...#.#.#...#.
.#.###.#.#.#.#.#.###.#.#.#.##
...#...#.#.#.#.#.c...#...#...
####.###.#.#.#.#.###########.
...#...#.....#.#.#...........
.#.#####.#####.#.#.#########.
.#.#...#...#...#...#...#...#.
.#.#.#.#####.#####t###.a.#.R.
.#...#...#...#....C....#.#.#.
.#######.b.###.#.#######.#.#.
.#...#.#!#.#...#.#.......#...
.#.#.#.###.#.#####.######s###
.#.#...#...#.....#.#...#.....
.#.###.#.#######.#.#.#.#.###.
.#.#...S...#...#.....#.#.#...
.#.#.#####.#.#.#######.###.##
...#.....#.#.#...#...B...#...
########.#.#.###.#.S.###.#.#.
.......#.#...#...S.#.....#.#.
.#######.#####.###.#########.
.#.....#.......#...#.......#.
.#.###.#########.###.#####.#.
.#...#...#.......#...#...#.#.
.###.#.###.#######.###.#.#.#.
.#...#.#...#@......#.#.#.#.#.
.#.###.#.#####.#####.#.#.#.#.
.....#.........#.......#.....
29 29
.#...#..r..#...............#.
.#.#.#.###.#.#####.#######.#.
Q#.#..a..#..a....#.....r.....
.#.Aq#####.#########.#.#####.
.....#...#.#.......#A#...#.#.
.#####.#.###.#####.#.###.#.#.
C#...#.#.....#...#.#.#...#.#.
.#.#.#.#######R#.#.###.###.#.
.#.#.#.#...#...#.#.....#.#...
##.#.#.#.#.#.###########.#.##
...#...#.#.#...#.......#...#.
.#######.#.c.s.#.#.###.#.###.
.....#...#.#.#...#.#...#.#...
.###.#.#.#.#######.####c.#.#R
.#...#.#.#.........#.....#...
##.###.#.#####.#####.#######.
...#.#.#.....#.#...#.#.......
.###.#.#####.###.#.#.###.####
.#.#...#...#.....a.....#.....
.#.#.###.#############.#####.
.#C......#.....#..!t.#.......
.###q#####.##r.#.###.#######.
.#.......#...#...#.#.......#.
.#.#####.###.#####.#.#####.#.
.#.#.#.....#.s.....#.....#...
.#.#.#.###.#.#.#.#.#####.####
...#.#...#.#.#.#.#.....#.....
.###.###.###.#.#.###########.
.......#.....#@#........C....
29 29
.....#.#..Q#..C....#...#.....
c#.#.#.#.#.#.###.#.#.#.###.##
...#q..#.#.....#.#...#...#...
.##C##.#.#######.######a.###.
.#.....#...#.#...#.....#.....
.#.#######.#.#.###.#.#.####a.
.#.#.....#.#.r...#@#.#.#.....
.###.#.#.R.#.###.###.#.#.#T##
.....#.#.#.#...#...#.#.#.#...
.#####.#.#.#.#.###.#.C##.#.#.
Q#.....#.#.#.#.#...#...#.#.#.
.#.#######.###.#.###.#.#.###.
.#....T........#.#...#...#...
.#########.#####.#.#######.##
....t#..!#.#...#.#..b#.....t.
.#####.#####.#.#.###.###.###.
.#...#...#...#...#.#...#.#...
.#.#.###.#.#######.###.###.##
.#.#...#.#.#.........#...#...
##.###.#.#.#.#######.###.##B.
...#.#.#.#.#.#.....#...#.....
.###.#.#.#.#.#.###.#.#######.
.#...#.#.#.#...#.#.#....A....
.#.###.#.#.#####.#.####Q#####
.#.#...#.#...#.....#.........
.#.#.##q.###.#.#########.###.
.#.#.....#...#...#.....#.#...
.#.#######.#####.#.###.#.#.##
...........#.......#.....#...
29 29
.....B.............#...#.....
.###.#.#########.###.#.#.#.#.
...#.#.#.#.....#.....#...t.#.
####.#.#.#.###.#.#########.#.
.....#.#.#!#...#.#......qq.#.
.#####.#.###.####r.#####.#.##
.....#...#.#.......#...A.#...
####.###.#.####q####.#.T.#q#.
...#...#..s#.......#.#...#.#.
.#.#.#.###.#####.###.#####.#.
.#...#...r.......#...#.....#.
.#####.#######.###.#########.
.....#.#.....#.#...#.....#...
.###.###.#.###.#.###.##t.#.##
.#.#.....#...#.#.#...#.#...#.
.#.#########.#.#.#.###.#####.
.....#.....#.#.#...#.....#...
##.###.###.#.#.#####.#.###.#.
...#...#t....#.#@#...#...#.#.
.###.###.#####.#.#.#####.#.#.
.#.#.#.....#...#...#.....#.#.
.#.#.#######.###.###.#.#q#.#.
...#.......#...#.#...#.#...#.
##.#######.###.#.#.#####.###.
...#...#.....#.#.#.........#.
.#####.#.###.#.#######.#####.
.....#.#...#.#...#...#.#.....
####.#.###.#####.#.#.###.###.
.........#.........#.....#...
29 29
.#T............#.............
.#.###.#########.##q###A####.
.#.#.#...#.......#.........#.
.#.#.###.#.#######.#######.#.
.#.....#.#.#.....#.#.......#.
.#####.#.#.#.#.###.#.#######.
.....#.#.#...#.#...#.#...#...
####.#.#.#####.#.###.c.#.#.#.
.....#.#.......#.#...#.#...#.
.###.#.#########.c##.#######.
...#.b.........#...C.....#...
##.#####.#####.###.###s#.#.#.
...#.....#...#...#...#.....#.
.###.R####.#.###.###.#######.
.....#.....#...#.#.#.#...#...
.#####.#.#####.#.#.#.#.#.###.
.#...#.#.#...#.#...#...#...#.
##.#.#.###.#.#.###.#######.#.
...#...#...#.#.#.C.......#.#.
.###c##s.###.#.#########.#.##
.......#...#.#.........#@#...
######.###.#.#########.#B###.
.........#.#.........#.....#.
.#########.#########.###b#.#.
...#.....#.#...#..!#.#.....#.
.#.#.###.#r#.#.#.###.#.#####.
.#.#.#.#.#.#.#...#...#...#...
.#.#.#.#.#.#.#######.###.#.#.
.#.....#...#.........T.....#.
29 29
..R#...#...#.......#.........
.###.#.#.#.#.#####.#.#######.
.#...#...#.#...#...#...#...#@
.#.#######.###.#.#####.#.#.##
.#...#.#...#...#.......#.#c..
.###.#.#.###.###########.###.
.......#.#.....#...#.....#...
.#######.#.###.#.#.#.#####.#.
Q#.#!..#.#...#...#.#.#.#...#.
.#.###.#.###C#####.#.#.#.####
.....#.#...#.....#.#...#.....
##t#.#.#.#.q####.#.###.#####.
...#.#.r.#.#.....t.........#.
.#.#.#.###.#.#########R#b###.
.#.#.#.#...#.#..S..#.........
.###.#.#.r##a#.#.#.#.#######.
...#.#...C...#.#.#.#.......#t
.#.#.#######.###.#.#######.Q#
.C.#.#.....s...b.#......c#...
.#.#.#.##s.###.C.#######.###.
.#...#.#...#.#.#...#...#...#.
.#####.#.#s#.#.#.#B#.#.#####.
...#...#.#.#...#.#C#.#.......
##.a.###.#.#.#####.#.########
.#...#.#.#...#.....#.........
.#####.#.A.#####.#########.#.
...#...#.#.......#...#...#.#.
.###.#.#.#########.s.#.#.###.
.....#.............#...#.....
29 29
...#...#.......#.............
.###.#.#.#######.#.#.########
.#!..#.#..B....#.#.#.#..A....
.#####.###.###.#.#.###.#####.
.....s...#...A...#.....#...#.
.#.####C.###.#####.#####.###.
.#.......#...#...#...#...#...
.###########.#.#q###.#r#.#C#.
.#.........#.#.#.#....C#.#.#.
R#.#####.A.###.#.#B###.###.#.
.#.#...#.#...#.#.....#.r...#.
.#.###.#.###.#.#####.q.#.####
.#.....#.#.....#...#.#c#.....
.#######.#########.#.##S####.
.#.....#.....#.....#.........
.#.###.#####T#.#.###########.
...#.#.a...t.#.C.......c.....
####.#####.#.######a######.##
.....#.....#...#.........#...
.###.#.#######.#.#######.###.
...#...#.....#...#.....#...#.
##.#####.#.#.###.#.#######.##
.#...#...#.#...#...#.....#...
.###.#.###.###.#.###.###.#.#.
...#.#.#@#B..#.q.#...t.#.#.#.
##.#.#.#.###.#.###.###.#.#b#.
...#.#...#...#.....#.b.#...#.
.###.#####.#########q#####.#.
...........#..........a......
