abcdefghijklmnopqrstuvwxyz-=[];/
ABCDEFGHIJKLMNOPQRSTUVWXYZ_+{}:?
OOOOOOOOOOOOOOOOCCCCCCCCCCCCCCCC
3
17 17
.....#.........#A
.###.r####.###.#.
...#.#..!#.#.....
##.b.#.###.######
.#.#...#.........
.b.#t###.#######.
.#...#...C...#@#.
.##t.#######.#.#.
.....#.....#...#.
.#####.###.#####.
.#.#s....#.......
.#.#.#a#.#####c#.
.#.....#.#.#.....
.#######.#.#.####
.......#.#...#...
######.#.#.#####.
.........#......A
17 17
...#.........#...
.#.#.####q##r#.##
.#.#.#.#.....#...
.#.#.#.#.c##.###.
R#.#...#..q#.#!#.
.#####.###.###.#a
......R#.#.....#.
.###s###.#######.
a....#.....b.....
####.###.#######.
...#.....#.#.S.#.
##.#######t#.#.#.
.......#@#...#.#.
.#####.#.#.###.#.
T#...#...#.#...#.
.#.#.#####B#.###.
...#.......#.....
17 17
.#...........#!#.
.#.#######.#.#.#.
.#.#.....#.#.#...
.#.#.#.###.#.###.
.#...#.#...#.#.#.
.#####.#.###.#.#.
...#...#.#.t.c.#.
.###.###.#b#####.
...t.#...#.......
.#####.###.######
...#...#...#.....
##.#.###.###.###.
...#...#.CQ..#.#.
.#####.#.#.###.#.
.#...#A#...#...#.
.#.#.#.#####.#.#.
...#@#.......#...
