abcdefghijklmnopqrstuvwxyz-=[];/
ABCDEFGHIJKLMNOPQRSTUVWXYZ_+{}:?
OOOOOOOOOOOOOOOOCCCCCCCCCCCCCCCC
7
13 13
.t.#.....#...
.#.#.#.#.#.#.
.#.#.#.#...#.
.#.#.#.#####.
.#...#...#...
.#######.####
.#.....#.....
.#.#######.#.
.#...#...#r#a
.#.#.#.#.#.#.
.#@a.#.b.#.#.
.###.#.#.##t.
.....#!#.....
13 13
.........#...
.#####.#.#.#.
.#...#.#.#.#.
.#.#.#.#.#.#.
.#.#...#...#.
.#.#########.
.#.#!#.#.....
.#.#.#.#.#t##
.#.#.#.#.#...
##.#.#.#.#.#.
...t.#.#.#.#.
.###.#.#.#.#.
.....#.....#@
13 13
.......#...#.
.#####.#.#.#.
.#...C...#...
.#.########C.
.#.#...#...#@
.###.#.#.#.##
.#...#.#.#...
.#.###.#.###.
.#...#...#...
.###.#####.#.
...#...#.#.#.
.#####.#.#.#.
.........#!#.
13 13
...#.........
.#.#.###.###.
@#.....#...#A
######.###.##
!....#...#...
####.###.#s#.
...#.#.....#.
.###.#######.
.....#.......
.#####.#####.
.#...#.#...#.
.#.#.#.#.###.
...#...#.....
13 13
.....#.......
##.#.#######.
...#........B
.###########.
.....#...#...
####.#.#.#.##
...#...#.#...
a#.#####.###.
..t#!..#.#...
.#####.#.#.##
.....#q..#.#@
.###.#####.#.
...#.........
13 13
...#..R#....Q
.###.#.#.#.##
..b..#...#...
.########c##.
.#....@#.....
.#.#####.####
.#T#.Q...#!#.
.#.#.#####.#.
...#.......#.
##.#########.
.#.#.....#...
.#.###.#.###.
.......#.....
13 13
.#..S........
.#.#######.#C
.......#.c.#.
.#####.#.Q##.
.#..!#@#.#r#.
##.#####.#.#.
...#...#.#...
.###r#.#.S.##
.#...#.#.#...
.###.#.#.###.
.#..A#.#...#.
.#.###.###.#.
...#.....s.#.
