abcdefghijklmnopqrstuvwxyz-=[];/
ABCDEFGHIJKLMNOPQRSTUVWXYZ_+{}:?
OOOOOOOOOOOOOOOOCCCCCCCCCCCCCCCC
7
17 17
...#...Q.#Q......
.###.###.#.#.####
....CS.#.#.#.....
.###b###.#.###A#.
.u.....#...#.#...
.#.###.#.###.#.#.
.#.#.d.#.....#.#.
.#.###.Q####.#.##
.#...A.S...#Q#...
.###.#####.#.###.
.#!#...#e..#.#...
.#.###.#.#####.#.
.#.#...#..u....#.
##.#.########t##.
...#.#..@#.....#.
q###.#.#B#.###.#.
...r.#.......#...
17 17
.#...#.........#@
.t.#.#.#D###.#.a.
...#R....#...C...
.#######.#.#####.
.#..!#b..#.#.....
##.###.###.######
...#.#.#.VV......
.###.#.#.#######.
.#...#....R#....T
.#.#.##S##.#.####
.#EC.......#.....
.###.VB##c#C####.
...#...#...S.....
##.#####.#.e.###.
...#...R.#.#...#.
.###.#####.###.#.
.....#....c....#.
17 17
...........#.....
B#######.###.E##.
.#.....#.....#.#.
.#.#.#####.###.#.
.#.#.#...#.....#.
.C.#.#.#.#######.
.C.#.#.#.........
####.#.##########
@....#.#.........
######.#.######b.
!....#.......#.#A
####.#######.#.#.
...#...#.....v.#.
.#####.#s#.###.#.
.....#...#.....#.
.#.#####.#######.
.#...............
17 17
.............#...
##.#.#######.#.#.
.U.#.#.....#...#.
.###.#.###.#####D
...#.#.#...#.....
##.#.#.#.###.####
...#.#.#.#@......
.###.#.#.########
...#.#!#.#.......
.#.#.###.#.#####.
.#.D..d#.#.#.....
v#.#T#.#.#.#.####
.#...#.#...#.#...
####.#.##a##.#.#.
.....#...#...#.#.
.######u##.####R.
.................
17 17
.........#..V..V.
.#.#####.#.#####.
.#.#...#.#D#...#.
.#.#.#.#.#.#.Q.#.
.#.#.#.#.#...#.#.
.###.#.#.###Q###.
.#...#.#.........
.#.###.#########.
.#.#.#.#.........
.#.#.#.###.######
.#.b.#..s#...#..E
.###.###.###.#.#.
.......#...#.#.#.
.##r##.###.#.#.#.
.#...#...#.#.#@#.
##.#.#####.#.###.
!..#.......#.....
17 17
.#a.......C......
.#.#q###########.
.....#!..#.......
###C####a#.######
...#.....#...#...
.#.#.##s##.#.#.#.
.#...#...#.#Q..t.
.#######.#.#####.
.#.....#...#...#.
.###.#.#####.#.#.
.#...#.....t.#.#.
.#.#######.#.#Ba.
.#.....#...#.#.#.
.#####.#.###.#.#.
.......#...#.#.#.
########u#.#.#.#.
@............#...
17 17
.......#....V....
####.###.#######.
.....a...#.....#.
.###B#.B##.###.#.
.....u.#.#...#...
###b.#.#.###.####
..E.S#.....#d#..u
.#########.#.#.#.
.....#...#.#...#.
####.#.#.#b#####.
...#...#.......#.
.#.###.#######.#.
.#..!#.#.....#.#.
Q#####.#.###.E##.
...C...#.#@#.#...
##.#####.#.#.#.#.
.....t...#.....#.
