abcdefghijklmnopqrstuvwxyz-=[];/
ABCDEFGHIJKLMNOPQRSTUVWXYZ_+{}:?
OOOOOOOOOOOOOOOOCCCCCCCCCCCCCCCC
7
9 9
@........
##.#.###.
!#.#c..#.
.#####.#.
...#...#.
##.#.####
...#.....
.#######.
..a......
9 9
@#.......
.#.#####.
.#.Q.#...
.#.###.##
...#!#...
####.#.#.
.....#.#.
.#######A
.........
9 9
.S.#.....
.#.C.###.
C#.#!#...
.#.###.##
.#..B#...
.#.#.###.
.#.#a#...
.#b###Q##
@#.......
9 9
...#.....
.#.#.#.##
.#...#q.!
.########
.....#...
###B.###.
.T.#.....
.#.#####.
@#.......
9 9
.#!..#...
.###.#.#.
.#...#.#.
.#.###.#.
.#.#...#@
.#.#.#B##
...c.#...
.#######.
......R..
9 9
.........
.#####.#.
.#...#.#.
##.#.###R
...#...#.
.#####.#.
.#!..#...
.###.###.
....r#@..
9 9
@........
##.###.#B
!#...#.#.
.#####.#.
..s..t.#.
########.
.....#...
.#.###.#t
.#.......
