abcdefghijklmnopqrstuvwxyz-=[];/
ABCDEFGHIJKLMNOPQRSTUVWXYZ_+{}:?
OOOOOOOOOOOOOOOOCCCCCCCCCCCCCCCC
7
17 17
...#.....#.......
.###.#.###.#####.
.....#.#.......#.
.Q####.#.#######.
.#.....#.#.#.....
.#.###.#.#.#.####
.#...#.#.#.#.#...
.###.###.#.#.#.#.
.#.#.......#...#.
.#.#########.###.
...#.#!....#.#...
##.#.#####.###.##
...#.....#...#...
.b##.###.###.#.#.
.#.B.R@#.#.#.#.#.
.###.#.#.#.#.###.
.....#.....#.....
17 17
.......#...#.....
.###.#.#.#.###.#.
.#...#...#.....#.
##.#############.
...#.......#.....
.###.#.###.#.####
.#!#.#B#@#.#.....
.#.#.#.#.#.#####.
.#.#.#.#...#...#.
.#.#.#.#.###.#.#.
...#.#.#...#.#...
####.#.#####.####
.....#.#.....#...
.#####.#.#####.#.
.....#.#.#.....#.
####.#.#.#######.
.....#...........
17 17
...#......S#.....
.#.#.#####.###.#.
.#...#!..#.....#@
.###.###.###s####
.#.b...#.#...#...
.#####.#.#.#.#.#.
...#...#.#.#...B.
.#.#####.#.#####.
.#...#...#.#.....
####.#.###.#.####
...#.#.#...#.#...
.#.#.#.#.###.#S#.
.#...#.#.#.#.....
.##s.#.#.#.#####.
...#.#...#.#..Q#.
.#.#######.#.#.#.
.A...........#...
17 17
.....#...........
##.#.###.#######.
...#..s#.#.......
.#####.###.#####.
...#...#..b#...#.
.#.###.#.#####.#.
.#...#.#.#...#R..
.###.#.#.#.#.####
.#...#...#.#.#...
.#.#######.#.#.#.
.#.......#.#...#.
.#######.A.#####.
.#...#...#...Q.#.
.#.#.#.###.#####.
...#.#.#...#!..#.
####.#.#.#####.#.
@....#.......#...
17 17
.......q.....#..a
.#q#########.#.#.
....!#.....#...#.
######.###.#####.
A......#@#.#...#.
.#.#####.#.#.###.
.#.....#.#...#...
.#####.#.###.#.##
.#.....#.#...#.#.
.#.#####.#.###.#.
.#.#...#.#.#.#...
##.#.#.#.#.#.###.
...#.#.#...#.#...
.###.b.###.#.#.##
.....#...#...#...
.#######.#######.
.......#.......r.
17 17
...#..!#...#.....
.###.#####.#.###.
.#...#...#...#...
.#.###.#.###.#.#.
...#...#...#.#.#.
.S##.####b.###.#.
...#...#.#...#q#.
##.###.#.###.#a##
.#.....#...#.#...
.#######.#.#.###.
.....#...#.#.....
.#.###.###.B####.
.#.....#.......#.
.#######.#####.#.
.#@..#...#...s.#.
.###.#.###.#.###.
.....#.....#.....
17 17
...........a.....
.#######.###.#.##
.#!....#.....#...
.#####.#.#######A
.#...#.#.......#.
.#.###.#######.#.
...#...#...#...#.
##.#.###.#.###.#.
...#...#.#...#.#.
.#####.#.###.###.
.....#...#.#.....
####.#####.######
.....#@..........
.###############.
.#.............#.
.#.###########.#.
...#.............
