abcdefghijklmnopqrstuvwxyz-=[];/
ABCDEFGHIJKLMNOPQRSTUVWXYZ_+{}:?
OOOOOOOOOOOOOOOOCCCCCCCCCCCCCCCC
7
17 17
.........#.......
.#######.#######.
.a...#.#...#...#.
####.#.#R#.#.#.#.
...#...#.#.#.#.#.
.#.###.#.#.#.#.#.
.#...#...#!#.#...
.###.###.###.####
.#.....#...S.....
.B########.#.###.
...#.....#.#.#.#.
.#.#.###.#.#.#.#.
.#.....#.#.#...#.
.#######.#.#####.
.#@#.....#.......
.#.#.#######s###.
...#.............
17 17
...#..!#@....#...
.###.#######.#.#.
.#.q.#.....#...#.
.a.#####.#.#####.
.#.......#.#...#.
.#########.#.#.#.
b..#.....#.#.#...
.#.#.###.#.#.###q
.#B..#...#.#.....
.#####.#.#.#.###.
...#..s#.#.#...#.
C###.###.#.#####.
.....S...#.#.....
.#####.###.#.###.
.#.....#...#...#.
.#######.#####.#.
...............#.
17 17
........C#.......
.#########.#.####
...#.......#.....
.#.#.#######.###.
.#...#.....#...#.
.#####.###.#####.
.....#.#...#.....
##.###.#.###.####
@..#...#.#.......
####.###.#######.
.....#.#.......#.
.#####.#######.#.
.b...........#.#.
.#.####a####.#.#.
.#.#.......#.C!#.
.###.#####.#.###.
.....#...........
17 17
.........#..A#...
.#######.###.#.#.
.......#...#.#.#.
######.###.#.#.#.
.......#r..#...#.
.#########.#####.
.#......!#.......
.#.#############.
.#.#.........#...
.#.#########.#.##
.#.....#.....#.#@
.B####.#.###.#.#.
.#.....#.#.#.#.#.
.#.A####.#.#.S.#.
.#.#.#...#...#...
.#.A.#.#.#q#####.
...#...#.........
17 17
.....#...S.#..s..
.#####.##q.#.###.
.......s...#.#...
.#######.###.#.##
.#...#.t.#...#.R.
.###.#.##S.#####.
.....#.....#...#.
####.#######.#.#.
...#.#@..#...#...
.#.#.###.#.#####.
.#.......#...#...
.#########.#.#.##
...#.#...#.#.#c#.
##.#.#.#.###.#.#.
.#...#.#.#...#...
.###.#.#.#.#####.
..Q..B!#...#.....
17 17
.................
.#####.##t##t###.
.....r.#@......#.
.#####.######Q.R.
.#.....#.......#.
##.#####.#####.#.
!#.#.........#.#.
.#.#########.#.#.
.q.#.....#.T.#.B.
.#.#.###.#.#####.
.#.....#.#.....#.
.#.S####.#####.#.
.#.#.....#...#.#.
.###.#####.#.#.#.
...#...#...#...#.
##.###.#.#.###C#.
.......#.#.......
17 17
.q.#.......#.....
.#.#.#.###.#.#.##
.#...#...#@#.#...
.#######.###.#c#.
...#...t..B#...#.
##.#.#.###.#.###.
.....#.#.#.#.#...
######.#S#.#.#.#.
.....#...#...#.#.
.###.#####b###.#.
Q..#.....#.....#.
.s######.#.#####.
.#!......#...#...
.###########.#.##
b..#......r#.#...
##.###.###.#.###.
.......#.....#...
