abcdefghijklmnopqrstuvwxyz-=[];/
ABCDEFGHIJKLMNOPQRSTUVWXYZ_+{}:?
OOOOOOOOOOOOOOOOCCCCCCCCCCCCCCCC
7
25 25
.......#.........#.#.....
.#.#.###.#####.#.#.#.#T#.
@#.#.#...#.....#...#...#.
##.###.###.###.#######.#.
...#...#...#...#.......#.
.##r.###.###.###.#######.
.......#.R.....#.#.#...#.
######T#.#######.#.#.#.#.
.....#...#.....#...#.#.#.
.###.#.#.#.###Q###.#.#.#.
.#...#.#t#.#!b.....#.#.#q
.#.###.t##.#.###.###.#.#.
.#...#.#...#...#.#...#.#.
.###.#.#.#####.###.###.#.
...#.#.#.#...#...#.#.....
##.#.#.#.#.####B.#.#####.
...#...#...#.....#...#...
.#.#######.C.#####.#.####
.#.#...#...#.#.....#.....
.###.#.#.###.#####.###t#.
.....#.....#.#...#.#.....
.###########.#.#.#.#.#Q#.
.#.......#...#.#.#.#.#...
.#.#b###.#.###.a.###.#.##
...#.....#.....#.....#...
25 25
.........#...#.......#...
######.#.#.#.#.#####.#.#.
.......#.#.#.q...#.....#@
.#######.#.#.###.########
...#...#...#.....T.......
.#.#.s.#########.#.#####.
.#...#.#.B.#...#.#.....#.
.#####.#.###.#.#.s####.#.
...#...#.....#.......#.#.
####.####t##.#########.#.
.....#.....#.#.........#.
.###.#.###.###.#########.
...#.#.#.#...#...#...#...
.#.###.#.###.###.#.#.#.##
.#.#...#.t.#.....#.#.#...
##.#.###.#.####s####.###.
...#...#.#.....a.......#.
.####R.#####.#.#.#.###.#.
.....#.....#.#.C.#...#.#.
.#.#######.a.s.#####.###.
.#.....q...#.#...#...#!..
.#####.#.###.###.#.######
.#...#.#.#...#.#.#.......
.#.#.#.#.Q.###.#.###.###.
...#.#.....#.........#...
25 25
.......#.....#...........
.#####.#.###.#.#C#####.#.
.#...#.#.#.#.......#C..#.
.#.###.#.#.########r.###.
.#...#...#.#.....#...#.#.
.###.#####.#.###.#.###.#.
.......#...#.#...#...#.#.
######.#.#.#.#.#####.#.#.
.......#.#.#.#..r#...#...
.#######.#R#.###.#.#.####
...#.....#.#...#...#.#...
T#.###q###.###.#######.#.
...#...#...#.#...#.....#.
.###.#s#.###.###.#.#####.
.#..S#.........#......a#.
.#.###.###Q####S######.#.
.#.#...#.....#.......#.#.
.#.#b###.###.#.#####.#.#.
...#.#...#.....#...#.#.#.
.#####.#.#########.#.#Q#.
.#.....#.#!#.c.....#.#.#.
.#.###.###.###.#####.###.
.#...#.#...#...#.....#...
.###.##Q.###.###.#####.#.
..@#.....#.............#.
25 25
.#...#.......#...........
.#.#.#.#####.#.#####.####
...#...#...#...#...Q.....
.#######.#.RT###.c######.
.......#.#S....#.....#.#.
#B####.#####.#.###T#.S.#.
.......#.....#.....#...#.
.#######.c.#########.###.
.#.....#.#.#.....#@..#...
.#.###.#.###.###.#####.#.
.#.#.....#...#.#...#...#.
.#.#.####C.###.#t#.#.###T
.#.#.#.....#.....#...#...
.b.#t#.#####.#.#######.##
.#.#...#..b..#.......#.#.
.#.#.###.#######.#####.#.
...#...#.#.#...#.#.....#.
.#####.#.#.#.#.#S#.#####.
.#A....#...#.#.#.#.......
.#.#####.###.#.#.##C####.
.#.b.....#...#.#.......#.
T#.#.###q#.###.#.###T###.
...#.#!....#.#.#...#.#...
.###########.#.#.#.###.##
...............#.#.......
25 25
.........#.......#.......
.###.###.##t.###.#.#.###.
...#...#...#...#..c#.#.#.
##.###.q##.#########.#.#.
...#...#.....#...#...#...
.##c.#######.#.#.#.######
.#...#..B..C...#.#.......
.#.###.###.#####.#######.
.#.......#.#...#.........
.#########.#.#.#########.
.#...A.#...#.#.....#.....
.###.#.#.#######.###.####
.#...#.#.#.....#...r.....
.#.#.###.#.###.###.#####.
...#.#...#...#...#.#.....
####.#.###.#.###.#.#.##s#
.....#.#...#...R...#A....
.#####.#######.###.#####.
....@#.#!....#.#.......#.
.#####.#####.#T#######.#.
.#.....#.....#...#....C#.
.#.#####.#####.#.######B.
.#.....#...#...#.........
.###A#.###.#.##########T#
.....#.....#..........t..
25 25
.......#.....#.....#.....
.#####.#.###.#.###.#.###.
.#....s#...#.#a#...#.#...
.##B.###.#.b##.#.##s.####
...#.#...#.#...#.#.......
##.#.###.#.#.###.#.#####.
...#...#.#.#.#...#.#...#.
.#####.###.#.#.###.#.#.#.
.R...#.....#.#.#...#.#.#.
####.#######.#.#####.#.#.
.....#!..R...#.b.....#.#.
.###.###.#.###########.#.
.#.#...#...#.......#...#.
.#.###.#####.#.#####.###.
.#.#...#...#.#.....#.#...
.#.#.###.#.S.#####.#.#.#.
.#...#...#.#.....#...#.#.
.###.#.###.#####.#####.#.
...#...#...#@..#.....#.#.
.#.#Q###.#####.#####.#.##
.#...#Q............#.#...
.###.#.#############.###.
...#.#.#...........#.....
s#.#.###.#########.#####.
...#.............#.......
25 25
.....#@......#...R.#.....
.###.###.###.#.#.#.#.#.##
...#.#...Q.#...#.#...#...
#t.#.#.###.#####.#######.
...#.#.#.#....A#.........
.###.#.#.#.#.#.#########.
.#.#.#.#...#.#...#.....#.
.#.#.#.#.#R#.#####.###.#.
!#.#...#...#....Q#.#.#...
##.######r.#####.#.#.####
........q#.#.#...#.#...#.
.######T##.#B#.#.#.#.#.#.
.#...#...#...#.#.#...#...
.#.#.#.#.b##.#.#####t###.
B..#.#.#...#.#.....#...#.
.###.#.###.#.###S#S#.###.
...#...#.#.....#.#...#...
##.T####.a######.###.#.#R
.#A#...cc..#.TC..#.#.#.#.
.#.#.#.###.#.##C##.#.#.#.
...#.#...#.#.#.....#.#...
.#T#####.#.#.#.#.###.###.
.......#.#.#.#.#q......#.
######.#.#.#.###########.
b........#.#.............
