abcdefghijklmnopqrstuvwxyz-=[];/
ABCDEFGHIJKLMNOPQRSTUVWXYZ_+{}:?
OOOOOOOOOOOOOOOOCCCCCCCCCCCCCCCC
13
17 17
.#...#...A.#.....
.#.#.#.###.T.#.##
.#.#.#...#...#...
.#.#.##a.#######.
...#.....T.......
.#########.#####.
.....#...#.....#.
.#####.#.#####.#.
.#.....#...#...#T
.#.#######.#.###.
.#.#.....#.#...#.
##.#.#####.###.##
...#.....#...#...
.#######.###.#a#.
.#....!#...#.....
.#.#####.C.R####.
...#@....#.......
17 17
.....#...........
.###.T.#.#.#####.
.c.#.#.a.#.#...#@
####.#.#.##r.#.##
.....#.#.#...#...
.#####.#.#.#####.
...#...#.#.#r..#.
.#.#.###.#.#.#.#.
.#.#...#...#.#.#.
.#.###.#####.#.#.
.#...#.#.#...#...
##.###.#.#.#####.
...#.....#.#.....
.###.#####.#####.
...#.#.#...#...#.
.#.#.#.#.###.#.#.
.Q.....#.....#!#.
17 17
...b...#.#..!#...
.#####.#.#.T####.
...#.....#.#Q....
.#.#.#####.#.###.
.#.#...#...#.#...
##.###.#q###.#.##
...#@#.#.....#...
.###.#.#########.
.#.....#.....#...
.#T###.###.###.##
.#...#.#...#...#.
.#.#.#c#.#.#.###.
.#.#.#...#.#.#...
.#.#.#######.#.#.
.#.#.......#.#.#r
.#.#######.#.###.
.........#.......
17 17
...#.........#...
.#.###.#.###.#.#.
.#..!#.B...#.#.#.
.Q#q##.###.#.#.#.
.#...#...#.#...#.
.#.#.#.###.#####.
...#.#.#...#.....
####.#.#.###.####
...#.#.#...#...#.
.###.###.#.###.#.
...#...#.#.#.....
.#.###.#.#.####T#
.#.#...#@#.......
.#.#.#########A#.
.#...A.......#...
.b####.#####.#.#.
.......#.......#.
17 17
.......#...#.....
.#.###.#.#.#.###.
.#.#.#.#.#.#..@#.
.#.#.#s#.#.#####.
.#.B.....#.......
##.############s.
...#...#.....#.t.
.###.#.###.#.#.##
...#.#...#.A.#.#.
##.#.###.###.#.#.
.#...#.#...#...#.
.#####.###.#R#.c.
.....#...#...#...
.c##.#.#.###.###.
.#.#.#.#...#!#.#.
.#.#.#.#.#####.#.
...#...#.........
17 17
...............#.
.c##.#########.#.
.#...#!#.....#.#.
.#####.#.###.#.#.
.#.....#.#@..#.#.
.#.#####.#####.#.
...#...#...#...#.
####.#.###.#.###.
.....#.....#...#.
####.#########.#.
.....#...#.....#.
.#####.#.#.#####.
.#...#.#.#.#.....
.#.t.#.#.#.#.###.
.#.#.#.#...#.#.#.
.#.#.#.#####.#.#.
...#.........#...
17 17
...#S......#.....
.###.###.#.###.#.
.....#...#.....#.
.#####.##########
.#.S.#...#.....#!
.#.#####.#.###.#.
.#.....#.....#.R.
.###.#.#######.#.
.#...B.#...#...#.
.#.###.#.#.#.#.b.
.#...#...#@#.#.#.
.###.######R.#.#.
...#.......#.#.#.
##.b.#####.#.###.
.#.#.#...#.#.....
.#.###.#.#.######
.......#.........
17 17
...#.....#.......
.#.###.#.#.#####.
.#...#.#.#.#...#!
.###.###.#.#.#.##
.#.....#.#...#...
.C####.#.#######.
.....#.#...#.....
.##r.#.###.#.####
...#.#.....#.#...
.###.#######.###.
@#...#.....#.#...
##.#.#.#r#.#.#.##
...#.#.#.#.#.#...
.#####.#.#.#.###.
.....#...#.#.....
.###.###.#.#####.
...#.....c.......
17 17
.....#.........B.
.###.#.#.########
...#...#.#!......
.#.############q.
.#.#.........c...
##.#.###.#.###.##
...#...#.#.#...#.
.#####.#.###.###.
.......#...#...#.
.#########.###.#.
.#@......#.....#.
.#######.###Q###.
.........#.......
########.#####.#.
.......#.......#.
.#####.#########.
.....#...........
17 17
.....#....!#...a.
.#.#.#.#####.###.
.#.#.#...#...#...
##.#.###.#.#####.
...#...#.#.#...#.
.#####.#.#.#.#.##
...#.#.#.#.#.r...
A#.#.#.#.#.#.###.
...#.#.#.#...#...
.###.#.#.#####.#.
...#...#.......#.
.#.###.#########.
.#...#...#.......
.###.#####.####R#
...#...#...#.....
##.###.#.###.###.
....@#.......#Q..
17 17
...#...#...#.....
.#.#.#.q##.#R#B#.
.#...#...#.#.#...
.#######.#.#.###.
.....#!#...#...#.
B###.#.#######.#.
.....#.#...#...#.
.#####.#.#.#.###.
.....#.#.T...#.#.
.###.#.#.#####.R.
.#...#.a.#.....#.
.#.#.#.#.#####.#.
.#.#.#.#...#...#.
.B.#.#.###.#.###.
.#.#.#.....#...#.
.#.######r##.#.#.
@#...........#...
17 17
...#.............
.###.###########.
.....#.........#.
######.#######.#.
.......#...#...#.
.#######.#.#.###.
.#.......#.R!#...
.###.###.######R.
...#.#.#.......#.
##.R.#.#####.#.#.
...B...R.....#B..
.#######.#######.
.#.....#.A.#.....
.#.#.#.###.#.####
.#.#.T...#.#.#@..
.###.###.#.#.#q#.
.....#.....#.....
17 17
@#.....#.........
.#.###.#.###.####
.#...#.#...#.....
.##C.#.###T#####.
....C#.....#...#.
#a####C###.#.#.#.
.........S...#.#.
.#####q#.Q####.#.
...#...#.#.....#.
##.#.###.###.###.
...r...#...#...#.
.###.#.###.#####.
.#...#...#.......
.#.#####.#######.
.#.....#...#.....
.#####.###.c.B###
....!#...#.......
