abcdefghijklmnopqrstuvwxyz-=[];/
ABCDEFGHIJKLMNOPQRSTUVWXYZ_+{}:?
OOOOOOOOOOOOOOOOCCCCCCCCCCCCCCCC
5
17 17
...#...#...#.R.#.
.#.#.#.#.#.#.#.#.
.#...#...#.#.#...
.b########.#.###.
.#.#.....#...#.#.
.#.#.#cc.#####.#.
.#...#...#...#...
.###.#.###S#.#.##
...#.#.....#..s#.
#t.#####.#######.
.#...a.#..B......
.#####.#####b###.
.....#.#.....#..t
.#####.###.#.#.##
.#A..#..!#.#@#.#.
.#.#.#####.###.#.
...#..Q..........
17 17
..@#.....r.......
.###.###.#.###.##
.#...#.#.#.#.#...
.#.###.#.#.#.###.
.#.#...#...#...#!
.#.#.#.#####.#.##
.#b#.#.....s.#...
.#.###.rr###b#.#.
.#.#...#.#...#.#.
.#.R.#####.###.##
.#.#.......#.#...
.#.##q.#####.###.
.#...#.......tT#.
.###.###########.
...b.......#.....
.#.#####a#.#.###.
.#...........#...
17 17
.Q.........#.....
.#.#######.#####.
.#.#....@#.......
.#.#.#.#########.
.#.#.#.........#.
.#c###########.#.
.#.#.....#...#...
.#.#.###.#.#.###.
.#...#.#...#...#.
.#####.#####.#.#C
...#...#...#.#...
##.#.#.#.#.###.#.
...#.#.#.#...#.#.
.#####.#.###.#.#.
t....q.#..A#!#.#.
r#####.###.#####.
.........#.......
17 17
.......#...#.....
.t##.#.#.#.#.###C
.#.#.#...#...#...
.#.#.#.##C####.##
...#.#.#.....#...
##c#.#.#.###.###.
.....#.#.#...#@..
.#######.#.S#####
.....#...#...#...
####.#.#####.#.#.
...#...#...#...#.
.#.a####.#.#####.
.#...#...#..Q....
.###.#r########ct
.#.....#...#....!
.#######.#.#.####
.........#.......
17 17
.......#.....#...
.#.#####.#.###.#.
.#q#.....#...#.R.
.#.#.#######.#.#.
.#.#.#@....#.#.#.
##.#.###.Q.#.#.#.
...#...#.#.#...#.
.#.###.###.#####.
.#..T#.#...#.....
.###.#.#.#.#.###.
.#.#.#...#.#...tq
.#.#.#####.###.##
.#...#...#.q!#...
.#.###.#.#.#.###.
.#.#...#...#...#.
.###.#########.#.
.............#...
