abcdefghijklmnopqrstuvwxyz-=[];/
ABCDEFGHIJKLMNOPQRSTUVWXYZ_+{}:?
OOOOOOOOOOOOOOOOCCCCCCCCCCCCCCCC
7
17 17
..............s..
Q#####.#####.#vu.
.....#.Q...#.#...
.###.#######.#.##
!#.#.......#.#.#.
b#.U######.#.#.#.
.......E.#.#.#...
####.#####.#.#R#.
.....#.t.#...#...
.###.#.#.#####.##
...#.#.#.......#@
##.#.#.####c####.
.b.#.#...#.......
.######U.#######.
.#.......#.....#.
.#.#######.###.#.
...........#.....
17 17
...#.......#.....
R###.#.###.#####B
.....#.#.#.......
.B####.#.#######.
.....#.#...v...#.
####.#.#####r#.#.
...#.#.....#.#...
.#.#.#####.#.####
.#.#.#...#.#.#...
.a.#.###.#.##v.#.
.#.#....C#.....#.
##.#####.###D###.
.......#...#@..#!
vu#######b.###.##
...#.....#...#...
.#.#.#.#####.###V
.#u..#...........
17 17
...#...#.........
.#B#.#.#######.#.
.#.#.#.....#...#@
.###.####a.#.###E
...#.....#.#.....
.#.#####.#.##U.#.
.A.....#.#...#.#.
.#.##u.#.u#D.#.#.
.#.#...#...#.#.#.
##.#.###.###.#.#.
...#.#...#...#.#.
.#####.##Q.r####.
.......#...T.....
.#######.###.##t#
...#...#..!#.....
##.###.###c####b.
.......S.........
17 17
...#!.a#.....#...
.#.##b.###.#.###.
@#...#.#...#b..B.
##.###.#.#####.#.
...E...#.....#...
.#.#dt######.####
D#.#...#...#.....
.#.###.#.#.#####.
.#...#.#e#......Q
.b.###.#.#######.
.#.#...#...#...#.
.#.#.##s#R.#.###S
.#.#.#.....#.#...
.###.###.###.#.##
.#...#...#...#...
.#.###.###.#####.
..e....#.C..V....
17 17
....b........#...
.###########.#.#.
.#...#.....#.#.#.
.#.###.#.#.#.e.#.
.#.....#.#.#.#.#.
.###.###.B.#.#.##
..!#.#.#.#@#.#.T.
####.#.#.###.#V#.
...#.#.#.....#.#.
.###.#.#######.#.
.....#.....#...#.
.###D#.###.#.###E
.S...#.#.#.#.#...
.#.#.#.#.#.#.#.#.
...#...#...#.#.#.
###C#s##.#####.#.
...............#.
17 17
.....#.......U...
.####t.#.###.###.
...#...#..c#...#.
.#.#.#####.#A#.#.
.#...#.....#.#...
.#####.###Q#.###.
.#.....#.#.....#.
##.#####.#.###.#.
...t.....#...#...
.##q.###.###.####
!#@#.#.....#.....
##.#.#.###.#####.
...#.#.#...#...#.
.#.#.#.####u.#.#.
.#...#...#...#...
.#Q#####.#.######
.......#.........
17 17
.......#.........
.#c#.###.#.#.#s##
...#...#.#.B.#...
.#####.#.#.###.#.
.#q..#...#.....#.
#a.#.#.t######.#.
...#.#.#.....t.#.
.###.#v#.###.###.
.A.#.....#@#.....
#R.#######.#####.
...#...#.....E...
.###.#.#.#####.##
.....#.#...#...#.
##T###.##a.#.###.
..!#...r.U.#.....
.###.##b.######b.
.....#...........
