abcdefghijklmnopqrstuvwxyz-=[];/
ABCDEFGHIJKLMNOPQRSTUVWXYZ_+{}:?
OOOOOOOOOOOOOOOOCCCCCCCCCCCCCCCC
7
17 17
..t........#..D..
####.#.#####.#.##
...#.#.......F...
.#.###.#####F###.
.#...#.........#.
.###.#########.#.
...#!#v....#...#.
##.###.###.#.###.
...#...#...#.#...
.c##.#.###.###.#.
.#...#...#...#.#.
.#.#####.###.#.#.
.#.#...#...#...#.
.#.#.#.#.#.#####.
.#.#d#.#.#.#..@#.
.w##.b.###.#.###.
.....#..e..#.....
17 17
.....#F........#.
.#.###.#.#####w#.
.#.#...#...e.....
.#.#.#####.###r#.
.#.#S....#.#...#.
.####b##.#.#.#.#.
.........#...#.#.
.#########v###.#.
...#.....#...U.#.
##.#.###.#.#.#.##
@#.#.#.#...#.#...
.#.#.#.####b.#S#.
...#.#.....#...#.
##D#.#.#.#####.#.
.....#.#.....#.#.
.#######.#.###.#.
......!ab#.......
17 17
...#...#.........
.#A#.#.#.#######.
.#...#.D.......#.
.v####.#######.##
.#...#.......#t..
.#.#.#####u#.###.
!#.#.......s.#...
##.#####c#V###.#.
...#...#.......#.
.###.#.###.#####.
.....#...#...#...
F#######.S.#.#.##
.......#.#.#.#...
.###.#.#.###.###.
.b...#.#...#...#.
.#.#######.###.#.
.#........u.D..#@
17 17
.................
.###.###########.
.#...#f....#...#.
.####u.###.#.#.#.
.#.....#@#...#.#.
.#C####A.#####.#.
...#.....#.....r.
.#####.#.#.######
.......#.#.t.....
########d######c.
.#...#.........#.
.#.#.#.##S####.#.
...#...#.#..!#R#.
.w######F#.#####.
.....#.D.#.#....q
###F.#.#.#.###.#.
.......#.#.....#.
17 17
.#..t....#.......
.#.##B.#.#####.#.
.....#.#.....Q.#.
#####d.#########.
.....#.....#...#.
.###.#####.#.###.
.#.........#...D.
.#############.#.
...#@....#.....#.
##.###.#.###T#.#.
...#...#.....#.#.
.###.#######.#B#.
a..#.....#...#...
##.#.###.#.###.##
.#!#.#.#.#.#...#.
.###.#.R.###.###.
.a..R..#.........
17 17
.....#...........
.###VC.###C#####.
.#...#.#.....TB..
.#####.#.###.#.##
.#..!A...#...#.#V
D#.#######.###.#.
.#........b#.#.#.
.###########.#.#.
...#...........#.
.#.#.#w#########.
.#.#.#...........
.#.#.###.#.##r##.
.#.V...#.#...#@..
.#####.#####.S##.
.B...#.....#..Ed.
.#.#.##T##.###.#.
v..#...........#.
17 17
...........#.#...
.#########.#.#.#.
.#.......#.#.V.#.
.#.#####.#.#.###.
.#.#..r#.#.#B#...
.f.###.#.#.###.#.
.#.....#!#.#..R#.
.#####.###.#.###.
.#.....#@u...#.#.
c#.#####.#####.F.
...#...#.#.......
####.#.#.#.######
.#...#.W.#.#...#.
.#.BU#####.R.#.#.
d#.#...u...#.#.#.
.#.###.#.###.#.#.
.....#.......#...
