abcdefghijklmnopqrstuvwxyz-=[];/
ABCDEFGHIJKLMNOPQRSTUVWXYZ_+{}:?
OOOOOOOOOOOOOOOOCCCCCCCCCCCCCCCC
7
17 17
.................
.###.###########.
.#.#.#.....#...#.
.#.#.#.###.###.#.
...#.....#...S..R
.#######.###.#.##
@#...#.....#.#.#.
##.#.###.###.Q.#b
...#...#.#...#.#.
.#####.#.#.###.#.
...#...#.#.#.#.#.
##.#.#####.#.#.#.
.#.#!#.....#.#.#.
.#.###.#####.#.#.
.#.#.....#...#.#.
.#.#####.#.###.#.
.........#.......
17 17
.........#...#...
.#####s#.#.#.#.#.
...#...r...#.#!#.
.#.#.#.###.#####.
.#...#...#.#.....
.#######.s.#.####
...#...#.#.#.....
##.###.#.#.B####.
.#...#.q.#...#...
.###.#.#.###.#.##
.....#.#...#.#...
.#####.###.#####.
.#.......#.....#.
.#####.#.#####.#.
.....#.#.....#...
####.#######.####
................@
17 17
...#.........#...
.#.###.#.#####.#.
.#...#.#.#.....#.
.###.#.#.#.#####.
.#...#.#...#.....
.###.###.###.###.
...B...#.#...#...
##.##a.###.###.##
!#...#.....#.#.a@
.#.#.#######.#.#.
.#.#...#.#.....#.
.#.###.#.#.#####.
.#...#.#...#S....
.#.###.#.#####.#.
.#.#...#...#...#.
.###.#####.#.###.
.....#.......#...
17 17
...#...#...#.....
.#.#.#.#.#.#.###.
.#.#!#.#.#.#.#...
.#####.#.###.#.##
.......#.....#...
.#############.#.
.......#.....#.#.
######.#.###.##A.
.......#.#...#...
.#######.###.#.#.
.#...#.....#...#.
.#.###.###.#####.
.#.....#...#...#.
.#.#####.###.#.#.
.#...#...#.#.#.#.
.#####.###.#.#.#.
.......#@....#...
17 17
.....#..B........
.###.#.#########.
.#...#.........#.
.#.#########.###.
.#...#...#...#...
.#####.#.#.###.#.
.......#R....#.#.
.###########.#.##
.#...#...#...#...
.#.#.#.#.#######Q
.#.#...#.......#.
.#.########S##.#.
@#...#.......#...
####.###.###.A##.
.....#!#.#.#...#.
.#####.#.#.###.#.
.......#.....#...
17 17
.........#.#.s...
.#######.#.#.###.
.....#...#s#...#.
####.#.###.#.###.
.#!..#b#.#...#...
.#A###.#.#.###.#.
...#...#.....#.#S
.#.#.#######.#.##
.#.#.....#...#...
.#######.#.#####.
.........#.....#.
.#######q#.#####.
...#@......#...#.
s#.#########.A.#.
.A.#.........#.#.
.###.#########.#.
.....#...........
17 17
..........@#.....
####.#######.###.
...#...........#.
.#.#####.#######.
.#.....#.#.......
.#####.###.#####.
...#r......#..!#.
.#.#######.#.###.
.#.q.#.....#.#...
.###.###.###.###.
.#.#...#.#.#...#.
.#.###.#.#.###.#.
.#...#.#...#.a.#.
.#.#.#.#.###.##S.
...#.#.#.#...#a..
####.#.###.###.##
.....#.....#.....
