abcdefghijklmnopqrstuvwxyz-=[];/
ABCDEFGHIJKLMNOPQRSTUVWXYZ_+{}:?
OOOOOOOOOOOOOOOOCCCCCCCCCCCCCCCC
9
17 17
...#.....#.......
.###.###.#.###.#.
...#.#.#.#...#.#.
.#.#.#.#.###.#.##
.#.....#.....#...
.###C#######.###.
...#...#...#.#...
####.#.#.#.###.#.
...#.#.#.#...#.#.
.#.#.#.#.###B#.##
.#...#...#...#R..
.#########.##a.#.
...#.....#...#@#.
##.#.#Q###c#.b##.
...#.......#.#...
.#b#####.#.#.#.#.
......!#.#.....#.
17 17
.................
.###.###########.
...#.....#@..#...
sc.#####.###.#.##
.#.....#...#.#...
.#####.###.#.###.
.....#...#.#.....
##.#####.#.######
...#...#A#q..a..!
.###.#A#.########
.#...#...#...#...
.#.#######.###a#.
..q#.#.....#...#.
.###.#.#.###.###.
...#...#.....#...
##.###########.#.
...............#.
17 17
.......#...Q.....
.#####.#.#.#B###b
...#@#.s.#.....#.
##.#.#.#.#####.#.
...#.#.#.#...#.#.
.###.#.#.#.#.#.##
.#...#!#.#.#.#...
.###.###.#.#.###.
...#.#T..#.#...#.
##.#.#.#####.###.
...#.....#...#...
.#######.#.#.#.##
.......#...B.#...
######.#####.###.
.....#.....#...#.
.###.####A.##Q##.
...#.............
17 17
@#...............
.#.##q####.###.#.
...#.....#.#...#.
##B#.###.###.###.
.....#...#...#...
.#####.###.###.##
.#...#.#.....#.#.
.#.#.#.#.###.#.#.
.#.#.#.#.#...#...
.###.#.#.#.#.####
...#...#.#.#.#...
##.#.#####.###.#.
.#.#.....#.....#.
.#.#####A###.###.
.#!#...#...#...S.
Q##A.#s###.#####.
.................
17 17
...........R.....
.#####.#####.###.
.#...#.#...#...#.
.#.#.###.#.#.###.
...#.....#...#...
.###R######S##.##
.#.........#.#..!
.#######.#.#.####
.#.......#...#...
.#.#########.###.
...#.......a.....
########.#.#t###.
.........#....@C.
.######a##.#####.
.#...#.....S...#.
.#.#.#######.#.#.
...#....s....#...
17 17
.........#.......
.#######.#.#.###.
...#...#.#.#.#...
##.#.###.###.#.##
...#.....#...#...
.###.#####.R####.
!#.#...#...#.#...
##.###.#.###.#.##
.......#.#.#...#.
.#######.#.#.###.
.......#.#.#...#.
######.#.#.###.#.
.....#.#.#...#...
.#T#.#.#.#.#####.
...#.#...#.#...#.
##.#.#####.#.#.#.
@..#.........#...
17 17
.......#.....#...
##.###.###.#.###.
...#.......#.....
.###############.
.....#.....b.....
.###.#.###.#####.
...#.#...#.....#.
A#.#.###.#####.##
...#.........#...
.###b#######.###.
.#.....#!..#...#.
.#.#.#.T##.###.#.
.#@#C#.#.#.#.#.#.
.###.#.#.#.#.#.#.
.....#...#.#...#r
########.#.####C.
.Q.......#.......
17 17
.....#...........
.#####.#B#####.#.
.#.....#.....#.#.
.#.#####.###.###.
.....#...#...#...
.#####.###.###.#.
.#.......#.#...#.
.#.#######.#.#.#.
.#.....#!..#.#.#.
.#####.####a.#.#.
.....#...#...#.#.
####.##r.###.#.#.
.....#.#...#.#.#.
.#####.###.#.#.##
...#.....#.#@#...
##.###.#.#.#####.
.......#.#.......
17 17
....@#......t....
.#.#c#.#######.##
.#...#...#...#...
.###.###.#.#.###.
...#...#.#.#...#.
##.#.###.#.###.#S
...#.....#.#.....
##########.######
.........#.......
.#######.###.###.
...#...#...#.#!#.
##.#.#####.###.#.
...#.....#.....#.
.###.#.#########c
.#...#.......#...
.#########.#.###.
....b......#.....
