abcdefghijklmnopqrstuvwxyz-=[];/
ABCDEFGHIJKLMNOPQRSTUVWXYZ_+{}:?
OOOOOOOOOOOOOOOOCCCCCCCCCCCCCCCC
7
17 17
.....#...B.......
.###.#########.#.
.a.......#.....#.
.#######.#.#####.
...#...#...#...#.
.#.#.##S####.#.#.
.#.#.........#...
##.###.##########
!#...#.#.......#.
.###.#.#.#####.#.
.#...#.R.#..@#.#.
.#.#######.###.#.
.#.#.....#.....#.
.#.#.###.#.#####.
.#.#...#.#.#.....
.#.#.#.###.###.#.
...#.#.........#.
17 17
.......#.........
####.#.#.#####.#.
...#.#.#...#.#.q.
.#.#.#####.#.#.#.
.#...#.......#.#.
.#####.#####s#.#.
.#...#.....#...#.
.#.#.#.#####.###.
.#.#.#.#...#...#@
.#.#.#.#.#.###.##
.#.#...#.#...#...
.#.#####.###.##Q.
...#...#..!#.....
.###.#####R######
.#...............
.###r#######.###.
.............#...
17 17
.......#.......#.
.#####.#.#####.#.
.....#.#.#...#...
.###.#.#AS.#.###.
...#.#.#.#.#...#.
####.#.#.###.#.#.
.....#...#...#.#.
.#########.###.#.
!#.....#...#...#.
##.#.###.#.#####.
@..#.#...R.#.....
##.###.###.#.####
...#...#...#...#.
.###.###.#.###.#.
...#...#.#...#...
.#.###.#.#######.
.#.....#.........
17 17
....!#.....#.....
.#####.###.#.#.##
...#@#...#...#...
##.#.###.#####s#.
...#.....#.....#.
.###.#####.###.#.
...#.#.#...#.#.#.
##.#.#.#.###.#.#.
.#.#...#.#.#...#.
.#.#.###.#.#.###.
...#.#...#.#.#...
.#####.###.#.##S.
.#...#.#...#.#...
.#.#.#.#.###.#.##
...#...#...#.#...
########.#.#.###.
.........#.......
17 17
@r.S...#.........
.#.###.#.#####.#.
.#...#...#...#.#.
.#.#######.#.###.
...#...#...#.s...
####.#.#.########
.....#.#..r......
.#####.#########.
...#...#...#...#.
##.#.###b#.#.s.#.
...#.....#...#.#.
.#######.###q#.#.
.....#...#..!#...
.###.#.###.#####.
.#.#.#.#...#.a...
.#.#.###.###.#.##
...#.....#.......
17 17
.....#.#......q..
##.#.#b#.#######.
...#...#...#..@#.
.#####.###.#.###.
.#...#...#.#.#...
.#.#.###.#.#.#.##
.#b#.#...#.#.#..!
.#.###.###.#.####
.#..A....#.#.#...
.#######.#.#.#.#.
.#...#...#.#...#.
.#.#.#.###.#.###.
...#.#...#.#.#...
.###.###.#.###.#.
...#.a.#.#...#.#.
##.R##.##R##.#.#.
.....#.........#.
17 17
...............#.
########.###.#.#.
.......#...#.#...
.#####.#####.###.
.#...#.#.....#...
.###.#.#.#####.##
a#...#...#....Q#@
.#.#######.#Q###.
.#.........#...#.
.#.#####.###.#.#.
.#.#..!#.#...#...
.###.###.#.#####.
.....#.#.#...#.#.
######.#.###.#.#.
.......#.....#.#.
.###.#########.#.
...#.............
