abcdefghijklmnopqrstuvwxyz-=[];/
ABCDEFGHIJKLMNOPQRSTUVWXYZ_+{}:?
OOOOOOOOOOOOOOOOCCCCCCCCCCCCCCCC
7
25 25
...#.........#.....#.....
.#.#.#######.#.###.#.r##.
.#...#.....#.....#.....#.
.#####.###.#Q#C#########.
.....#.#.#.#...#.........
##.#r#.#.#.#.#.#.#####q#.
...#...#.#...#...#...A...
.###.r##.#########.###.##
@#...#.....#.........#.#.
#r.#####.#.#.#######.s.#.
...#...#.#...#.....r...#.
.###.#.###.###.###.#####.
.#...#...#.#.....#.....#.
.#a#####.#.#.######q.#.#.
...#.....#.#.#.....T.#...
####.#####.###.#########.
.....#.........#...A...#.
.#####.####b##.#####.#.#.
s#.....#...#Q..#!..#.#...
.#.#####.#.#######.###T##
.#.#.....#.#.....#.......
.###.#####.#.#.#########.
.....#...#.#.#.......#...
.#######.#.#.#####.###.##
.........#.......#.......
25 25
.............#...#.....#.
.#####.#####.#.#.###.#.#.
...#...#.#...#.#.....#.#.
##.#.###.#.###.#######.#.
.#.#...#.#.....#...#...#.
.#.###.#A#######.#A#.###.
...#.#.#....A..#...#...q.
.###.#.#.##t.#.#.#.###.#.
.#...#.#...#.#.#.#.....#.
.###.#.#.###.#.#.#######.
.....#.#.#.S.sQ#.#.......
##.###.#.#.###.#.#.#.###.
.#.#...#.#.#.#.#.#.#.#...
.#.#.##tS#.#.#.#.#.r.###.
...#.....#.#...#.#.#...#.
######.#.#.#####.S####.#.
.....#.#.#.....#.#.....#.
.###.###.#.###.#.#.####a.
.#..Q....#.#.#...#.#@..q.
.#########.#.###.#.###.#.
...#s....#.#.#!#.#...#...
.#.#.#####.#.#.#.#.#.####
.#.#.........#.#.s.#.....
.#.###########.#.#######.
.#.............#.........
25 25
.........t.......#...#...
.#####.#########.#.#.#.#.
...#...#.......#.#.#...#.
##.#.###.#####.#.#.#.s###
...#...R.B...#.#.#.#.#...
.#####.##s.###.#.#.#.#.#.
.#.....#.#.#...#.#.#.A.#.
.#.#####.#.#.#.#.#.###.#.
.#...#...#.#.#.#.#.#!..q.
.###.#.###.#.###.#.#####.
...#.#.....#.#...#...#@#.
.###.#.#####.#.#b#.#.#.#.
.#...#.#.....#.#...#...#.
##.###.#.#.###.#.#.#####.
...#...#.#.#.....#.#...#.
.#.#####.###.#####.#.#.#.
.#.#...#.....#...#.#.#...
.B##.#.####b.#.#.###.####
.#...#.#...#.#.#...#.#...
.#.###.#.a.#t#.###.#.#.#.
S..#...#.#.#...#...#...#.
.###.###.#.#.###.S.#####.
.#...#...#...#...#...#...
.#.###.#######.#######.##
.#...........#...........
25 25
.#!#...........#.#.......
.#.#.#####.###.#.#.C####.
...#.#.....#.#.#...#.....
.#####.#####.#.###A#.###.
.#.....#.....#.#...#.#.#.
.#.######c.###.#.#.#.#.#.
.#...#.....#...#.#...#.#.
.###.#.#.###.###.#####.#.
.....#.#.....#.......#.#.
######.#############.#.#.
.....#...#...........#.#.
##.#.###.###.#.#######.#.
...#...#.R.#.#.#...#.....
.#####.###.###.#.#.#.####
.#.......#.#...#.#.#.....
.#########.#.###.#.#####.
.........#...#.#.#.....#.
.#######.#####.#.###.###.
...#...#.........#@C.....
##.#.####r#######c.######
.#.#.............#.......
.#.r######.#####.#.######
...#.....#.#.....#.......
.###.###.#.#.###########.
.....#.....#..........T..
25 25
.....#.#.....#...........
.#.#.#.#.###.#.#####.#.##
.#.#...#...#...#...#.#...
.#.#####.#######.#.###.#.
@#...#...#....!#.#...#.#.
####.#.###.####C.###.r##.
.....#.R.#.#.......#...#.
.#####.#.#.#######.###.#.
.....#...#.........#...#.
.###.###.###########.###.
...#...#...#.......#...#.
##.#.#.###.###.###.###.#.
...#.#.#...#...#...#.#.#.
####.#.#.###.###.###.#.#.
.....#.#.#...#.#.#...#.#.
.#######.#.#.#.#.#.#.#.#.
.#.....#.#.#.#.#b#.#.#.#.
.#.###.#.#.#.#.#.#.#.#.#.
...#...#.#.#.#.....#.#.#.
.###.###.###.#.#######.#.
.#.#...#...#.#.#.#.....#.
.#.###.###.#.#.#.#.##B##.
.#...#.....S.qc#.#.......
.#q#.r######.#.#.########
.............#...........
25 25
r..#.......#.............
.#.#.###.#.#.#.#a#######.
.#...#...#.#.#...#.#...#.
C###.#.###.#####.#.#.#.#.
!..#.#..r#.......#...A...
##.#.###.##Q######.######
...#.#...#.......#.#.....
.###.#.#####.###.#.#####.
.#.#.#.#R....#...#.....Q.
.#.#.#.#.#.R##########.#.
.#...#.#.#.#...#.....#.#.
.#.###.###.#.#.#.###.#.#.
.#...#...#...#.....#.#...
q#######.###########.###.
.......#.#...t.....#.#...
######.#.#.###c###.#.#.##
.....#...#.......#...#...
.###.#####.##R##.#######.
...t.....#.#...#.#.....#.
##.###.###.#.#.#.#.###.#.
...#@..#...#.#.#.#...#.#.
.#######.###.#.#.#.###.#.
.#.....#.#...#.#...#...#.
.#.###.#.##Q##.#####.###.
...C.#.............#.....
25 25
.............#.........#.
.###A#######.#.#A#####.#.
.#.....#...#...#...#...#.
.#.###.#.#.#####.#.#.###.
...#.#...#.......#.#.....
####.#############.#####.
.........#...#.....#...#.
##.#####.###.#.#####.###.
...#.........#...#.....#.
.###.#######.###.#.###.#.
...#...S...#...#.#...#A#.
.#.#####.#.#t#.#.###.#.#.
.#.#.....#.#...#.#...#.#.
##.#.#####.#####.#.###.#.
.C.#.#...#.....#!#.#...#.
.###.#.R.#####.###.A.C##.
.....#.#.....#.....#.#...
.#####.#####.#######.#.##
...#...#...#.......#.#.#.
##.#.###.#######.###.#.#.
.#.#.#.......C...#...#.#.
.#.#.#.###.###.###.#.#.#.
.#.#.#.#@#...#.#.#.#.#.#.
.#.#.#.#.S##.#.#.#.###.#.
.....#.....#.....#.......
