abcdefghijklmnopqrstuvwxyz-=[];/
ABCDEFGHIJKLMNOPQRSTUVWXYZ_+{}:?
OOOOOOOOOOOOOOOOCCCCCCCCCCCCCCCC
3
17 17
.............#...
########.###.###.
.......#.#.#...#.
.#####.#.#.###.#.
.....#.#q#...#...
####.#.#.###.###.
.....#...#.....#.
.#########.#####.
...#.............
.#.###.########C#
.#...#.....#...T.
.###.#####.#.###.
...#a#...#.#...#.
##.#.#.#.#.b##.#.
A..#.#.#...#...#.
.##r.#####.#.###.
...#....!#...#@..
17 17
......C..#.......
######.#.#.#####.
.......#.#.#.....
.###Q###.#.###.##
.Q.......#...#.#@
.##c#r.#####.#.#.
.....#.......#...
.###.###r#######.
.#.#...#.....#...
.#.###.#.#B#.###.
.....#.#...#..A#.
####.#.###.###.#.
...#.#.......#.#.
.#.#.#########.#.
.#.C..r#.......#B
.#.###.#.#######.
.#.....#......!#.
17 17
.....#...........
.###.#.#######.#S
...#.#...#...#.#.
.#.#.##r##.#.#.#.
.#.#...#...#..c#.
##.###.#.######c.
...#.....#..Q..#.
.#########.###.##
....s........#...
.###############.
B......#...#...#.
##a###.a.###.#.#.
..S..#...#...#.#.
.#######.#.###.#.
..t.....Ra.#.#.#c
.#########.#.#.#.
........@#!#b....
