abcdefghijklmnopqrstuvwxyz-=[];/
ABCDEFGHIJKLMNOPQRSTUVWXYZ_+{}:?
OOOOOOOOOOOOOOOOCCCCCCCCCCCCCCCC
7
35 35
.......C.........#...#.............
####.#.###.#####.#.#.#.###.#######.
.....#.....#.......#.#...#.......#.
.#########.#########.#######.###.#.
.......#.#.#...#...#.......#...#.#.
.BA###.#.#.#.#.###.#######.###.#.##
.#...#.#.#Q#.#...#...........#.#...
.###.#.#.#.#.###.#.c########.t#R##.
.....#.#...#.#.#.#.#.....#.........
####.#.###.#.#.#.###.###.#########.
...#.B...#.#...#.C...#.#...#...#...
.#t#.###.#.###.#.#.###.###.#.###.##
.#.#.#...#.#...#.#.....#.#.#.#...T@
.###.#.###.#.###.#####.#.#.s.#.###.
.#...#...#.#...#.....#...#.r.......
.#.#####.#####.#####.#.###.#######.
...#...R.#.....#...#...#...#.....#.
.###.###.#.#######.#####.T##.###.##
.#.....#...#...#...#...#...#.#.#...
.###.#.#####.#.#.#.###.###.#.#.###.
...#.#......b#...#.....#...#.....#.
##.#####.#############.#.#.###.###.
.#...#...#.#...........#.#...#.#...
.###.#.###.C.###########.#####.Q.#.
.#r..#.#...#.#.......#...#...T.#.#.
.#.###.#.t##.##C####.#.###.#.#.#.#.
.#...#.#.#...#.......#.....#...#.#.
.###.#.#C#.###.#################.#.
...#...q.#.#.#.............#.#...#.
.#######.#.#.#.#####.###R#.#.#.###.
.........#.#.....#...#.#.....#...A.
c#.#######.#######.###.#.#######.##
.#.#.A...#...#...#...#..qa!#...#...
r#.#.###.###.#.#.###.#.###.#.#.###.
.#.....#.......#.....#...#...#.....
35 35
..........t....#...#...........#...
.#s#####.#######.#.#.#.#######.#.c.
.#...#...#...c...#...#...#...#...#.
.#.#.#####.#.#.#########.#.#.###t#.
.#.#.....#.#...#.......#.#.#.....#.
.#.#####.#.#####.###.###.#.#####.##
...#.....#.#.....#.#...#...#...#...
####.#####.#.#####.###.#####.#####.
.....#.....#.......#.#.....#...#...
.###.#.#####.####R.#.###.#.###.#.#.
.#...#.#.....#...#...#.#.#.....#.#.
.###.#.#.#####.#.###.#.#.#######.#.
...#.#.#R#.....#...#...#.#.......#.
.#.#.#.###.#######.#####.#.#######.
.#.#.#.#...#.....#...#...#.#.#.....
.#.###.#.###.###.##A.#.###.#.#.####
.#.....#...#...#.#...#...#.#.#.#...
.#######.#.###.###.#####.#.#.#.#.#.
.#.#.....#...#.#...#.....#.#...#.#.
.#.#.#######.#.#.###.###.#.#####.#.
.#.#.#...#...#.......#...#...#...#.
.#.#.#.#.#.###########.#####.#.###.
.#.....#.#.....#.....#.#.#!#.....#.
.#########.#A#.###.#.c.#.#.#.#####.
...#.....#...#...#.#.#...#.#.#.....
##.#.###.###.###.#.###.###.###.###.
...#.#.T.#...#...#...#.#...#...#...
.###.###.R####.###.#.#.#.###.###.##
.#.....#...#...#.#.#...#...#.#@#...
.#.###.B##.#.###.#.#######.#.#.###.
.#.#...#...#.#...#.......#.#.#.....
.###.t##.###.###.#.#######.#.######
...#...s.#.....#...#.......q.......
##.###.#.###QR.#.###.#############.
.......#.......#...#...............
35 35
...#.....#.#.....#.............#...
.#B#.#.#.#.#.#.###.#########.###.#.
.#...#.#...#.#.#...#@......#.....#.
.#.###.#a###.#.#.#####.#.#########.
...#...#.....#.#.......#.#...#.....
.###.#.C.#####.#######.###.#.#.###.
.#...#.#...#.....#.....#...Q.#...#.
.#.#####.###.#####.#####.#q#.c##.#.
.#.#.....#...#...#.#.#...#...#...#.
##.#.#####.###.#.#.#.#.###.###.###.
...#...#...#...#.....#a..#.#...#.#.
.#####.#.#.B.##########q.#.###.#.#.
.......#.#c#...#!........#..r#.#...
.###T###.#####.########b#c##.#.###.
q#...#.#.......#.......#.#...#...#.
.#.#.#.#########.#####.#.#.#####.#.
...#.......#.........#...#.#.B...#.
##########.#########.b.###.#.######
Q......#...#.........#.#...#.#.....
.#####.#.###.#########.#.###.#.###.
.#...#.#.#.....#...#S..#A..#...#...
.#.#.#.#.#####.#.s.#.#####.#.###.##
...#.#.#.....#.#.#b#.#.#...#.#...#.
####.#.#####.#.#.#.#.#.#.#####.###.
...#.#...#...#.#.#.#.#.#.#.....#...
.###.#.#.#.###.###.#.#.#.#.#####.##
.....#.#.#.#...C...#.#.#.#...#.....
.#####.#.#.###.#.##Q.A.#.###.#.###.
...#...#.#.....#.....#.#.....#...#.
##.#.###.######b.#####.#######.###.
.R.#...#...#...#.#...........#.#...
.#.###R#.###.#.#.#######.###.###.#.
.#...#.s.#...#...#..S#.R.#.#.#...#.
.###.#.###.##q##r#.#.b.###.#.#.###.
...q.#.............#...#.......#...
35 35
...........#.#.................#...
.#.#######.#.#.#############.#.#.S.
.#.#.....#...#.#.....#.....#.r.#.#.
.###.###.###.#.#.#####.#q#.#.#.###.
...#.#...A...#...#.....#.#...#.#...
##.#.#.#########.#.#####.###t#.#S#.
...#.#R#.........#.#..q...r#.R.#.#.
.###.#.#.#########.#.#.###.#.#.#.##
.#...#.q.#.......#.#.#C..#...#.#...
.#.###.#.#.#.#####.#.###.#####.###.
...#...#.#.#.....#.#...#.....#.c...
.###.#.#.#.#####.#.#####.###.#.#.#.
.#...#.#.#....@#.#.#...#...#.#...#.
.#.#####.#######.#.#.#.###.#.#a###a
.#...........T...#...#...#.#.......
.###################.###.#######.##
.#.......#.........r...#.......#...
##.####R.#.#######.#####.#####.####
...#...#...#.....#.....#.....#.#...
.###.#.#######.#.#####.###t#.#.#.#.
.....#.#.....#.#.#...#.....#.#...#.
######.#.###.#.S.#.#.#####.#######.
.Q...#!#...#...#.#.#.....#.#.......
.###.###.#.#######.#.#.###.c.#####.
...#.#...#...#.....#.#.#...#...#...
####.#.#####.#.#####.#b#.###.#.#.##
...#.#.#.#...#.#...#.#...#...#.#...
.#.#.#.#.#.###.###.#.#.###.###.##a.
.#...#.#.#.........#.#.#...b...#.#.
.###R#.T.####q######.#.##q.#.###.#.
.#...#.....#a........#...#.#.#.#...
.#Q#.#####.#.#.#########.#.#.#.#.##
A..#.....#.#.#.#...#.....#.#.#.#...
.#####.###.R.###.#.#.#######.#.###.
.....#.....#.....#...........#.....
35 35
...#...S.........#...#.............
.#.#.#.#.#.#####.#.###.#######.##c.
.#.#.#...#.#.....#.#...#.....#.#..T
.#.#.#####.#.#####.#.#####.#.#.####
.Q.#...#...#.......#.......#.#.....
.#####.#.###################.#####.
.......#...#.............#.#...#...
.#########.#.T###s.#####.#.###.#.##
.#.....#...#.#...#.#...#...#...#...
.#.###.#.#.#.#.#.#.#.#.#####.#####.
.#.#.#...#.#.#.#.#.#.#.......#...#.
##.#.#####.#.#C#.#.#.#########.##C.
...c...R.#.#.#...#...#...#.....#...
.#Q#.S.A##.#.#.#######.###.#.###.#.
.#...#.....#.#.........#...#...#.#.
.###.#######.#####.###.#.#####.#.##
...#.#...#...#.....Q...#.#.....#...
##.#.#b#.#.###.#####.###.#.###r#S#.
...#.....#...#.....#.#...#.......#.
.#######.###.#.###.###.#######.###.
..b..#...#.#.S.#.#.......#...#...#.
.###.#.###.#.#.#.#########.#.###.#.
.#...#.....#.#.....#.......#.....#!
##.#.#####.#.#######.###########.##
...#.#...#.#.......#.#...#.......#T
.#b###.#.#########.#.#.#.#.#######.
.......#.........#.#.#@#.#.#...#...
.#############.###.#.###.#.#.#.###.
...t...#.....#.....#.#...#...#.#...
##.#.###.###.#######.#.#.#####.#.#.
...#.....#.........#.#.c.#.#...#.#.
.S##.#####.#######.#.#.#.#.#.###.#.
.#...#.....#.....#.#.#.#...#...#.#.
.#####.#####.#####.#.#.#######.#.#.
.......#...s.........#...........#.
35 35
...#.........#.....#..a#.......#...
.#.#.#######.#.###.#.#.#.###.###.#.
.#.#...#r#...#.#...#.#...#.#.....#.
.#.##s.#.#.###.#.#####.###.#######C
.#...#...#.....#.....#...#R..#...#.
.R.#####.###########.###.#.###.#.#.
.#.......#.....#...#...#...#...#.#.
.#########.#.#.#.#.###.#####.##R.#.
...#...#...R.#...#.#.#.a...#...#...
##.#.###.###.#####.#.#.#.#.#.#.##Q.
...#...#.T.#...#.#...#...#.#.#.#.#.
.#####.###.r##.#.###.#####.#.#.#.#Q
.#.......#.#.#.#.#...#...#!#.#.#...
.#.#######.#.#.#.#.###.#.###.#.####
.#...#..t#.#.#.#...#...#.#...#.....
.###.#.#.#.#s#.#.###.###.#######.#.
...#.#.#.#.#.#.#...#.#.#.......#.#.
##.#.#.#.#.#.#.###.#.#.#######.###.
.#.#.#.#..C..#.#...#.#.......#...#.
.#.#.#.#######.#.###.###.###.c##.#q
.#.#...#...#...#.#.....#.#...#...#.
.#.#####.#.#.###.#####.#.###.#.###.
.#.#.....#...#.#.#.....#...#.#.....
.#.#.#########.#.#.#####.#.#.#####.
.#.#.#.........#...#.#...#.#.....#.
.#.#.#.######T######.#.###.###.###.
.#...#...............#...#...#.#...
.#####.############b.###.###.###.##
.C.....#.....#@#.......#...#t#...#.
.##S####.###.#.#S#########.#.a.###.
.#.......#...#.#.#.....#...#...#...
.#.###.###.###.#.#.###.#.##S####.##
.#...#...#...#.#...#...#...#.......
.#######.###.#.#####.#r###.####S##.
.........#.....q..b#...............
35 35
.............#.........#...........
.###########.#.#.#####.#########B#.
...#...........#.#...#.........#...
.#.#.#############.#.#########.#.#.
.#.#.#...#.....q.#.#.........#.#.#.
##.#.###.#.#####.#.#########.#.#.#.
...#.....#.#...#...#...t.#...#...#C
.#######.#.#.#.#######.#.#.########
...#...#.#...#.#.....Q.#.#.....#...
##.#.#.#.#####.#.###.###.#####.#.#.
...#.#.#....@#.t.#...#.#.#...#.#.#.
.#####.#.#####.###.###.#.###.#.#.#.
...#!#...#.....#...#...#.....#...#.
.#.#.#####.#####.###.#.#####.#####.
.#.#...#...#.....#...#.#....R#...#.
##.###.#.#######.#.#####.#####.##b.
.....#...#.......#.s...........#...
.#.#######.#.#########s#########.##
.#.#.......#.....c.............#...
.#.#.######T######A#####A#####.###.
.#.#.s.#..........S......#...#.....
.#.###.##########s##.###.#.#.##S###
.#.#...#.....#.......#.#.#.#.....#.
.###.###.###.#.#######.#.#.###.#.#.
.#...#...#.....#.....#...#.#...#.#.
.#.###.#########.#.###.#####.###.#.
...#...#...#.#...#t..#.#.....#...#.
.###.#.#.#.#.#.#####.#.#.#####.###.
.#S..#...#.#..qs.....#.#...#.#.....
.#######.#.#.#s#.#.###.###.#.#####.
.#.....#.#.#.#.#.#.#..A#..A#.......
.#.###.###Q#.#.#.###.###.###.######
...#.#.....#.#.#...#.....#...#...#.
####.#######.#.###.#######.###b#.#.
.................a......a......#..b
