abcdefghijklmnopqrstuvwxyz-=[];/
ABCDEFGHIJKLMNOPQRSTUVWXYZ_+{}:?
OOOOOOOOOOOOOOOOCCCCCCCCCCCCCCCC
7
21 21
.........#...#...#...
.#######.#.#.#.#.#.#.
A..#.....#@#.#.#...#.
.#.###.#####.#.#####.
.#...b.......#.#.....
.###.##S###q##.#.###.
...#.....#...#.#q..#r
#r.#####.#.#.#.###.#.
...#...#...#...#.#.#.
.###.#.#########.a.#b
R..#.#.......#...#...
##.#####.###.###.###.
.#.....#...#...#.R.#.
.####b.###.###.t##.#.
a.q..#.#...#.#.....#.
.###R#.#.###.S.#####.
.#.......#.....#.....
.R.#A#####.###Q#.###.
.#.#...#!#.#.....#...
.#.#.#.#.###.#####.##
QB...#.#.....#.......
21 21
...#...#...........#.
.#.#.#.#####B#####.#.
.#...#...T...#@......
.#.#######.#########.
.#.R...S...#.......#.
.###.#.#.###.#####.#.
S....#.#...#.#...#s#.
.#####.#####.#.###.B.
.#...#.....#Q#.#...#.
##.#.#b#.#.#.#.#.####
!#b#...#.#.....#.....
.#.###.#.#######.###.
.#.A...#.#.....#.#...
.#.###.###.##S.###.#.
.#...#c....#.C.....#.
.###.#######.#######.
...#.#.#.......#...b.
##.#.#.#.###.###.#.#.
.#...#..r#.#.....#.#.
.#####.###.#######.#.
.........S.......#...
21 21
...#.................
.###.#####.A########.
...#.#...#.#...#.....
.#.s.#.###.#.###.####
.#.....#...#.#...#...
########.#Q#.#.###.#.
.......#...#...#...#@
.#####.#.#.###.###.##
...#...#.#...#...#...
##.#.#######.###.#.#.
...#.........#...#.#.
.###########R#.#c###.
.#!#.........#.....#.
.#.#.###.#########.#.
...#.#...#.......#.#.
#t##.#.T##.#.#####.#.
.....#...#.#.......#.
.#######.#.b########.
.......#.#.#...#...#.
###B##.#.#.#.#.#.#.S.
.......#.....#...#...
21 21
.....#......@#.......
.###.#.#.#####.#####.
...#.#.#.......#.....
.#.#.#####.#####.###.
.#.#.....#.#...#...#.
.#.#####.#.###.###.#.
.#.#.#...#.....#...#.
##.#.#.#########.###.
...t...t.........Q...
.#####.#.#########.##
.....#...#.......#...
.###.#####.#####.###.
.#...#...#.#...#.....
##.###.#.#.#.#.######
...#!..s.#...#...B...
.#######.##########q.
.#.....#...#.......#.
.#.#.#####.#####.#.#.
...#.....#.....#s#.#.
.#######.#####.#.#.#.
.......#.......t.#...
21 21
.....#...............
.###.#.#######.#####.
...#.#.c.......#...#.
.#.#.#.#.#######.#.#.
.#.b.#.#...#...#.#.#.
##.###.###.#.#.#.t.#.
...Q...#...#.#.#.#...
B###.###.###.#.#.####
.....#...#...#.#.....
####.#.####B.#.#####.
...#.#...#...#...#.#.
.#.##T##.#.#####.#.#.
.#...#...#...#@#.#.#.
.###.#.#####.#.#.#.#.
.#.....#.....#.....#.
.#######.#######.###.
.....#.........#.#...
.###.####T####.###.##
...#...#.......#...#.
######.#.#######.###.
!......#.............
21 21
..R#.......#.........
.#.#.###.###.#.#####.
.#.#...B.....#...#...
.#####.#########.#.##
...#...#.#......R#..@
##.#.###.#.######B###
...#.....#...........
.###Q###.###########.
.....#...#.....#.....
####.#.###.#####.####
.....#.#.#...#!..#...
.##r##.#.#.#.#######.
.#...#.#.C.#.........
.#.#.#.#.#########.##
.#.#.#.#.....#...#t..
.#.#.#.#####.#.#.###.
.#.#c#.#.......#.#...
.#.#.#.#.#########.#.
...#.#.#.#.........#.
.###.#.###.##a######.
...#.......#.........
21 21
...........#.........
####.#####.#.#####.#.
....A#...#.#...#.#.#.
.#####.#.####Q.#.#.#.
.......#.........#.#.
.###########b#####.#.
.#.......#...#.....#.
.###.#####.#.#.#####.
.....#..a..#!#.#...#.
##.###.#######.#.#.#.
...#...#.........#.#.
.###.#############.#C
.#.#...#.........#.#.
.#.###.#.#######.#.#.
.#...#.#.#...#...#.#.
.###.#.#.###.#.###.#.
...#.#.#...#...#...#.
##.#.#.###.#.#####.#.
.#...#.#...#.....#.#.
.###.#.#.B######.#.#.
.....#...#S.A....t.#@
