abcdefghijklmnopqrstuvwxyz-=[];/
ABCDEFGHIJKLMNOPQRSTUVWXYZ_+{}:?
OOOOOOOOOOOOOOOOCCCCCCCCCCCCCCCC
11
17 17
.................
.#Q##q##########.
..........!#.....
#B##########.####
.#.....#.....Q...
.#.###.#.#####.#.
...#...#.....#.#.
.###.#######.###.
...#.........#...
##.###########.#.
@#..........c..Q.
.###############.
.....#.......#...
.#####.###.###.##
.....#...#.....#.
.###.###.#######.
...#.............
17 17
.....#.....#.Q...
.#.###.#c#.###.#.
.#.....#...#...#.
.#######.###.####
.#.....#.#.......
.Ra#.#.#.###.###.
.#...#.#...#.#...
.#.###.###.#.#.#.
...#...#.#.#.#.#.
####.###.#.#.#.##
...#.#...b!#.#...
.#.#.#.#####.###.
.#.#.t.........#.
.###.###.#######.
...#...#..@#.....
.#.###.#####.###.
.#...........#...
17 17
...#.........#T..
.#.#######.#.#.#.
.#.........#.#.#.
.###########.t.#.
.#.....#...#.#.a.
.###.#.#.#.#.#.#.
...#.#...#.#...#.
.#.#.T####.#.###.
.#.#.....#@#.#!#.
##.#####.###.#.##
...#...#.....#...
.###.#.#########.
...#.#.#.....#...
.#.#.#.#.###.#.##
.#t#.#.#.#.#...#.
.#.#.#r#.#c#####.
.#...#...........
17 17
........s#.....#.
.#.#####.###.#.r.
.#.#...B.....#.#.
.#.###.##A####.#.
.#.#..T..#...#.#.
.#.#.###.#.###.#.
.#.#.#.....#...#.
.#.#.#####.#.###.
.#.#.....#.#...#.
.#.#.###R#.###.B.
.#.#...#.#..@#...
##Q#.###.#######.
...#.#!#...#...#.
.###.#.#.#.#.#.#.
...#.#.#.A...#...
.#.###.#.########
.#.....#........A
17 17
.#.....#.......c.
.#.###.#.#.###.#.
.....#...#.#.#...
.#########.#.###.
...#...#...#.....
##.#b#.#.########
@#.#.#...#.......
.#.#.#####.#####.
.#.#.#.........#.
.#.#.#.#R##T####.
...#...c.#q#...#.
########.#.#.#.#.
.......#...#.#.#.
.#.###.###.#.c.#.
.#.#!#.#...#.#.#.
.###.#.#####a#.#.
.....#.......#...
17 17
.....#@q.........
##.#.#.#.####r.##
...#...#.....#...
.###.#######.###.
.#...#.......#.#.
.#####.#######.#.
.#...#...#.....#.
.#.#.###.#.#####.
...#...#...#.....
.#####.###.#.###.
.#...#...#.#..q#.
.#.#.###.#.###.#.
...#.#.#.#...#.#.
####.#.#.###.#.##
...#.#.#.....#...
.###.#.#########.
.............#!..
17 17
.........#.......
.#.#####.#.###.#.
.#@#...#.#...t.#.
.###.#.###.###.#.
.....#.....#...#.
.###########.###.
.#.........#.#...
.#.#####r#.#.###.
.#...#...#.#...#.
.###.#.#.#.###.r.
...#.#.#.....#.#.
##.###.#####.#.#.
.#.....#..!a.#.#.
.##b.###.####R.#.
...#.#...#...#.#.
.###.#.###.#.#.#.
.....#.....#...#.
17 17
.a.#...t...#.....
.###.#.#####.#.#.
.....#.#.....#.#.
.#####.#.#####.##
.#...#...#..b#...
.#.#####.#.#.###.
.#.#..!#...#R..#.
.#.#.#######A###.
.#.#.#...C...#...
.#.#.#.#.#.#s#.#.
...#.#.#.#...#.#.
##.#.#.#.#####.#.
...#...#.....#.#.
.###########.#.##
.....#.R.....#...
####.#.#.#######.
@......#.........
17 17
.#..!#.......#...
.#.#####.###.#.#.
.#.#.....#.#.#.#.
.#.###.##s.#.#.#.
...#...#...#...#.
.###.#B###B#####.
.#...#...#.....#.
.#.###.#.###.###.
.#.....#...#.....
.#.#######.#.####
.#..R#.....#...#.
.###.#.#######.c.
.#...#.#.....#.#.
.#####.#.##S.#.#.
.......#...#.#...
########.#.#####.
@........#.......
17 17
.........#.......
######C#.#.###.#.
.........#.#.#.#.
.#########.#.#.##
.#...........#...
C#.#############.
.#...#.#.........
.###.#.#.#######.
...#...#.#.....#.
.#.###.#.#.###.#.
.#.....#.#...#.#.
.#######.#.c.###.
...#...#.#.#.....
##C#.#.#.###.####
...#.#.#...#.#@..
.#.#.#.###.#.###.
!#...#.....#..C..
17 17
.#...........#...
.#.#######.#.#.#.
.#.....#t#.#.#.#.
.#s#b#.#T#.###.#.
...#...#.#...#!#.
.#.#.###.###.###.
.#.#.#...#...#...
.###.#.#.#.###.##
.#.A.#.#.#.....#.
.#.###.#########.
.#.#R..q.....#...
.#.#######.#.#.#.
.#.#.......#...#S
.#.#.###########.
...#.#...#.......
.###.#.#.#.######
.....#.#........@
