abcdefghijklmnopqrstuvwxyz-=[];/
ABCDEFGHIJKLMNOPQRSTUVWXYZ_+{}:?
OOOOOOOOOOOOOOOOCCCCCCCCCCCCCCCC
7
17 17
!..#.............
##q#######.#####.
.#.......#.#.#...
.##x####.#.#.#.##
..W..#...#.#...B.
.###.#.###.#.###.
...#.#.....D.#...
##.#.#####G#.G##.
..C#......@#.#...
.###.#######.#X##
.#.#...#...#.#...
.#.###.#.#.#.###.
.#...#...#.#...#.
.###tC###C.###.#.
...#...#.....B...
##.##X.#.QW##r#D.
.......#.........
17 17
@#...#E........#.
.#.#.#.#.#####.#.
...#...#.#.......
.###F###.#e######
...C.#.#...#.....
####.#.###.#.###.
...#.....#.W.#!..
.C.#####.#.b.c###
.c...r...#.#.#...
.###.#####.#.#.#.
.#.....#...#.#.#.
.#####.#.#.g.#.#.
...#.....#.#.#.#.
.#b#.######e.#.#.
.#.#.#.....#.#.#.
.#.###.###.#.#.#.
.#.......#.....#.
17 17
...#...........#@
.#.#.#########.#.
.#...#.........#.
.#.###t#####.###.
.#.#.......#.#...
.###.##r##.#.R##.
.....#.#...#.....
.#R###.#.###c###.
.#.....#...s.#...
.#.#########.####
.#.........#..Q..
.#.#######.t####.
.#.#.....#...b!#.
.#.#A###.#.#U#.#r
.#.X.#.#...e.#.#.
.###.#.#####.#.#.
.....T.......#...
17 17
......@#.....#...
.#######.#.#.#.#.
.#.w.#...#.#.#.#.
.#.#.#.#a#.###.#.
.#.#...#.#.....#u
.#.#####.####Dr#.
..VF.....#...#...
.###.###.#.#.#.#.
...#.#.....#.#t#.
##.#.##D.#####.#.
d..#...#.#..!#.#.
.##B#e.#.#.###.#.
...#...#g#.#...#.
##.#.#####.#.###.
...#g..#...#.#...
.#####.#.###.#.##
.......#.....s...
17 17
....S....#.......
.#######.###.S##.
.#.....#.....#...
.#####.#######.C#
.#...#.......#.#.
.#.#.#.C####.#.#b
.C.#...#...F.#...
.#.###t##T.#.#c#.
.#...#...#...#...
.#x#.#.#.##R.#.##
...#...#f..#.#.#A
.#.#.#####.#.#.#.
.#.#.#...#x#@#...
.#.#.#.###.#####.
.#.#.#.#...#...#.
##.#.#.#.###.#.#.
!..B...F.....#...
17 17
...#.......#.....
.#.###.###.#####.
.#.....#.#.......
.#######.#D#####.
.#...#...#.....x.
.#.#.###.#.#Xr.#.
.T.#...#.#.#.#...
####.#R#.#.#.####
...#.#.#.#...#...
.#.r#u.#.###.u.##
.#!#...#.e...#...
.###.###.#######.
.#...#@#.....#..X
.V##.#.#####.#.e.
.#...#.....#...#.
.#.###G#.#######.
...#...#.........
17 17
.......#.....#!#s
.e##e###.#bd.#.#.
.........#...#...
a####C####.####W.
...v.#G..A.....#.
#T##.###.#####.#.
..d#.....a...#...
d####C##.#X#.####
.......#.....B.#s
.###.########E.#.
.#.#.....#...#...
D#.###.#.#.#.###.
...#...#...#.#...
##.#.#########.##
...#.........#...
.####d######.###.
F.........@#.c...
