abcdefghijklmnopqrstuvwxyz-=[];/
ABCDEFGHIJKLMNOPQRSTUVWXYZ_+{}:?
OOOOOOOOOOOOOOOOCCCCCCCCCCCCCCCC
7
21 21
...............#.....
.#.###########.#.###.
.#...#.........#.#.#.
###B.#.######Q##.#.#.
.....#.#.......#.#...
.#####.#.###q###.#.##
.#.....#...#.....#.#.
.#a###.###.#.#####.#.
.#!..#...#.#...#...#.
.###.###.#.###.#.###.
...#.#s....#...#.#...
##.#.###.###.###.#.S.
...#...#@#...#.#...#.
.#####.###.###.#####.
.#...#...#.#.....#...
.#.#.###.#.###.#.#.q#
...#...#...#...#.#.#.
.###.#.#####.#####.#.
.#.#.#.#...#.....#...
.#.R.###.#.#.###.###.
...#.....#.....#.....
21 21
...............#.#...
##.###.#######.#.#.#.
...#...#.....#.#...#.
.#######.###.#.#.###.
.......a...#.#.#.#.#.
############.#.#.#.#.
.......#!#...#.#...#.
.q##.#.#.#.###.B####.
.C...#.r.#...#.....#.
.#.#####.#.#.#####.b.
.#.....#.#.#...#.#.#.
.#####.#.#####.#.#.#.
.#...#.#.c.....#.#...
.###.#.#.#.###TA.###.
.#...#.#.#.#.#.......
.#.###.#.#.#.#.###a##
...R...#...#.#...#...
##.#.#######.###.#.#.
.#.#.............#.#.
.#.#Q#######s#####.#.
...................#@
21 21
.S.........t..c......
.#####a###.#.#.######
..S..#.....#.#.#.....
.###.#.#######.S.###.
S..#.#.........#...#.
####.#######.###.###.
.....#...q...#...#...
.#Q###########.###.#.
.#.............#...#.
.#.#############.###.
...#.....#...#.#...#.
.###.###.#.#.#.###.##
.#.....#Q..#.....#...
.#####.#########.###.
.#.....#.#.....R.#.#!
.#.C####.#.#######.c#
...#.....#.Q.........
####.#.###.#.#.###q#.
...#.#...#t#.#.#.#...
.#.#.###.#.###.#.#.##
.#....@#.......#.....
21 21
.................#...
.###########.###.#.#.
.#.........#.#...#.#.
.#r#######.###.###.#.
.#...#...#...#.....#A
.###.#.#.###.######c.
s#...#.#...#.#.......
.#.#######.#.#.######
.#.#.....#.#...#.....
.#.#.###.#.#####.###.
.#.#.#bS.#...#...#.#.
.#.#.#.#.#.#.#.###.#.
.#...#.#.#.#...#....S
.#####.#.#.#########.
.#.....#!#.........#.
.#.###.###########.#.
.#...#.#....C..#...#.
.###.#.###.###.#.###.
...#.#.....#.#...#.#.
##.#.#######.#####.#.
.....#@..............
21 21
.............#@......
.#.#########.#######.
.#.......#.......#...
########.###t###.#.##
.........#.....#.#...
c#######.t.###.#.###.
...#.....#.#.#.#...#.
.#.#####.b.#.#.###.#.
.#.#...#.#...#.#.#.#.
.#bq.#.###.###.#.#.#.
.#...#.....#...#...#.
############.###.###.
.............#.#...#.
.#############.###.#.
..!#.....q.#.....#.#.
####.#####.##t.#bs.#.
R..#a....#.....#.#...
.###.###.###.#######.
.....#.#...#.#.....#.
.a###C.###.###.#.###.
q........#.....#.r...
21 21
.....#...#.c.........
.###.#.#.#.#####.###.
.#!..#r#.....#.#r..#.
.####q######.#.###.##
.#.......#.......t...
.#.#####.###########.
.#.....#...#.......#.
.#.###.###.#.#####.#.
.#.#.#.#.#...#...#.#s
.#.#.#.#.#######.#.#.
.#.a.#.#..q...t..#.#.
.###.t.#####.#Q###.#.
.#...#.....#.#.......
.#####.###.#######q#.
.....#...#.......#...
####.#####.#####.#.##
...#.....#...#...#...
.b.#####.###.#.#T###.
.#.....#...#.#.#@#...
.#.#######.##a.#.#.#c
.#.............#.....
21 21
.#!......#.....#...#.
.#######.#.###.#.#.#.
.......#.#...#...#.#.
.#####.#.###.#####.#.
.#.....#...#.#.#...#.
.#.#######q#.#.#.###.
.#.......#...#b#.#...
.#######.#####.#.#.#.
...#...#.....#.#...#.
##.#.#.###.#.#.#####.
.#...#...#.#.......#.
.#.#######.#######.#.
..T#.......#.....#.#.
.###.#.#####.###.###.
...#.#.#...#.#.#...#.
.###.###.#.#.#.s##.#.
.#...#...#...#...#...
.#.###.#######.t.####
.#...#...#.....#.....
.###.###.T########.#.
..@#............B..#.
