abcdefghijklmnopqrstuvwxyz-=[];/
ABCDEFGHIJKLMNOPQRSTUVWXYZ_+{}:?
OOOOOOOOOOOOOOOOCCCCCCCCCCCCCCCC
7
35 35
.......#...a...#.......#...........
.#####.#.#.#.###.#.###.#.#######.#.
.#@..#...#.#.#...#...#.#...#...#.#.
.#c#.#####.#.#.#####.#####.###.#.#.
...#.#...#...#...#.#.....#.....#.#.
.#.#.#.#.###.###.#.#####.#####.T.##
.#.#...#.....#.#.......#.......#...
##.#########.#.#####.####S####.###.
...#.......#.....#...#.......#...#.
.###.#####.###b###.###.r####.#b###.
.....#.....#.......#...#.b.#.#.#...
.#####.#####.####t##.###.###.###.#.
...#.#.........#...#.#.#...#..Q..#.
##.#.######s####.#.#.#.#.#.#######.
.#.....#.....#...#...#...#...#.....
.#####bq.###.#.#rQ######.#.###.####
...#...#.#.#...#.......#.#r..#.#...
.###.###.#.#.###.#####.#####.#.###.
...#.B.#.#...#...#...#.#...#.#.....
.#.###.#.#####.#####.#.#.#.#.##s##.
.#.....#.q...#.......#.#.#.#....T#.
.#######.#.#.#######.#.#.#.###.##b.
..s....#q#.#.#.....#.#...#...#.....
####.###.r.#.#.#.###.Q######.#.####
...#.#...#.#...A.........#...#.....
.#.###.##S.###############.#######.
.#.#...#...........#.......#...#...
.#.#.###.#######.###.###t###.#.#.##
.#.#.....#.....#.#...#.......#.#...
.#.###R#.#.###.###.###.###########.
.#.....#.#.#.#.#...#.#...#.......#.
.#####.#.#.#.#.#.###.#.#.#.#####.#.
.#...#!#.#.#.#...#.....#.#...#.#.#.
.#.#.#####.#.#####.#####r###.#.#.#.
...#.......#.....t.C...#.......#...
35 35
...T...#@............#...#.......#.
.#####.#############.#.#.#.#####.#.
.....#...............#.#.#.....#...
.###.#####.###########.#.#C#.#.####
.#...#...#.#.....#...#.#...#.#.#...
##.###.###.#.###.#.#.#.###.#.#.#.#.
...#.......#...#...#...#R#.#.#...#.
.#####.#######.#########.#.##b##.#.
.....#...#...#...#.....#.#.....#.#.
####.###.#.#####.#.#.#.#.#####.###.
...#.#...#.....#.#.#.#A..#.#...#...
.#.#.#.A####.###.#.#.###.#.#.q##.#.
.#...#.#...#.#...#.#.#...q.#.#...#.
.#####.#.#.#.#.#####.#######.#.#.#.
.#...#.#.#...#...#...#.....#.#.#.#.
.S.#.#.#.#b###.#.#.###.###.#.#.#.##
...#.#...#...#.#.#...#.#.#...#.a...
####.#####.#.###.###.#.#.#####.###.
.....#.....#...#...#...#.....#.#...
.###b#.#######.###.#.#####.#.###.#.
.#..Q#!#.#...#.....#.....#.#....r#.
.#.#####.#.#.###########.#.#.#####.
.#.#.....#.#.....r...#...#.#.#...#.
.###.###.#.#.##C.#.#.#.###.###.#.#.
...#.#.#...#...#.#.#.#...#.....#.#.
.#.#.#.#######.#.#.#.###.#.#####.#.
.#.#.........#.#.#.#.....#.B.#...#.
#a.#b#######.#.#.#.###########.###.
.....a...r...#.#.#.#...#.......#...
.#s#######.###.#.#.#.#.###.#####.##
...........#.#.#.#.#.#.#...#.#...r.
.###########.#.###.#.#.#.###.#.###.
.#.......C...#...#...#.#.#.....#...
.###.###.###.###.#####.#.#.#####.#.
.....#.........#.........#.......#.
35 35
.................#...#.....#.......
.#####.#######.###.#.#.#.#R###.###.
.#...#...#...#.....#...#.#.....#.#.
##.#.###.###.###########.#######.#.
...#.#........S....#...#...#.....#.
.s##.#.#######.#####.#.###.#.#.###.
...#.#.#.....#.#...#.#.....#.q...#.
.#.#.###.###.###.#.#.#######.###.#.
.#.#.....#...#...#...#.....#.#@S.#.
.#.##r##a#.###.#######.#.###.#.#.#.
.#...#.#...#...#.......#.....#.#...
.###.#.#.#####.#.##########A.#.####
s#.#.#...#.....#.#.........#.#.....
.S.#.#.#####.###.#.#######.#.###.S.
...#.r.#...#.a...t...#...#.#...#.#.
.###.#.#.#.#.#.#####.#.#.#.###.#.#.
.#...#.#.#.#.#.#.....#.#.#...#...#.
.#.#S#.#.#.#.#.#.#######.###.#.####
.#...#...#...#.#.......#...#.#.#...
.###.#################.#.#.#.###.#.
.#.#.....................#.#.....#.
.#.###############################.
.....#..Q......#...........#.....#.
####.#.###.#####.#########.#.###.#.
...#...#...#.....#.......#.#...#...
.#######.###.#####.###.###.#.#.###.
.#.....#q#.#...#R#...#.#...#.#...#B
.#.###.#.#.##t.#.###.#.#.###.###.##
.#...#...#...#.#...B.#...#.#.#.#...
.S##.#######.#.#.#.b.#####.#.#.Q##.
...#.c.#.....#!#.#.#.#...b.......#.
.#.###.###.#####.###.#.#.#########.
.#...#...#.......#...#.#.........#.
.#.#####.#######.#.###.#########.#.
.#..T............#.....#...........
35 35
.....#!#.#.................#...#...
.###.#.#.#.####b.#########.#.#.###.
...#...#.#.#...#.#.....#...#.#...#.
##.#####.#.#C#.#.#.#####.###.###.#.
.#.#...#...#.#.s.#.#.....#.....b...
.#.###.#.###.#.#.#.#.#####.###.###.
.#...#..r#...#.#.T.#.#@#...#...#.#.
.###.#.#t##q.###.#.#.#.#.###.###.#.
...#.#.#.....#..c#...#.....#.#.....
.###.#.#.#####.###.#########.#.####
.....#...#...#.#.#.....#...s.#.....
.#####.###.#.C.#.#####.#.#.#.#####.
.....#.#...#...#.......#.#...#...#.
####.###.#######.##t####.#####.###.
...#.....#...#...#.....#.#...#.....
.B########.#.#.####Q.#.#.#.#.#.####
.#.......#.#.#.......#...#.#.#...#.
q#.###.###.#.#############.#####.#.
.#...#..S..#...#.....#...#.....#.#.
.###.####Q##.###.#.###.#.#.###.#.#T
.#...#...#...#...#.#.r.#...#.#...#.
.#.###Q#.#.###.###.#.#######.a##S#.
...#...#.#.....#.#.#.#B....#.....#.
.#q###.#.#######.#.#.###.#.#.###.#.
c....#.#.....#...#...#...#.#.#.#...
####.#.###.###.#T#####.###.#.#.###.
...#.#..R#..s..#.....q.#.#...#t..#.
.###.#############.#####.#####.#.#.
...#...#.......r...#.#.........#.t.
##.###.#.#####.#.###.#.#######.#.#.
.....#...#.b...#...#.#.#.....#.#.#.
.#########.#######.#.#.###.###.#.#.
.#.....#...#.....#T#.#.....#...#.#.
.#.###.#.#####A#.#.#.#####.#.#T###.
...q.#.........#...#.......#.......
35 35
...q...#...#.....#.....#...........
.#######.#.###.#.###.#.#######.###.
...#...#.#.....b.....#.#.....#...#.
.#.#.#.#.#############.#.###.###.#.
.#.#!#.#.#...#.......#...#.#.....#.
C#.###.#.###.#.#.######b##.#######.
.#.#...#.#...#s#...............#...
.#.#.###.#.###.######T.###.#####.##
.#.#...#.#...#.....#.#...#.#.....#.
.#.###.#.###.#####.#.###.#.#.#####.
.Q...c.#...#...........#.#.#.....#.
####.#.###.###.#######.#.R.#####.#.
.....#...#...#.#.#...#.#.#.#...#.#.
.###.###.###.#.#.#.#.###.#S#.#.#.#.
.#.#.#.#.....#.#.#.#...#.#.#.#.#...
.#.T.#.#######.#.#.###.#.#.###.###.
.#.#.......#.....#...c...#.....#.#.
.#.#.#####a#.T######.#S#######.#.#.
.#...#.....#.#.#.....#.......#...#.
.##q##.###.#.#.#.#####.#.##b####.#.
.....#.#.#...#sR.....#.#.#...#...#.
.###.#.#.#####.#####.#.#.#.#.#.###.
.#...#.#.........#...#.#@#.#...#...
##.#.#.#######.#.#.###.###.####b.##
...#.#...#.B.#.#.#...#.....q...#...
.###R###.#.#.#.#.###.#.####s.#.###.
....a#....A#...#.#...#.#..s#.#...#.
.###.#.#####.#####.#Q#.#.#.#.###.#.
...#...#...#.#.....#.....#.#.#.#...
########.#.###.#########.###.b.####
.......#.#...#...#.....#.#...#.....
.#####.c.###.###.#.###.#.#.##r##.#.
.#...#...#.......#.#.#.#.#.A...#.#.
.#.#.#############.#.#.###.#.#.#.#.
...#.................#.......#...#.
35 35
...#.....#.......#.....#.......t...
.#.###.#.#.C####.#.###.#r#######.#A
.#.....#.#.#.#...#.#.#.#.#...#...#.
.#######.#.#.#.###.#.#.###.#.#.####
...#...s.#...#.C.#.#.#.....#.#....b
.#.#.#.#####.###.#.#.B######.#####.
.#...#.........#.#.#.......#.#.....
.###############.#.###.#.###.T.###.
.#...#.....#.....#!#...#.#...#.#...
.#.#.#.###.#.q##.###.#####.###.#.##
.#.#...#.....#...#.#.......#...#.#.
.#ts#C########.###.#.#######.#.#.#.
.#...#.......#.....#...#.....#.#...
.###.#.#####.#####.###.a.#####.###.
...#.....#...#...#...#.#.....#...#.
##.#######.###.#.#.###.#########.#.
.....#.....#...#@#.#...#.........#.
######.#######.###.#.#B#.#T#######.
.......#.......#...#.....#.....#...
.#######.#.#####.#########.###.#.##
.......#.#.#.............#...#.#...
.#####.#.#b#.###########.#.#.#####.
.#.#...#.........#.....#.#.#.#...#.
.#.#.#.###########.###.###.#.#.#.#.
.#.#.#.#...........#.#...#.#...#...
.#.#.#.#.###########q###.#.########
...#.#.#.#............A#.#...#.....
##.#.#.#.###.#########.#.###.#.####
...#.#.#...#.....b...#.#.....#.....
.###.#####.#.#####.#.#.#########.#.
...#.#.....#.c...#Rs.#...#.....#.#.
##.#.#.#####.#.#.#.#.###.#.###.###.
.#.#.#...#...#.#.#.#.#t#.#.#..C#...
.#.#.###.#####.#.###.#.#.#.#.###.#.
...#...........#.....#....a#.....#.
35 35
...#..A....#...#.........#.......#.
.#.###.###.#.#.#.#####.###.###.#.#.
.#.....#...#.#b#.#...#.......#.#.#.
.Q########.#.#.###.#.#######.#.#.#.
.........#.#.#.....#.#.....#.#.B.#.
.#####.S.#.#.#######.#.###.###.#.#.
.#...#.#.#.#.....#...#.#...#...#...
##.#.###.#.#.###.#.###.#.#a#.B###t.
...#.....#.#...#.#.q...#.#...#.....
.#####B###.#####.#.#.###.#.s.######
a#...#...........#...#.#.#.#.......
.#.#.#################.#.#.#######.
...C...#.....#!#.#.....#.#...#.#...
R#####.#.###.#.T.#.###.A.###.#.#.#.
.....#.#.#...#.#...#...#.#...A.#.#.
.#####.#.#.###.#.###.S.#.#.###.#.#.
.#...#...#.....#...#.#.#.A.....#.#.
.#.#.#############.#.###.#######.##
...#...........#...#.#...#.....#...
.###.#.#######.#.###.#.###.###.###.
.#.#.#.#...#...#...#.#.....#.#...#.
.#.q.###.#.#######.#.#######.###.#.
.#.q.....#.......#.#s#.........#...
.#.t#Q########.#q#.#.#.#######.###.
...#@..#.....#.T...#.#.#...#.#.#...
##.##q.#.###.#.#.###.s.#.#.#.#.#.##
.#...#.#...#.#.#.#.#.#...#...#.#...
.###.#.###.#.#.t.#.#.#######.#.###.
.#...#...q.#.#.#...#.....#...#.....
.#.###.#.S.#.#.###.###.###.########
...#...#.#.#.#...#...#...#.....#...
.###.###.#.#.#.#####.###.#####.#.##
.#...#...#.#...#.....#.#.......#...
.#####.#R#.#####.#####.###########.
.......#.#.........................
