abcdefghijklmnopqrstuvwxyz-=[];/
ABCDEFGHIJKLMNOPQRSTUVWXYZ_+{}:?
OOOOOOOOOOOOOOOOCCCCCCCCCCCCCCCC
7
17 17
.........#.....#!
.#A###.#.#.#.###.
.#.#...#.#.#...#.
.#.#.###.#####.#.
...#.#.#...#...#.
####.#.###.#s###.
.....#.......#...
.#####.#####.#.a#
...#...#...#.#...
.#.##a##.#.#####.
.#.......#.......
.################
......r..#......@
########.###.#.##
R..#...#...#.#...
.###.#.###.#####.
.....#...........
17 17
.................
.###########.###.
...#.......#.#@..
##.#.####b.#.####
.R.#.#.....#.....
.s##.#.#####.###.
.#.#.#...#...#...
.#.#.##S.#####.##
...#.#.#.....#...
####.#.#####.#.#.
.....#.#.....#.#.
.#####.#.#######.
...#...........#.
.#.###########.#.
.#a....#!#...#...
.#####.#.#.#####.
.....#...#.......
17 17
...#.......#.....
.###.###.#.#####s
...#.#...#.......
.#.#.#.#########.
.#...#...#.S.....
.#######.#.#.####
.#.......#...#@..
.#.#######.#####.
.#.....#...#...#.
.#####.#.###.#.#.
.....#.#.#...#...
###q##.#.###.####
.......#.....#!..
.B########.#####.
.#.........#.....
.#########q#.####
.....A...........
17 17
......@#.........
.#######.###.###.
...........#...#.
.#####B#.##Q##.#.
.#.....#.#.....#.
##.###.###.#####.
...#.......#.#...
.###.#######.#.##
.#q#B..#...#.#...
.#.#.###.#.#.###.
.#.#.#...#.#.Q.#.
.#.#.#.###.###.#.
.#...#...S..!#...
.##a.#R#.#####.##
...#.#...#...#.#.
.#.###.###.###.#.
.#.....#.r.......
17 17
.#.............#.
.#.#.########b.#.
.q.#.#!..#...#.#.
.#.#####.#.#.#.#.
.#.......#.#.#...
.#########.#.###.
...........#.#...
.###########.#.##
.#...........#...
.#.###.#########.
.#...#.#.......#.
.###.###.#####.S.
..@#.#...Q...#...
.###.#.###b#.####
.#...#.....#.....
.#.#######.####s.
.#...............
17 17
...............#.
.#Q#.#########.#.
...#.b...#@......
##.#.#.#.#######.
...#.#.#.#...#.#S
.#####.#.#.#.#.#.
.#.....#.#.#.#...
.#.####Q.#.#.####
...#.#...#.S.....
S###.#.###.####S.
...S.#.....#...#.
####.#######.###.
...#.#.......#...
.#.#.#.#####s#.##
.#.#...#.....#..!
.#######.########
.................
17 17
.......b...#.....
.####b####.#.###.
.#...#...#.#..@#.
.#.###.#.#.B####.
...#...#...#.....
##.#.#######.###.
...#.#.#.....#...
.###.#.#.#.###.##
.#!..#...#.#.#.#.
.#####A#.#.#.#.#.
.......#.#.#...r.
######.###.#.###.
.....#.....#.#...
.#.#########.###.
.#.........#.....
.###R###########.
...#.............
