abcdefghijklmnopqrstuvwxyz-=[];/
ABCDEFGHIJKLMNOPQRSTUVWXYZ_+{}:?
OOOOOOOOOOOOOOOOCCCCCCCCCCCCCCCC
13
17 17
...........#.....
.#######.###.###.
...#...#.......#.
##.#.#.#########.
...#B#.#.........
.#####.#.#######.
.....#.#...#.....
####.#.###.#.##a#
..@#...#.B.#.....
.#####.#.#.#####.
.....#.#.#...#.#.
####.#.R.###.#.#.
...#.#.#...#.#...
.#.#.#.#.#.#.###.
.#...#...#.#...#.
.#########.###.#.
...........#!..#.
17 17
.............#@..
########.###.###.
.........#.#.#...
.#########.#.#.#.
.....#.........#.
.###.#.##s####B##
...#.#.#.........
####.###.#######.
...#...#.#.....#.
.#.###.#.#.###.#.
.#.....#!#...#.#.
.#########.#.###.
.#.........#.....
.#.##############
.#.#...#...#.....
.#.#.#.#.#.###.#.
.....#...#.s...#.
17 17
.............#...
##.#########.#.#.
...#...#...#.#.#.
.###.###.#.#.###.
!#.......#...#...
##.##C########.##
...#.......#.....
.###.#####.###.#.
.#...#...#...#.#.
.#.###.#.###.###.
...#...#...#.....
####.######R##S#.
..@#...#.......#.
.###.#.#.#####.#.
...#.#.#.#...#...
.#.#.#.#.###.####
.#...#...........
17 17
.....s.#@...C....
.###.#.#########.
.#...#.........#.
##.###########.#.
...#.........#...
.#####.#.#######.
.#.S.#.#.......#.
.#.#.#########.a.
.#.#...........#.
.#.#############.
.#.......T...#...
.#.#########.#.##
.#...#...#...#.#.
.###.#.###.###b#.
...#.#...c.....#.
.#.#.###.######q.
.#!#.............
17 17
.....#.....#.....
##.#.#.###.#.###.
...#.#...#...#...
.###.#.#.q####.##
.#...#.#.#...#...
.Q.#####.#.#.###.
.#.#.....#.#.#...
.#.#.#####.#.#.##
.#...#.....#...#.
.#####.#########.
...#.............
##.#######r###B#.
...#...#@#.....#.
.###.#.#.#.###.#.
.q...#.#.#...#...
.#.###.#.###.####
...#!..#.........
17 17
.#...........#...
.#.A####.###.#.#.
.......#.#.#.#.#.
########.#.#.###.
...#.....#.#.....
.#.#.#####.#####.
.#...#.......#.#.
.A####.#.R##.#.#.
...#...#...#...#.
##.#.#####.#####.
...#.....#.......
.#####.########aQ
.#@....#....a..#!
.#######.#####.#.
.......#...#.#...
.#####.###.#.R###
.....#...........
17 17
.#.........#.....
.#.#.#####.#.#.##
...#.....#.#.#...
.##C####.#.#.###.
.#...#.#.#.#.#...
.#.#.#.#.###.b.#.
...#...#.....#.#.
######.#######.#.
.......#...#...#@
########.#.#.T###
!....#...#.#.....
####.#.###.#####.
...#...#...#.....
.#.#####.###.###.
.#.....#...#.#...
.###.#####.#.#.##
...#.........#...
17 17
t........#.....#.
.#####.#.#.###.#.
.#...#.#.#.#..T#.
##.#.#.#.#.#.###.
...#.#.#.#t#.....
.###.#.#.#.#####.
.#.#.#.#.#.....#.
.#.#.#.#.#####.#.
!#.#...#.#.....#.
##.#####.#.#####.
.#...#...#.....#.
.#.#.#.#######.#.
...#...#.....r.#@
.#######.###.r.##
.#.......#.#.#...
.#####.###.#.###.
.......#.........
17 17
...........#.....
####.#.###.#.###.
...#.#.#...#.#.b.
.#.###.#####.#.##
.#....c#.....#.#.
.#####.#.###TB.#.
...#...#!#...#...
.#.#.#######.#c#.
.#.#.#.........#q
#q.##s.#.####t.#.
...#...#.#b....#.
.###.###.#####.#.
.....#.#.#...#.#.
.#t###.#.#.#.###.
...#...#.r.#.....
##.#.#.S#########
.....#..........@
17 17
.......#.........
.#####.##c.#####.
...#.......#...#.
##.#########.###.
@#.....#.#.....#.
.#####.#.#.###.#.
.....#.#...#...r.
.#.###.###.#.#.#.
.#...#...#.#.#.#.
.###.###.#.#.###.
.#.....#.#.#...#.
.r.#####.b.###.#.
.#.#!....r...#...
##.#########.####
...#...#...#...S.
.###.#.#.#B###.#.
.....#...#.......
17 17
.......#..!#.....
.#####.#.###.###.
...#...#...#.#.R.
.a.##r####.#.#.#.
.#.....#...#...#.
c#####.#.#####.#.
..A#...#.#.#...#.
.###.#.#.#.#.###.
.#...#.#.#...#...
##.###.#.#A###.##
...#@..#.....#...
.###########.#.#.
.#.R.....#.#.#.#.
S#.###.#.#.#.###.
.#...#.#...#.....
.###.#.#########.
.....#Q..........
17 17
.......#.........
.#####.#######.#.
.....#...#.....#.
.###.##C.#.#####.
.#...#.....#...#.
.#.###.#####.#.#.
.#.#...#.....#.#.
.#.#####.#####.#.
.#...#...#...#.#.
####.#.###.#.t.#.
...#.#..!#.#...#.
.#.#.#####.#####.
.#...#.....#...#.
.##C##.#####.#.#.
.#.....#...#.#.#.
.#.#####.#.#.#.#.
...#@....#...#...
17 17
...#.......#.....
##.#.###.#.#.###.
!#...#...#...#.#.
.###.#.#####c#.#.
...#.#.......#.c.
##.#.#######.#.##
...#.#.....#.#...
.###.###.#.#.###.
...#.....#.#.#...
##.#######.#.###.
.#...#...#.#...#.
.##C.#.###.###.##
...#.#.......#...
.#.#.###.#####.#.
.#.#...#@#...#.#.
.#.###.##qA#.###.
.#.........#.....
