abcdefghijklmnopqrstuvwxyz-=[];/
ABCDEFGHIJKLMNOPQRSTUVWXYZ_+{}:?
OOOOOOOOOOOOOOOOCCCCCCCCCCCCCCCC
3
17 17
...#.....#.......
.#.#.q.#.#######.
.#.#.#.#.....#...
.###.#.b####.#.#.
.#...#.#...#...#.
.#.###.#.#.#####.
...#...#@#.s..Q..
####.#####.#.####
.....r...T.#.....
A#####S#.#######c
...#.....#.......
.#.###.###.##R###
.q...#...#C..#...
####.###.###.###.
!..#.#.....#.....
##.#.#.######Q##.
.....#...........
17 17
.................
##B###.#########.
!....c.#.....#s..
#q##.#.###.###.#c
A#...#...#.....#.
.T.###.#.#.#####.
...#.#.#r#...#..q
.###.#.#.###.#.#.
.#.....#...#.#.#.
.#########.#.###.
.....#...#.#.....
####.#.#.#.#####.
.....#.#.q.#...#.
.#####.#####.#.#.
b#...B.#.....#@#.
.#.#####.#.#####.
...#.....#.S.....
17 17
.........#.......
.#.####a.#.#####.
.#.....#.#.#.....
####.#.###.#.###.
...#@#...#.#.#...
.#.#####.#.#.###.
.#...#...#.#...#.
.###.#.###.###.#.
...#...#...#...#.
.#.#####.###.####
.#.........#.....
.###############.
...#.#...#....!#.
##.#t#.#a#.#####.
.R.#.#.#...#.....
.###.#.#####.###.
.....#.......#...
