abcdefghijklmnopqrstuvwxyz-=[];/
ABCDEFGHIJKLMNOPQRSTUVWXYZ_+{}:?
OOOOOOOOOOOOOOOOCCCCCCCCCCCCCCCC
7
9 9
@#....a..
.#.#####.
.#!q...#.
.###.###.
....s#..A
.#.###.C#
.#...#...
.###.###.
...#.....
9 9
...#...#.
.#.#.#.#.
.#...#...
.#######.
.#!#.....
.#.###.##
.#...#...
.###.###.
.....#@..
9 9
........q
.###.####
.#@#....!
.#.######
.#.......
.###.###.
...#.#...
##.###.#.
.......#.
9 9
...#.b...
.#.#.###.
.#.#B#...
.#.#.#.##
.#...#.#!
.#####.#.
...t.#.#.
####.#.#q
@....#...
9 9
.........
.#######.
.#@....#.
.#t###.#.
...#!#.#.
.#.#.#.#.
.#.#.#.#.
.#.#.AC#.
.#...#...
9 9
.#.......
.#c###.r#
R..#@#...
.###.###.
.#.....#.
.#.#c###.
.S.#...Q.
##.#.####
...#....!
9 9
..T..#...
####.#.#.
...#...#.
.#.##T.#.
.#..!#@#.
.#######.
.#r..#...
.#.#.#.#.
...#...#.
