abcdefghijklmnopqrstuvwxyz-=[];/
ABCDEFGHIJKLMNOPQRSTUVWXYZ_+{}:?
OOOOOOOOOOOOOOOOCCCCCCCCCCCCCCCC
9
17 17
.................
.#########.######
...#@....#...#!..
##.#####.###.###.
...#.....#...#...
.###.#####.#q#.B#
.....#.....#...#.
######.#####.###.
.......#.....#..t
.#####.#.#####.#.
.#...#.#.#.....#.
.#.#.###.#.#.###.
...#.#...#.#...#.
.##R.#.######T.##
...#.#...#...#...
##.#.###.#.#.###.
...#.......#.....
17 17
.....#...#.......
.###.#.###.#c###.
.#...#.....#...#.
.#.###.#####.#.S.
.#.#.........#@#.
.#.#####.#######.
.#.....#.#.......
.#####.###.#####.
...#...#...C.....
.#.#.###.#####.##
.#.#...#.....#...
##.##t.#.#a#.###.
...#.#.#.#...#...
.###.#.###.###.##
!#...#...#.#.Q...
##.#####.#.#.###.
......c....#.....
17 17
.........#.......
####.###.#.b.####
...#...#.#.#@#...
.#.###.#.#.T##.c.
.#...#.#.#.....#.
.###.#.#.###.###.
...#...#...#.#...
.#.##Q####.a.#.#.
.#.#.......#.#.#.
##.#.#T#####.#.##
...#.....#..T#...
.######t.#######.
...#...#.#.....#.
.#.S.###.#.###.#.
.#.#.....#.#...#.
.#.#.#####.#.##T.
.#!#.......#.....
17 17
.#...#...........
.#.#.#.#####.###.
...#...#..Q#...#.
.#######.#.#####.
.b.#.#...#....r#.
##.#.#.#######.#.
.....#.#....@#.#.
.#####.#.#####.#.
.#.....#...#...#.
.#.#######.#.###.
.#.#.......c.#...
##.#C#######.#.##
...#.#...#.R.#...
.###.#.#.#.#####.
!#.#...#.#.....#.
##.#.###.#####.#.
.......#.........
17 17
...........#.....
.###.#####.#.CB#.
.#@#.#...#...#...
.#.#t#.#.#####.##
...#.#.#.....#.#.
####.#.#####.#.#.
.....#.#.#...#.#.
.#####.#.#.###c#.
.......#.#.#..B..
.#######.#.#####.
.#..B....#.....#.
.#.###.#######.##
.a...#......s#...
.#######.###.###.
.......#...#.#...
######.###.#.#.##
...........#.#..!
17 17
.#!#...#...C.....
.#.#.#.#######.#.
.#.#.#.........#.
.#.#.##########tb
.#...#...#.......
.b######.#.######
...#...#.#...#...
.#.#.#.#.###.#.#.
.#...#.#...#.#.#.
.#####.#.#.#.#.#.
.#.......#.#...#.
.#.#############.
.#..@#.........#.
.#####.#######.#.
.#...#.#...#...#.
.#.#.a.#.#.#.###.
...#.....#.#.....
17 17
S......#........@
.#####.#c#####.##
...#.#...#...#...
.#.#.###.#.#.#.#.
.b.#...#.#.#.#.#.
.#.#.#.#.#.#.###.
.#s#a#.#...#.....
.#.#.#####.###t#.
.#.#.......#...#.
.#.#########a#.##
.#.#.......#.#...
.#.#.#####.#.###q
.#.#...#.#...#...
.#.###.#.#####.##
.#...#.....#.#..!
.#.#######.#.##s#
Q#...............
17 17
.....#...#.......
.#.#.#.#.#######.
.#.#.S.#.........
.#.#.#.#########.
.#.R.#.........#.
.#.###########.#.
.#...#...#.....#.
.###.#.#.#.#####.
.#...#.#.#!R.....
.#.###.#.###.####
.#.....#...#.#...
.#########.#.###.
.......#...#.....
######.#.#.#####.
.......#.#.#.....
.#######.###.####
......@#.........
17 17
!#...#.......#...
.#.#.###.R##.#.#.
.#.#...#.#...#.#.
.#.###.#.#.###.##
.#...#.#.#.#.....
.###.#.#.#.#####.
.#...#...#.#.....
.#.#######.#.###.
.#.....#.#...#...
.#.###.#.#####.##
.T.#...#.....#..A
.###.#T#.#.#.###.
.....#...#.B...c.
###aT#.###.#.###.
....@#...#.#.#...
.#######.#.###.##
....T....#.......
