abcdefghijklmnopqrstuvwxyz-=[];/
ABCDEFGHIJKLMNOPQRSTUVWXYZ_+{}:?
OOOOOOOOOOOOOOOOCCCCCCCCCCCCCCCC
7
17 17
.......#...#.....
.#####.T.#.#t#.#.
.#...#.t.#...#.#.
.#.#.#.#.###.###.
...#.#!#...#.....
#r##.#####.####c.
...#.q.#...#.....
.#.###.#.###.####
.#...#...#.#.....
.###.#####.#####.
.#.....#...A.....
.######a.#.#.####
.#.......#.#.#@..
.#.c######.#.###.
.#......T#.R.#...
.#######.#####.#.
...............#.
17 17
...#.........#...
B###.#####.#.###.
.#...#.....#...#.
.#.###.#######.#.
.#.#.#.......#...
.#.#.#######.###.
.#.#.......#.#...
.#.#####.#.#.####
.Q.#.....#.T.....
.###.#####.#####.
.r...#.....#@#...
.#.#.q####.#.#.a#
.#.#.#!..#.#.#...
.#.#####.#.#.###.
.#.....#.#.....#.
.###.#.#.#######.
.....#.#.........
17 17
.......#........b
.##R####C###.###.
.#...#.....#.#.#.
.c.#.#.#####.#C#.
...#r..#.....#.#.
.#####.#.#####.#.
.#.#!#@#...#.#...
S#.#.Q####.#.#.##
.#B#...#...#...#.
.#.###.#.TS#.c##.
.....#.#.#.#.#...
####.#.#.#.#.#.#.
...#.#.#.#.....#.
.#.#.#.#.######s.
.#.#.#.#...#.#...
.#.#.#.###.#.#.##
.#...#.....#.....
17 17
...#...c...#.....
##.#.#####.#.#.#.
...#...#...#.#.#.
A#####.#.###.#.##
.#.....#.#...#...
.#.#####.#.#####.
.#...#.#...q.#...
.###.#c#####.#.#.
...#.#.......#.#.
.#.#.#.#####.#.##
@#.....#...#.#..s
C#######.#.#####.
...#A....#...#...
.#.#.####Q##.#.#.
.#...#.....#...#.
.###q#.#########.
..!#...s.........
17 17
...#.......#....r
.###.#####.#.#.##
.....#...T...#...
.#######.#######.
.#.C...#.#.......
.###.#.#.#.#####.
.#...#...#.#..B..
.#.#####.#.#####c
.#.#...#.#.....#.
.#.#.###.#####.##
...#.#...#...#...
####.#.###.#####.
.....#.#@#.....#.
.#####.#.#.#.#.#.
.......#...#.#.#.
.###########.#.S.
.............#.#!
17 17
...#.............
.###.#######.###.
.....#!..#...#.#.
.#######.#.###.#.
.....#...#...#...
##.###.#####.#.C#
...#...#.....#.#.
.###.#####.###.#.
.#...#.....#@#...
##.#####.###.###.
...#.....r...#...
.###.#####.###.##
.#...#.....#...#.
.#.###.#####.###Q
.#.#.#...#...#.a.
.#.#.#.#.#.#####.
...#.C.#.........
17 17
.#...#.#.....#...
a#.#.#.#.#t#.#B#.
...#!#.#.#.#.....
.#####.#.#.#####.
.#.#.....#...#...
.#.#.#######.#.##
.#.#.#.......#.#.
.#.#.#.#######.#.
.#...#.#...#...#.
.###.#.#.#.#.###.
...#.#.#.#...#@..
##.#.#.#.#######.
...#.#.#.#.....#.
.##C##.#.###.#.#.
...#...#.#...#.#.
##.#.###.#.###.#.
.....#...S.#.....
