abcdefghijklmnopqrstuvwxyz-=[];/
ABCDEFGHIJKLMNOPQRSTUVWXYZ_+{}:?
OOOOOOOOOOOOOOOOCCCCCCCCCCCCCCCC
7
9 9
.......#@
.#####.#.
.....#.#.
.###.#B#.
...#.#...
##.#.####
.#.#.....
.#.q#t##.
.......#!
9 9
.A..c#...
.###.##B.
b#@......
.#######.
...#!#...
.#.#.####
.#.#...Q.
.#.#####.
.#a......
9 9
@........
####.####
...#T....
.#.###.#.
.#...#.#.
.###.###.
...#..!R.
##.#####.
.........
9 9
...#@....
.#.#####.
.#.#.....
.#.#.###.
.#...#.#.
.#####.#.
..r..#...
.###.####
..T#..q.!
9 9
.....#!#.
.###.#.#.
.#...#.#s
.#####.#.
.....#.#.
.###.#.#.
..C#.#...
#c.#.###.
@..#.....
9 9
.....#!..
.###.###.
.#.#.....
.#.###r##
R..#.....
##.#.###.
t..#..@#.
.#######.
.........
9 9
@#.......
.#.###.S.
.....#.#.
######.##
.....#...
.###.#.#.
.#!#.#.#S
.#.#.###.
...#.....
