abcdefghijklmnopqrstuvwxyz-=[];/
ABCDEFGHIJKLMNOPQRSTUVWXYZ_+{}:?
OOOOOOOOOOOOOOOOCCCCCCCCCCCCCCCC
9
17 17
.....#...........
c#.###.#.#######.
.#.....#...R.....
.#########.######
.#.....#..c#.....
.###.#.#.###A###.
...#.#.#.....#...
##.#.#.#######.#T
c#.#.#...#...Q.#.
.#.#T###.#.#.#.##
.#.#.#.....#.#...
.#.#.###########.
...#.#....!#.....
.##A.#.#####.###.
.#...#...#..R#.#B
.#.#.###.#.###.#.
...#...#.s.#@....
17 17
!..#.............
##.#####.#######.
.#....q#.b.#.....
.#####.##B.#####.
.#...#.#..T#...#.
.#.#.#.#.###.#.##
.A.#...#.....#...
.#.#####.#######.
...#...#.C.#.....
.###.#.#.#.#.###.
.#...#.#.#.#...#.
.#.#####.#.###.#.
.#.........#...#.
.#########.#.###.
.#...#...#@#.#.#.
.#.#.#.#.###.#.#.
...#...#.....B...
17 17
.....#.........#.
.#r#.###.#####.#.
...#.....#!#.#.#.
##.###.###.A.#.#.
.#.#r..#...#.....
.#.###.#.###A###.
.#...A.#.....#@#.
.###.#.#####.#.#.
...#.#...T...#...
.###.###.#.###.##
...#...#.#...#.#.
##.###.#####.#.#.
...#.#.#...#.#...
.#.#.#.#.#.a.###.
.#...#...#...#.#.
.#############.#.
.................
17 17
..R..#..c..#...#.
.Ac###.#.#.#.#.#.
.#.#..Q#.#...#.#.
.###.###.#####.#.
.......#...#@#...
######.###.#.R##.
...#!#...Q.#.....
.#.#.###.#.######
.#...#.q.#.......
.#######.#######.
.#.....#.....#...
Q###.#.#######.#.
...#.#..t....#.#.
##.#.#######.#.##
.#.#.#.....#.#...
.#.#.#.#.###.###.
..r..#.#.........
17 17
.......#@....#!#.
####.#.#####.#.#.
.....#.......#.#.
.########r##.#.#.
.#.........#.#...
.#.#######.#.###.
.#...#.....#...#.
.#.###.#######.#.
...#...#...#...#.
.###.###.#.###.#.
.#.#.#...#...#.#.
.#.#.#.#####.###.
.A.#...#.#...#...
##.#####.#.###.##
.#...b...#...#.#.
.###.###.###.#.#.
.......C...#.....
17 17
.....#.......#...
.#####.#.###.#.#.
.#.....#.#...#.#.
.#.#####.#.#####.
....B..#.#.......
.#######b########
.#.....#...#.A...
.#.###.bR#.#.###.
.#...#.#.#...#...
.###.#.####A##.#.
..@#.#.........#.
#A##.#.#########.
...#.#.#...#.....
.#.#.###.#.###.##
.t...#...#...#...
.#####.#####.###.
.......#!....#...
17 17
...#..!#.R.......
.#.#.#####.###.#.
.#.#.....#...#.#.
.#.#####.###.#.##
.#...#.#...#.#...
.###.#.###.####b.
.#.#.....#...#...
.#.##C##.###.#.#.
.#.........#...#.
.###############.
.#...........#...
.#.#######.###.##
.#.#.....#.#...#.
.#.#####.#.#.###.
.#.#.....#...#...
.#.q.##q.####b.#.
.....#@........#.
17 17
...#.......#.....
.#.#.#####.###.#.
.#.#...#...#...#.
.#.###.#.###.###.
.#.....#.#...#.C.
.#####c#.#.#.#.#.
!#.#...#.#.#.#...
##.#.#.#.###.#.##
...#.#.#.....#.#.
.###.#.#######.#.
.#...#.A.......#.
.#.###.#.#######.
.b.#.#...#.......
.#.#.#####.###.#.
.#...#.C.....#.#.
.###.#########.B.
...............#@
17 17
a......S...#.....
.#########.#.###.
...#.....#.#.#...
.#.###.#.#.b##.#.
.#...#.#...#...Q.
####.#.#####.###.
.....#...#...#.S.
.#######.###.#.#.
.#...#.......#...
.#.#.#.#######.##
...#.#..@#...#...
.###.#####.#.####
.#.#...#...#....!
.#.###.#.########
.#...#...#.......
.#.#.#######.###.
...#.........#...
