abcdefghijklmnopqrstuvwxyz-=[];/
ABCDEFGHIJKLMNOPQRSTUVWXYZ_+{}:?
OOOOOOOOOOOOOOOOCCCCCCCCCCCCCCCC
7
17 17
.#.......d..q..#.
.#uD##.#.#.#.#.#.
...#...#.#.#.#...
.###.#B#.#ct.###D
...d...#.....#!#.
.#R###.###.###.D.
@#..R..#.#.#...#.
##.#####.#r#.####
...#.......#.....
.sa#############.
.#.s...#.....#...
.###.#.#.#.###.##
.#...#.#.r...#...
.#.##S.#.###.###.
.#...#...#.#...#.
.###.#####.#.###.
...........#.....
17 17
.......Q.#.#.....
.#######.#.#.###.
.#.....#.#.....#.
.#.###.#.#.#####.
.....#.#.#...#...
.#####.#.###.#.#.
.#.....#.#...#.#.
.#.#C###.#####.#.
.#.#...........#.
.#.#############.
.#.....#...#.....
.#####.#.#.#####.
.....#...#c....#.
#############B.#.
...D.........#.#.
.#.#.#######.#.#.
!#...#.........#@
17 17
...#!#...#...#...
##.#.#.#.#.#.###.
.r.#.#.#...#....d
u###.#.#########.
...#.#.#.D.....#.
.#.#.#.#######.#.
.#.#...#....a#.#.
.#.#c###.###.#.#.
.#.....#.#.....#B
##.###.#.#######.
T..#.#...#...#...
.###.##A.#.#.#r##
.#.......#.#.#.#.
.#######.U.#t#.#.
.#.....#@#.q.#.#.
S#.###.###.#.#.#.
.....#.....#..s..
17 17
.........#.......
.#####s#.#.##rb#.
.#...#.#.#.....#.
.#.#D###.#.#####.
.#.#.....#.#.....
.#.#######.#.###.
.#.C.....#.#...#.
########.#.###.##
.......#.#.#.#...
.#####.#.#.#.###.
.#!#@#.#.......#.
.#.#.#.########U.
.#.#.#.......#...
.#.#.#######.#.##
...#.#.....#.#...
####.#.###.#.###.
.........#.......
17 17
.q.#...........#@
.#.###.#.#####.#.
.#...#.#...#..U..
.###.#####.#.####
..!#.....#.#.#...
########.#.###.#.
.......#.#.....#.
.#U#.#A#b#.#####.
.#.#.....#.#.d...
.q.#######.#.#.#.
.#.....#.#.#.#.#.
.#.###.#.#.#.#.#.
.#.#...#.....#.#.
.#.#.#######.#.#.
.#.#.#.....#.#.#.
.#.#.###.A.#a#.#.
...#.....#.....#.
17 17
.......A...#.....
.#########.#####.
.....#...#.....#.
####a#.#.#####.u.
.....#.#.....#.#.
.#u###.#####.#.#.
...#.......#@#.#.
##.#.#####.###.#U
.U.#.#...#.#...#.
.#.#.#.#.#.#.###.
.#!#.#.#...#.....
.#####.###C#####.
.......#.....#...
.###########.#.#S
.#.......#...#.#.
.#.#####.#####.#.
.......#.........
17 17
...#.........u...
.###.#A###.#.####
.#...#...#.#.#...
.#.###.#.#.##u.#.
.....#.S.#.....#.
.#####.#.#######.
...#...#.......#.
##.#.#########.s.
@..#.#.......#.#.
S###.#.#######.#.
.....#.......#.#.
.###R#.#####.#.#.
.c..!#.....#...#.
.#.#######.#####.
.#.#.....#.......
.#.#.###.#######.
...#...#.........
