abcdefghijklmnopqrstuvwxyz-=[];/
ABCDEFGHIJKLMNOPQRSTUVWXYZ_+{}:?
OOOOOOOOOOOOOOOOCCCCCCCCCCCCCCCC
7
17 17
...............#.
.#.s#########A.#.
.#.........#.#.#.
.#Q#######.#.#.#.
...#.......#.#...
##.#.###U###.###.
.#.#.#..U........
.#.#.####a.######
...#.#...#.....#.
.###.#.#.#####.#.
.#...#.#.#.....#.
.#.###.#.#.#####.
.#.....#.#.#.....
.#####.#.s.r.#v#.
.#..!#.#.#...B...
.#.#####.#####.##
@#.......#....Q..
17 17
.....#...........
.###.v.#########.
...#.#.#.....#...
##.##D.#.#####.##
...#...#.C...#...
.#.#.###.#.#.###.
.#.#!#F#...#.....
.R#d##.#.########
.#.e...#.....#..@
.#.#.#######.#.##
.#.#.....#...#...
.#.###.###.#####.
..f#.#....C#...#.
.A##.#####c#.#.#.
.d.....#.....#...
.r##.#.#####.###.
.....#.......#...
17 17
....U#...........
.#.#.#.#.#####d#.
.#.#.#.#.....#.#b
.#.#.#.#U###.#.#.
@#.#.#.#...#.#.#.
##.#.#.#.#.#.#.#.
..V#.#.#.#.#.#...
.###.#.#.#.#.####
...#.#.#.#.#.....
.#.###.#.tw#####.
.#...q.#.#!....#.
.###T#.#.#B###.#.
...#.#...#...#...
#u.#.###.###.####
.v.#...#.....#...
.#####.#####.###.
...w.#....E.....u
17 17
D#!...q#.....f...
.#####.#.#######B
.....#.#...#...#.
.#.#.#.###.#.QQ#.
.#.#.#...#.S.W...
.#.#####.#####.#.
.#.....#.#.....#.
.###.###.#.#####.
.S.#.#...#.#.#...
.#D#.#.e##.#.#.##
.#...#.#...#.#...
##.###.###.#.###.
...#...#...#.....
.###.#C#.###.####
.#...#...#...#...
.#.###.###.###.#.
.......#.......v@
17 17
.#d...c..........
.#.###.#########.
.#...#.....#...#.
.###.W####.#.###.
.....#.....#.#...
.#####R##d##.#.##
.#...#...#.......
.###.###r#######.
.#.....t.....#.#.
.#.###.#####.#U#.
.#.#.qS#@..#.#T#.
.v.#.#.###.#.#.#.
.#.#.#...#.#.#.t.
.#.#.###.#.#.####
...B.#...#.#.#!..
####.#.###.#.###.
...........#a....
17 17
...............#.
.#####.#######.#.
.....#...#.......
.##d##.#.#.######
.#...#.#.#.#Q....
.#.#.###.#.#.#cv.
.#.#.....b.q.#...
.#.###.#####.#.##
.#.#!#.#.....#.#.
.E.#.###.#####.d.
.#.#.....#...#...
##.#######.#.###.
........@#.#.#...
.#########.#.#.##
.#.......#.#.S.#.
.#.#####.#.#.#.#.
.......#...#....B
17 17
...............#F
.#######.#####.#.
.#.#.....#...#...
.#.#.#######.###.
...#...#......@#.
.###d#.#.#.#####F
.#.....#.#.......
.#.#####r#.######
.#.......#...#W..
.#######.###.###.
.....#.#.#.......
##E#.#.#A##a#####
.....#.#.....#...
.#####.#####.#.#.
..s..#.....#.#!#.
####.###.Q.u.##U.
.....t...#.#.....
