abcdefghijklmnopqrstuvwxyz-=[];/
ABCDEFGHIJKLMNOPQRSTUVWXYZ_+{}:?
OOOOOOOOOOOOOOOOCCCCCCCCCCCCCCCC
7
35 35
.....#...............#.....#...#...
.###.#.T##########.#.#.#.#.#.###.#.
.#.#...C.....S.....#.#.#s#.Q.#...#.
.#.#####.###.#.#####.#.#.#.#.#.###.
.r.....#.#...#...#.#.#.#.#...#...#.
.##Q##.#.#.#####.#.#.###.###.###.#.
.....#...#.....#.#.#.....#.....#.#.
####.#######.t##.#.#######.#####.#.
.#...#...#...#...#.A...b...#...#!#.
.#.###.#.#.q.#.#####S###A###.#.###.
.#.#...#...#.#.....#......A#.#...#.
.#.#.#.#####.#####.##A####.#.###.#.
.#.#.#.....#.....#.......#.#.#.#...
.#.#######.#####.#######.#.#.#.####
.Q.....#...#.#...#...#...#.#.#.....
.#####.#.###.#.###.#.b.Q#T##.###.#.
...#.#.#...#.#.#...#.b.......#...#.
.#.#.#.###.#.#.###.#.#########.###.
.#.#.#.....#.#...#.#s......#...#...
.t.#.#######.###.###.#####.#.###.##
.#....t#.#.....#.....T...#.#.#...#.
.#####.#.#.###.#########.#.#.###.#.
....r#.#.#.R.#.........r.#.#...#...
.#A#.#.#.#.#####.#####.#.#.#.#.####
..C#.#.#...#...#.....#...#.#.#.....
####.#C#####.#.#####.###.#.###.###.
.....#.......#.....a...#.#...#.#@#.
.#################r###.r####.#.#.#.
.....#.....#.....#.....#...#.#...#.
#Tq#.#.###.#.###.#####.#.#.#.#####.
.....#...#.#...#.#.....#.#.#.....#.
.#####.###.###.#.#######.#.#####.#.
.......#...#...#.#...#...#.....#.#.
.#######.sC#.###.#.#.#.#####.##b.#.
.......#.......#..T#.......#.......
35 35
.....#.......#.............S.......
.####B.#####.#.#####.#####.#.#.###.
......c....#...#.....#...#.#.#...#.
.###############.#####.###.#.###.#.
.#...#...........#.....#A..#...#.#.
##.#.#.##S####B###.#####.###.###.#.
...c...#!..#S....#.......#...#...#.
.#####.###.#.###.#.#######a###.###.
.....#...#.#.#.#.#.....#.....#...#.
####.#####.#.#.#.#####.####c.###.##
.....#.....#.#.......#...#.....#...
.#####.#####.#####B#c###.###.#####.
.#.....#.....#a..#.....#...#.#...#.
.#.#########.#.#.#.#.####b.###.#.#.
...#...#...#.a.#.#.#.b...#.....#.#.
####.#.#.#.S##.#.#.#.#.#.#######.#.
...t.#...#...#.#.#.#...#.....#...#.
.#####r#####.###.#.#####.#####.###.
.#.....#.........#.#...#.#...#.....
.#.###.#######.###.#.###.#.#.####A.
.#.#.#.......#.#...#...#...#.......
.#.#.###a###.###.#####.######C####R
...#.....#...#...#.....#...#...#...
.###.#####.#.#.#####.#.###.#.#.#.#.
.#...#.....#.#.#...#.#...#.#.#.#.#.
.###.#.#####.#.#.#.#.###.#.#.c.#.#.
...#.t.....#.#...#.#.#...#.#.#.#.#.
##.#.#####.######s.#.#.##C.#.#.#.#.
.#...c...#.........#.#...#...b...#.
.#c#.#.#.#A####T####.###.#.#######.
...#.#.#...........#...#.#...#.....
.#r#.#.#########.#.#.#.#.###.#.####
.....#.T...#...#.#...#.#.#@..#.....
.#######.#.#.#.#######.#.#########.
.........#...#.........#...........
35 35
...............#.....#.............
.#############.###.a.#.###.########
.....#.......A.....C.#..T#.........
.#a#.#.#####.#######.###.#########.
.#...#.#.#...#.....#.#.B.....#.....
##.###t#.#.#.#.#.#.#.#####C###.###.
...#.C...#.#.#.#.#.#...#.......#.#r
.###.#####.#.###.#.###.#.#######.#.
.#...#.#...#.....#.#...#.#.#.......
.#.###.#S#######.###.A##.#.#.######
.#.....#...#Q..#.#...#..T#.....#..!
.###.#####.#.#.#.#.###.#.###.###.##
...#.#...#...#.#.#.#...#...#.#...#.
.#.###.#.#####.###.#.#####.###.###.
.#.....#.#...#.#...#...#.#.#...#...
.#######.#.#.#.#.#####.#.#.#.#####.
.......#...#.#.#.#.......#.#.#...#.
####.######r.#.#.#.##C####.#.#.#.#.
.....#.....#.#...#...#.....#.#.#b#.
.#C###.###.#.#.#####.#.###.#a#.#.#.
.#...#.#.#...#.....#.#...#.#.#.#...
.#.#.#.s.#########.#####.#.#.#.###.
...#@#.#.......#...#.....#.#...#...
.#####.#######.#.###.#####.#####.##
.#.....#...q...#...#.#.....#.....#.
.#.###.#.#.#.#####.#.#######.#####.
.#...#.#.#.#.....#...#.......#....T
####.###.#.#####.###.s.#########.#.
.....#.q.#....C#.t...#...#....A#.#.
.###.#.#######.###.##Q##.#.#.#.###.
...#.#.#...#.#...#.....#.#.#.r...#.
.#.#.#.#.#.#.###.#.#####.R.#.###.#.
.#.#.#...#.#...#.#.#...#.#.#.#.#...
.#.#######.#.#.#.###.#.#.###.#.###.
.#...........#.#.....#.......#.....
35 35
.........#.....#.......#...#.#.....
.#.#######.###.#.###.#.#.#.Q.#.###.
.#...#...#.#a#.....#.#.#.#.#.#...#.
####.#.#.#.#.######t.#.#.#.#.##S.#.
!#...#.#.#..t#.......#.#.#....T#.#.
.#.#a#.#.###.#.#a#####.#.#.#qs##.#.
.#.....#t....#.#.......#.#.#S....#.
.###R#####b###.#.#######.#.#.#####.
...#...#...#...#.ar#.....#.#.#...#.
##.###.#.#.#.###.#.#.###.###.#.###.
.#...#...#.#...#.#...#...#.....#.R.
.###.#######.#.#.#####.#.q.#####.#.
.....#.....#.#.#...#..q#.#...#...#.
.#####.###.###.###.#.###.###.#.####
.#.......#.....#.#.#.#...#...#.....
.#####.#.#######.#.#s#.###.#######.
.....#.#.#.......#.#.#...#.....#...
####.t##.#.#.#####.#q#########.#.##
...a.....#.#.......#.........#.#...
##.#######.##c######.#######.#.###.
.....#.....#...#..@#.#.....#...#.#.
.#.###.####b.#.#.###.#.###.###.#.#.
.#.#...#.....C.#.#...A.#.#...#...#.
.###.#######.#.#.#.###.#.###.#####.
...#.........#.#.....#.#...#.....#.
##.###########.#####.#.#.#.#####.#.
.........#...#...#...#.#.#.#...#.#.
.#########.#.###.#####.#.#.#.#.#.#.
.#.........#...#.#.....#.#.#.#.#..t
.#.###########.#.#.#####.#.#.#.###.
.#.#...#.....#...#.#...#.#r..#..b#.
.#.###.#.#.##t####.#.A.#######.###.
.#...#...#.......#...#.......#.#...
.###.#########.#.###########.#.#.##
...............#......r......#.....
35 35
.#.....#.............#.......#.....
.#.###.#.#T#.#######.###.###.#####.
.....#.....#.#.....#...#.#s#.....#.
############.#####B###.#.#.#####.#.
.....#.......#...#...a...#q..#...#.
.###.#Q#######.#.#.#.#######.#.###.
.#.#.#.#.......#.r.#.....#...#...#.
.#.#.#.#.#######.#.#####.#.#####.#.
.#.....#.#.....#.#...#.#...#...r.#.
.#######.#####.#.#.#.#.#.###.#.#.#.
.............#.#.#.#.#...#...#...C.
.###########.#.#.##t.#####.#######.
...#.#...#.#.#.#...#.....Q.........
##.#.#.#.#.#.#.###.#####.#########.
.#.#.#.#.#.....#...#...#.......#...
.C.#.#.#.#######.#.T.#.###.#.#.#.##
...#.#.#...#..B#.#.#.#...#t#.#R#...
.###.#.###.#.#.#.#.#.###.#.#.#.###.
.....#.#.....#...#.#.#!#.#.#.#...#.
######.#.#######C###.#.S.###.###.#.
.......#.#.....#...#.#.#...#.#...#.
.#######.#.###.#.#.#.#.A##.#.#####.
.....#...#.#.#...#...#.#...#.#.....
.###.#.###.Q.#########.#.###.#.####
.#.#.#...#.........#.q...#.#...#...
.#.#.###.#########.#.#####.#.###.#.
...#...#.#.......#...#...#...#...#.
##.#S#.#.#####.#####.C.###.#######.
...#.#.#.#c....#.....#...#...#.....
.###.#.#.#.#####.#####.#.###.#.##r.
.#..A#.#B..#...#.#@....#...#.#.S...
.###T#.###.#.b.#.###.#####.#.#.####
.#...#.#...S.t.#...#.#.....#.#.....
.#.#.#.#C###.#.###.#.T.r##r#.##c##.
...#.#.......#.....#.#.............
35 35
@..#...............#.........#.....
##.#.###.#####.#####.s.#####.#.#.#.
...#.#...#...#.#.....#...#...#.#.#.
.#.#.#.###.#.#.#.#######.#.#####.#.
.#.#.#.....#.#.#.#.....#.#.......#.
.###.#####T#.###.#.###.#.S########.
...#.....#...#.....#...#.#.#...#...
##.#####.#.#.#.#########.Q.#.#.#.##
...#....T#.#.#.#.........#...#...#.
.###.#####.#.#.#.###########.#####.
...#.#.#...Q.#.#.#.........#.#...#.
.#.#.#.#.#####.#.#.#######.#.C.#.#.
.#.....#.......#...#....R#.#...#...
######.###########.#.###.#.#.#####.
.....#...#.......#.#...#.#.#.#...#.
.###.#####.#####.#.###.#.#.###.#.#.
.#...#...#.....#.#.....#.r...#.#.#.
.#.###.#.###.#.#.#######.###.#.#.##
.#.....#...#.#.#.....#.#.#.#...#...
.#########.###.#####.#.#.#.#######.
.#.....#.......#.#...#..R..#...#...
.#.###.#########.#.#######.#.#.#.#.
.....#.....#...#...#.....#...#.#.#.
.#######.#.##r.#.###.###.#####.#.#.
.#.....#.#...#.....#.#...#...#.#.#.
.#.##T.###.#.#####.#.#.###.#.#.#.##
.#...#...#.#...#.#...#.#...#.#.#...
####.###.#.b##.#.#####.b.###.###B#.
.....#.#!#.#.#.#...R.#.#...#.....#.
.###C#.###.#.r.###.#.#.#.#.#####.#.
.#.......#R..c.#...#.#.#.#.#...#.#.
.#.#####.###.#.#.#####.###.###.#.#.
...#.#...#...#.#.#...#.....#...#.#.
###a.#.#######.#.#.#.#######.###.#.
...............#A..#.......B.......
35 35
.......#...........#.......#...#...
##.#####.#.#######.#.#####.#.#.#.s.
...#.....#.....#...#...#.#...#...#.
.#.#.R########.###.###.#.#########.
.#.#.#...#...#...#.....q.#.......#.
.###.#.#.#.#.##c.#######.#.#####.#.
...#...#.#.#...#...#...#...#...q...
.#.#####.#.###.C##.#.#.#####.#.###.
.#.....#...C.#.#.#...#.......#...#.
####S#######.#.#.###############.##
.....#...............#.........#...
.#.###.#############.###.###.#.###.
.#.#...#...#...#...#...#.#...#...#.
.###.#q#.#.#.#.#.#.###.###.###.###.
.....#.#.#...#.#.#..@#.....#...C...
.#####.#.#R###.#.#######.#######.#.
...q...#.#...#.#.......#.#....!#.#.
######t#.#.#.#.#.###.##s.#.R####.a#
....T..#...#.#.#t#...#...#...#.s...
.s####s#####.#.###.A##.#####.###c#.
.#.c.#...#...#...#.......#...#.....
.#C###.#.#.#####.#########.###.#bR.
.#...#.#...#.#...#.........#...#...
.###.#.#####.#.###.###A#######.####
...#.#...#...#.....#...#.......#...
##.#.###.#.###T#####.#.##b.#.###.#.
.#.#...#.#.Q.....#...#...#.#.....#.
.q.###.#.###.#.#.s.#####.#.#######.
.#.#...#...#.#.#.#.....#.s..S....#.
.#.#.#####.###.#.#####.#.#######.#.
.T.#.....#.#...#...#...#.#...#...#.
.#######.#.#.#####.#.###.#.#.#####.
.#.......#.#.....#.#.#...#.#.#.....
.#.#####.#.#####.#.#.#.###.#.#.###.
...#.....#.......#...#.....#...#...
