abcdefghijklmnopqrstuvwxyz-=[];/
ABCDEFGHIJKLMNOPQRSTUVWXYZ_+{}:?
OOOOOOOOOOOOOOOOCCCCCCCCCCCCCCCC
7
17 17
.#...............
.#.###########.#.
.#.#...#.#.....#.
.#.#.#.#.#.#####.
.....#...#...#...
.#####.#####.#.##
.#...#.#.....#...
.#.#.###.#######.
.#.#.....#.....#.
##.#######.###.#.
...#.........#...
.###########.####
...........#.#@..
#######Q##.#.#Q#.
......!#...#.....
.#######.#######.
.........#.......
17 17
.....#.#.........
.###.a.#.#####.#.
.#...#.#.#...#.#.
.###.#.#.#.#.#.##
...#.#.....#.#...
##.#.#######.###.
...#.......#...#.
.######q##.#####.
.#...#@..#.#.....
.#.#.###.#.#.####
.#.#...#.....#..!
.#.###.r######.#r
.#...#.....#...#.
.#.#######.#.###.
...#.......#.#...
.###.######a.#.#.
...#...........#.
17 17
.....#@....#.R...
.###.#####.#.#.#.
.#.#.#...#...#.#.
.#.#.#.#.#####.##
.#.....#Q......#!
.###############.
...........#...#.
.#####R###.#.#.#.
.......#.#...#...
##a###.#.########
.....#.#...#...r.
.###.#.#.#.R.###.
...#.#...#.#...#.
.#.#######A###.#R
.#....q..#...#...
.#######.###.###.
.......#.........
17 17
.#!#...#.........
.#.#.#.#.#######.
.#.#.#.#...#.....
.#.#.#.###.#.####
...#@#.#...#.....
.#####.#.#######.
.#...#...#.....#.
.#.#.#.###.###.#.
...#.#.#...#.#.#.
####.#.#.###.#.#.
...#.#.#...#...#.
.###.#.###.#.###.
.#...#.#.#.#...#.
.#.###.#.#.###.#.
...#.....#.#.#.#.
.######R##.#.#.#.
...........#.....
17 17
...........#..!#.
.#########.#.###.
.........#.#...#.
##########.###.#.
...#...#...#.#.#.
.#.#.#.#.#.#.#.#.
.#...#...#...#.#.
.#######.#####.#.
...#.....#...#.#.
.#.#.#####.#.#.#.
.#.#@#.....#...#.
.#.###.########Q.
r#...#.......#..A
.###.#######.#.#.
.#...#.....#...#.
.#.###.###.#####.
.#.......#.......
17 17
.........#.......
.#.###.###.###.#.
.#.#...#.....#.#.
.r.a####.#####.#.
.#.......#.#...#.
.#######.#.#.####
.#.#..!#...#.....
.#q#.#####.#####.
...#...#.......A.
##.###.#########.
.#.#.#...#...#...
.#.#.###.#a#.#.#.
.#.#...#.#.#.#.#.
.#.###.#.#.#.#.#.
...#...#...#.#.#.
.###.#.#####.#.#.
.....#....@#...#.
17 17
.............#...
.########Q.#.#.#.
.#.........#.#.#@
##.#########.#.##
...#.......#.#...
.###.###q#.#.#.#.
...#.#R..#.#.#.#.
##.#.###.#.#.#.#.
...#.#...#.#.#.#.
.###.#.###.#.###.
.......#...#.....
.#######.#######.
q#.....#.....#.#.
##.###.#.###.#.#.
!#...#.#.#...#.#.
.###.R.###.###.#.
.....#.....#.....
