abcdefghijklmnopqrstuvwxyz-=[];/
ABCDEFGHIJKLMNOPQRSTUVWXYZ_+{}:?
OOOOOOOOOOOOOOOOCCCCCCCCCCCCCCCC
9
17 17
!#....q..#.......
.###.#####.####QB
...#.......#...#.
a#.#.C######.#.#.
...#...#..t..#...
.#######.#######.
.......#.#...#...
######.#.#.#.#.##
...#...#...#.#.#.
.#.#.###b###.#.#.
.#...#.......#...
.#######.#######.
...#.....#.....#.
##.###.#c#.###.#.
.#.#...#@#...#.#.
.#.#.###.##S.#.#.
.....#.......#...
17 17
.......#.......#C
.###.###.#.###.#.
...#.....#...#...
t#.#######.#.####
.#...#...#.#.....
.###.#.T.#######.
.A...#.#...#!..#.
.#.#A#.###.###.#.
....@#...#...#.#.
########.Q##.#.#.
.......#...#...#.
.###.#####.#####.
.#.#.......#.....
.#.############S.
.#...#.......#...
.#.#.t####.#.#R#.
...#.......#...#.
17 17
.......#.......c.
.#.##A##.#######.
.#.............#.
.###############.
.#.#...#.....#...
.#.#.#.#.###.#.#.
...#.#.#...#...#.
##.#.#.###.######
.#.#.C...#...#!..
.#.#.###.###.###.
.s.#...#.......#.
.#.###.#######.#.
....@#...#.#...#.
.#######.#.#.A##.
.#.......#...#...
.#.###########.##
.#...............
17 17
.....Q.....#...#.
.###q#.###.#.#.#Q
...#...#.#...#.#.
##.#R###.#####.#.
.#...#@....#...#.
.###.###R#.#.###.
...#.#...#.#.....
.###.#.#.#.#####.
...#...#!#.#.....
.#.#######.#.####
.#.....#...#...#.
.##r.#.#.#####.#.
.#.#.#...#...#.T.
.#.#.###.#.#.#.#.
.#.#...#.#.#.#.#.
.#.###.###.#.#.#.
.....#.....#.....
17 17
.......#.#.......
.#####.#.#.#####.
...#.#...#.#@#...
.#.#.#.###.S.#.##
.#.#...#...#.#...
.#.#####.###.###.
.#...........#...
.##########A##.#.
...#!....#....s#.
##.#####.#.######
.....#...#.......
######a#######.#.
.......#.....#.#.
.S######.###.#q#.
...#.......#.....
##.#######.#####.
...........#.....
17 17
...#.........#...
.###.#.#####.#A#.
.....#.#...#....T
######.###.##c##.
.......#.....#...
.#######.#####.##
.#....Q#.#.....#!
.#.###.#.S.#####.
.#.#.#.#.#.#...#.
.#.#.#.#.#.#.C##.
.#...#.#...#...#.
.###.#.###.###b#.
..@#.#...#.....#.
.###.B##.###.###.
...#.#.#.#...#...
.#.#.#.#.#####.##
.#.....#.......A.
17 17
.................
.#####.#####.c##.
.#...#.....#.#...
##.#.#####.#.#.##
...#...#...#.#.#.
.#####.#####.#.#.
...#.#...#...#...
##.#.###.#.#####.
@R.#.#...#.....#S
.#.#.a.###.###.##
.#...#...#...#...
.#.#####.#####.#.
...#!....#...#S#.
.######q##.#.###.
.......#...#...#.
######.#.#b###.#.
.........#.......
17 17
...#.....#....B..
.###.###.#.####S.
......@#.#.#.#...
########.#.#.#.##
...#...#.#...#...
.#.#.#.#.###.###.
.#...#.#...#.#.#.
.t####.#.#.#.#.#.
...#.#.#.#.....#.
##.#.#.#########.
...#.#.#.......#.
.###.#.#.###s#.#.
...#.#!#.#.......
##.#.###.#T#####.
...#...#.....#C..
.###.#.#####.#.##
.....#.....r.#...
17 17
.................
.##############A#
.....#A....#.....
.##C.#.###.#b###.
..B#.#.#.#...#...
####.#.#.#####.##
.....#.#.....#.#.
.#.##Q.#####.#.#.
.#.#!..#.....#.#.
.#####S#.#####.a.
.#S......#.....#.
.#.###.###.####s.
.#B#.#.#...#.....
.#.#.#.#.###r#.#.
.#.#.#.#.#.....#.
.#.#.#.#.###.#T#.
.....#.......#@..
