abcdefghijklmnopqrstuvwxyz-=[];/
ABCDEFGHIJKLMNOPQRSTUVWXYZ_+{}:?
OOOOOOOOOOOOOOOOCCCCCCCCCCCCCCCC
7
25 25
r#.....#.............#...
.#.#.#.#####.#####.#.###.
...q.#.....#.#...#.#C#...
.###.#####.#.#.#.#.#.#.##
...#.#.#...#.#.s...#.#...
##.#.#.#.#####.#####.###.
...#.#.#.....#..R#.....#.
.###.#.#####.#.#.#####.T.
.#...#...#...q.#...#.#.#.
.#.#####.#.#######.#.#.#.
.#...#...#.#.......#.#...
.###.#.###.#.####q##.###.
.#.#.#.......#.......#...
.#.#.#########.#####.#.##
...#.....#@#.......#.....
##.#####.#.#.###########.
.....#...#.#T#!....#...#.
.#####.###.#.#####.#.#.##
.#.....#.....#.....#.#...
##.#####.#####.#####.###.
...#.......#...#.....#.#.
.###########.#####.###.#.
...#.......#.......#.#...
.#.#.##c##.#########.#.##
.#.......#...............
25 25
...........#.....#.......
.s##.#####.#.###.#######.
.#...#.#...#S#.........#.
.#.###.#.###.#####S###.#.
.#.#.#...#.......#...#...
##.#.#.##r######.###.###.
...#.............b...#...
.#################.#.#.##
.#...c...#.#.......#@#...
.#.#####.#.#.##T#b.#####.
.#...#...#...#...#.......
.###.#.##q.###.#.########
.#...#.#...#...#.#...#...
.#.A##.#.###.###.#.###.#.
...#...#.....#...#.....#.
####.#########.###.#####.
.....#.......#...#.#.#...
.#####.###.#.###.#.#.#.##
...#...#...#.#...#...#...
.#.#####.###.#.Q######.#.
.#.#...#...#.#...#...#.#.
##.#.#.#.#.#.###R#.#.###Q
...#!#.#.#.#...#...#.#...
.#####.#.#.########R.#.#.
.......#.#.............#.
25 25
...#.....#.......#.......
.###.#.#.#.#######.###.#.
.....#.#.#.#......B..#.#.
######.#.#.#.#########.#.
.......#T..#.#...#.....#.
.###########.b.#.#.#####.
.............#.#.#.#@#...
.#############Q#.#.#.#.##
...#.......t...#.#.#.#.#.
##.###.###.#.#.#.#.#.#.#.
.#.r.#...#B..#...q.#.....
.###.###.#######.#.#####.
...#.#...#...#...#.....#.
.#.#.#.###.#.#########.##
.#.#.r...#.#.........#...
##.#.###.#.#########.#.#.
...B.....#!#.....#...#.#.
.#.#####.###.ab###.#####.
.b.....#.#.......#.#.....
.#####.#.#r#####.#.#.####
...#...#...#.....#.#.....
.#.#.#####.c.###C#.####r.
.#.#.#...#.#...#.#.....A.
.#.###.#.#.q##.#.########
.#.....#.......#.......B.
25 25
...................#.....
#t#B####.#########.#.###.
......b..#.....#.#...#...
.#########.#.#.#.#####.##
.#.....#...#.#...#.#...#.
.#.###.#.###r###.#.#.###.
.#...#.#.#...C.....#.....
.###.#.###.#.#####.#####.
.....#!#...#.R...#.....#.
#####B##.###.#.#.#####.#.
.#.....#.#...#.#...#..B#.
.#.#.#.#.#.###.###.#.###.
...#.#...#.#.#...#.#...#.
.###.#####.#.###.#.#####.
...#.#...#...#...#...#...
##.#r#.#.#b###.#s###.#.##
...#...#...#...#.#..s#.#@
.#########.#.###.c.###.#.
.#.....#...#...#.#.....#.
.#.#.###.#.###.#t######Q.
.#.#.#...#...S.#.....#...
.#.###.#####.#.#.###.###.
.#.#.c.#.....#...#c#.....
.#.#.#############.#####.
...#.....................
25 25
.....#...#.......#.......
.###.#.#.#####.###.##a##.
.#.#...#.......#.A.#...#.
.#.###########.#.###.#.#.
.#.............#.#...#.#.
.#####.A########.#.#a#.#.
.#...#.#.........#.#.#...
.#.#.#.#.#########.#.a##.
.#.a.#.#.#.#.......#.#...
.#.#.#.#.#.#.#######.#.##
...#.#.#.#.#...#.....#...
.A##.###.#.###.###.#.###.
...#.#...#...#...#@#.#...
####.#.#####.###.###.#.##
.....#....r#...#.#...#...
.#########.#.###.R.#####.
...#......Q#...#.#...#...
##.#.#########.#.###.#.##
...#.#.........#.#...#...
.###.#s###.#.###.#.#.###.
.....#....a#.#...#.#.#...
.###.#.#####.#.###.#AQ.##
.#!#...#.....#.#.....#.#.
.#.###########.#.###.#.#.
.#......a......#...#.....
25 25
...#.................#...
.###.###########.###.#.#.
...#...R...#.....#...#@#.
.#.###.#####.#####.#####.
.#.....#.....#...#...#...
.#######.#B###.#.###.#.#.
.#.......#.....#.#.#.#.#.
.#.#####.#.#####.#.#.#.#.
.#.....#.#.#.#...#.....#.
.#####.###.#.#.##########
.#.....#...#.........#...
b#.###.#.#####BB###q.#.#.
.#...#.#.......b...#...#.
####.###q#####.#.#######.
...#...#.....#.#....t#...
.#.#.#.#.#.###.###.#.#.##
.#.#.#.#.#...#.#!#.#.#.#.
.#.###.#.###.#.#.#.#.#.#.
.#.....#...#.#.#.#.#.#.#.
.#s#.C##.###.#.#.#.###.#.
.#...#.Q.#...#...#.#...#.
.#####.###.#######.#.###.
...#...#...#.......#.....
.#.#.###.###.#.#########.
.#.....#.....#...........
25 25
.......#.#...............
.###.#.#.#.#########.###.
.#.#.#.B.#.#.#.....#.#.#.
.#.#.#####.#.#.###.#.#.#.
.#.#.#.....#.#...#.#.#...
.#.#.#.#####.###.#.#.#.##
...#.........#...#.#.#.#.
r#.###########.###.#.#.#.
.#.....#!......#...#.#...
.#####.#########.###.###.
.....#.c.....#...#...#.#.
.#####.#.###.#.###.###.#.
.......#.#.#...#...#.....
.#####S#.#.#####.###.####
....@#...#...#.#...#.....
.#####.###.#.#.#.#.######
.#.....#...#.#.#.#.......
.#.#####.#.#.#.#.#######.
.#...#...#.#q#.....#...#.
.###.#.###.#.#######.#.#.
...#.#...#.#.#.......#...
##.#.#.###.#.#.#########b
.#.#.#.#...R.#.#.#.....#s
.#.#.###.##R.#.#.#.###.#.
...#.....#.....#.....#...
