abcdefghijklmnopqrstuvwxyz-=[];/
ABCDEFGHIJKLMNOPQRSTUVWXYZ_+{}:?
OOOOOOOOOOOOOOOOCCCCCCCCCCCCCCCC
1
17 17
.......#....a....
.###.###.#####.#.
.r.#.A...#...#.R.
r#.#######.#.#.#.
.......#!..#.#.#.
#####A.#####q#.##
.B...#b..#.#.#..Q
.#.#.###.#.#.###.
.T.#...#...#.....
.#s#######.######
.#........R#.#...
.###########.#.#.
..c#.......#...#.
##.###s#S#.###.#.
.#...#.#.#.T.#@#C
.###.###.###.###.
t........#.......
