abcdefghijklmnopqrstuvwxyz-=[];/
ABCDEFGHIJKLMNOPQRSTUVWXYZ_+{}:?
OOOOOOOOOOOOOOOOCCCCCCCCCCCCCCCC
7
17 17
........q..#...#.
.#####.###.#.#.#.
...#...#.#...#.#.
##.#.###.#####.#.
S..#.#.......#...
.###.###.###.###.
.#@#...#...#...#.
.#.###.#.#.###.#.
.#.#...#.#...#.#.
.#.#.###.###.###.
...S.#.....#.....
##.#.#####.######
...#.....#.#...#.
########.#.#.#.#.
.....r...#...#.#.
.#############.#.
....!#...........
17 17
..@#...Q.....#...
.###.#.#.#####.#.
B....#.#.#.....#.
.#####A###.#####.
.....#.....#.q...
####.#######.####
...#.....#.#!#..A
.Q######.#.#####.
.....#...#......b
.###.#.###.######
...#.#...#.#.....
##.#.###.#.#.###.
.#.#.#...#.....#.
.#.#.#.#####.###.
...#...#a..#.#r..
.###B###.#.###.#.
.........#.....#.
17 17
.....#...#.......
####.#.#.#.#####.
...#.#.#...#...#.
.#.#.#.#####B#.#.
.#...#.#.......#.
.#####.#.#####.#.
.......#.#.....#.
.#######.#.#####.
.#.......#@#...#.
.#####.#.###.#.#.
.....#.#.#...#.#.
####.#.B.#.###.#.
.....#.#.#...#...
.#######.###.###.
.#.....#...#.#...
.#.###.#.###.#.##
...#.....#!..#...
17 17
.....#...........
.###.#####.#####.
.#.#!#...#.#@#...
.#.###.#.#.#.#.##
.#.....#...#.....
.#.#.###########.
.#.#.....#.....#.
.#.#####.#.###.##
.#.....#.#.#.#.b.
.B####.#.#.#.###.
...#...#...#...#.
##.#######.#.#.#.
.#.#.....#...#.#.
.#.#.a##.#######.
.#...#.#.#...#...
.#####.#.#.#.#.#.
.Q.........#...#.
17 17
.#!..#...........
.###.#######.#.##
...#...#...#.#...
##.###.#.#.#####.
.....#.#.#.....#.
.#####.#.#####.#.
.#...#...#.....#.
.#.#.#####.#####.
...#.......#S....
.###########.#.#.
.#.........#.#.#.
.#.###.###.###.#.
.#.#.#...#.....#.
.#.#.###.#######.
.#...#...#...#...
.#####.###.###.##
.......#........@
17 17
.......#...#..a..
.#.###.#.b.###b#.
.#q..Q.#.#.....#.
.###.#.#.#####.#.
.#...#...#.......
.#.#.###########.
.#.#.#...#.....#.
##.#.#.#.#.###.#.
...#.#.#...#.#.#.
.#####.#####.#.##
.............#..a
.#######S#####.#.
.A..@#......!#.#.
.#.Q##.#########.
.#...#...#.....#.
.###.###.###.#.#.
.......#.....#...
17 17
.............#...
.#########.###.#.
.........#.....s.
###R####.####R##.
.#.....S...#.....
.#.###.###.#.####
.#.#.#.#..s#.....
.#.#.#.#.####r##.
.#...#...#...#...
.###.#######.#.##
...#.....R...#...
.#########.#####.
.....#...#.#...#.
.###.#.#.#.#.#.#.
...#.#.#...#.#.#.
##.#.#.#####.#.#.
...#....@#!..#...
