abcdefghijklmnopqrstuvwxyz-=[];/
ABCDEFGHIJKLMNOPQRSTUVWXYZ_+{}:?
OOOOOOOOOOOOOOOOCCCCCCCCCCCCCCCC
9
17 17
...#.......S...#.
##.#.#.###.#.B.#.
...#.#.#...#!#...
.###.#.#.#######.
.#...#.#....@#...
.#.###.###.###.##
.#.#.#.a.#.#...#.
.#.#.###.#b#.###.
.#...#.#.....#...
.###.#s#######.#.
...#.#.........#.
.###.#.#.#######.
.#...#.#.#.....#.
.#.###.#.#.#####.
.#.#...#.#...#...
.#.#####.#.#.#.##
.....b...#.#.....
17 17
...#...#.........
##.#.#.#.###.#A#.
...#.#.R...#.#...
.###.#.###.#.#.##
.#!..#.#...#.#...
.#####.#.###.###.
...#.#.#...#.#.#.
.#.#.#.###A#.#c#.
.#...#.....#.#...
.###.#####.#.###.
.#.#...#@#.#...#.
.#.###.#.s.###.#.
.#.......#.....#.
.###############.
.#.....#.......#.
.#.###.#.#####.#.
.....#.......#...
17 17
.....#...#.......
.#.#.###.#.#####.
.#.#.....#...#...
.#.#########.#.##
.#.....t.#...#...
.#######.#.#####.
.#s#.....#.....#.
.#.#.#######.###.
...#.......Q.#...
##.#######.#.#.r#
.#.......#...#!#.
.#######.####a##.
...#.....#...#...
.#.#.#####.#.b#CR
.#.#.......#...#.
.#.###########.#.
@#...............
17 17
.....#.......#...
##.#.#.#####.#.#.
...#...#...#...#@
.#########.#.####
.#.........#.#...
.#qS##.#.Q##.#.#.
.#.#...#T#...#.#.
.#.#.#####.###.#.
.#.#.........#.#.
.#.###########.#.
.#.....#.#!....#.
.##q##.#.#######.
.#.....R.#...#...
.#####.#.#.#.#.##
.#...#...#.#.#..s
.#.#.#####.#.###.
...#.......#.....
17 17
...#.........q...
.#.#.###.#######.
.#.#...#.....#...
.#####.#####.####
.....#.#...#.#...
.#.###.#.#.#.#.B.
.#.....#.#.r.#.c.
.r######.#.#.#.#.
.#@#.....#.#...#.
.#.#.###.#S#####.
.#...#...#.#.....
.#.###.#.###.####
.#.#.#.#.#!R.....
.#.#.#.###.#####.
.#...#...#.#.....
.#######.#.#.###.
..C......#...#.S.
17 17
!..#...#.....#...
##.#.#C#.###.#.#.
...#.....#.#...#.
.###.#####.###a#.
.#...........#...
.#.#########.#.#.
.#..@#...A.#.#.#.
.###A#.#.#.#.#.#.
r....#.#.#...#.#.
####.#.#.#####.#.
...#...#.....#.#.
.###q#######.#.##
.......#...#.#...
.#.###.#B#.#.#.#.
.#.#.....#.C.#.#.
.s.#########.###.
.#.TA............
17 17
...#...#.......#.
.###.#.#b#####.#.
.....#!R.....#...
.###########.###.
.....#.......#...
####.#.#######.##
...#.#.....#.....
.#.#.#.###.#####.
.#.#.#..T#.....#.
.#.#.###.#####.#.
.#...#.....#...#.
.####C####.#.####
..A#.....#@#.....
##.#.Q##.#######.
...#.#.#.........
.###.#.#########.
.....#...........
17 17
.#.........#..q#.
.#.#####.###.#.#.
..B#...#c#...#...
.###.#.#.#.####t.
.#@#.#...#..!#...
.#.#.#########.##
.#.#.#.......#.#.
.#.#.#.###.###.#.
.#.#.....#.#...#.
.#.#######.#.###.
.#...#.....#.#...
.###.#.#####.###.
.#...#.#...#...#.
.#.#.#.#.#.###.#.
.#.#.#...#.....#.
.#.#.###T#######.
..Q#.............
17 17
...#@....#.......
.#.#####.#.#.###A
.#.....#...#.....
.#####.#########.
.#...#.....#.....
.#.#.#####.#.####
...#.#.....#.....
####.#.#########.
.....#...#.......
.##s####.###.####
...#.......c.....
.#.c######.#####.
.#.....#!r.......
.#####.#.#######.
.#.....#.......#.
.#.###########.#.
.#.............#.
