abcdefghijklmnopqrstuvwxyz-=[];/
ABCDEFGHIJKLMNOPQRSTUVWXYZ_+{}:?
OOOOOOOOOOOOOOOOCCCCCCCCCCCCCCCC
7
17 17
.........#.#.....
.#.####B.#.#.#.##
.#.#...Q...#.#...
Q#.#########.U##.
.A...........R.A.
.#D#############.
.#...#...#.....#.
.#.#.##q.#.###.#.
.#.#.....#.#.#...
.D.#####.#.#q###.
...#@..#.#.#..B#.
######.C.#.##C.#.
.......#.#...#.#.
.###.###.###.#.#.
.#.A.....#.#.#...
.#.#######.#.###.
...T.......#..!#.
17 17
.........#.....#.
.##d###S.#.#.#.#.
...#.#...#.#.#.#.
#d.#.#.#####.#.#.
...#.#..t....#...
.###.#######c###.
...#.....#.......
T#.#.###.#.######
..a#...#.#.#.....
.##S.A.###.#####.
..!#.c...#.......
####.###.#######.
...#.#.....#...#.
.###.#.#b#.#.#.#.
.#...#.#@..#.#.#.
.#.###.#####.#.#R
.....#.......u...
17 17
.................
.#.########sa###A
.#...#.....#!....
.##T.#.###.#####.
.#...#.#.#.....#.
##.#.c.#.#.QR###.
...#.#...#.......
.#######.########
.......#.#.....#@
.#####.#.#.#.c.#.
.....#...#.#.#.#.
####.#######.#.#.
...#.#.C.....#.#.
.###.#.#######.#.
.#...#.#.D.....#.
.#.###.#.#######.
.......#.........
17 17
..B............#.
.q######.#####.#.
.....#...#.....#.
####.#.#######.#.
...#.#.......#...
.##a.D######.####
.....#.....B.....
.#####.###.#####.
...#...#...#!#...
##.#.#.#R###.#.##
.#.#.#.....#...#.
R#.#.#s###A#####.
.#.#.....#...#...
.#.###U###.#.#.#.
.#...#.#S..#.#@#.
.###.###.###.###.
.........#.......
17 17
...#...A...r...#.
.#.#.#########.#.
.#.#.....#...#.#.
.#######.###.#.#.
......d#..!#.#.#.
####.Q.#####.#.#.
.....#.#...#...#.
.#.#####.#.#.###.
.tD#.....#.#...#.
.###.#####.###.B.
...#.#...#...#.#.
.#.#.#.#.#.#.#.#.
.#qa.#.#...#@#.C.
.#####.U######.#.
.#.r.#.......U.#.
.###.###T###.#.#.
...........#.....
17 17
.................
.###########.###U
.#.......d...#...
.#.#####S#.###.#.
.#.#..@#...#...#!
.#.#.B##.###.####
.#.#......U#.....
##.#####.#######.
...#...#.#.......
.###.#.###.####D#
....b#...#.#.....
.####Q##.#.###Ts.
.....#...#.....#.
####.#.######q.#.
.#...#.......#.#.
.#.#########.#.#.
...........#.....
17 17
@#.........#.....
.#.###.#####.#.##
.#...#.....#.#...
.###.#R###.#.###.
...#...#.#..u#.#.
##.###.#.#b###.#.
...#..c#.......#s
.#.#.###.#####.#.
.#.#.....#.....#.
.#####.#######.#.
.......#.....#.#.
##.#####q###.###.
!D...#...#.#...#.
.#b###.#u#.tq#.#.
.......#.....#...
########.#.#####.
.........#.......
