abcdefghijklmnopqrstuvwxyz-=[];/
ABCDEFGHIJKLMNOPQRSTUVWXYZ_+{}:?
OOOOOOOOOOOOOOOOCCCCCCCCCCCCCCCC
7
17 17
.....#.........b.
.###.#####.###.#.
...#...#...#.#...
##.###.#.###.###.
...#.#...#.#.....
.###.#B###.#.####
!#.....#...#.....
q#.###.###.####R.
.....#.#......@#.
.###.#.#.#.#####.
.#.#.#...#.#...#.
.#.#.#######.#.#.
.#.#.......#.#.#.
.#.#######.#.#.#.
.#.......#.Q.#.#.
.#######.#####.#.
....C....T...#...
17 17
....@#.......#...
.#####.###.##q.#.
.#.......#.#...#.
.#.#A#####.#.###.
.A...#.....#.#...
.###.#.#####.#.T.
.....#.#.....#.#.
######.#.#####.##
.....#.......#...
.###.###########.
.#.............#.
.#############.#.
...#.#.........#.
##.#.#.#########.
!..#...#...#.....
####.###.#.#t#.#.
.........#....s#.
17 17
.......#.........
.####C.#.########
.#.#...#.........
.#.#.#####.#####.
.#.#.....#.#.....
.a.#####.###.###q
.#..........q#...
.###.#########.##
...#.#.q...#.....
##.#.#.###.#####.
...#@#.#...#..!#.
.#####.#.#.#.####
...#r..#.#.#.....
.#.#.B##.#######.
.#.#.#.#.........
.#.#.#.##########
.#...............
17 17
...........#.....
.###.#####.#.#.#.
...#.R...#.#.#.#.
.#A#.#.#.#.#R#.##
.#...s.#.#.#.#...
##.###.#.#.#####.
...#@..#.........
.###########a###.
...............a.
.#############.#.
.....#....b..#.#.
####.#######.#.##
...#...#...S.#...
.#####.#.#.#####.
.......#.#.#..!#.
.#######.#.#.###.
.........#.R.....
17 17
...#!........#...
.###########.#.#.
.#S......#...C.#.
.#.#####.#.###.#.
.#.....#.#.#...#.
.###.###.#.#.#.#.
.....#...#.#.#.#.
.#####.#.#.###.#.
....@#.#.#...#.#.
.#####.#.###.#.#.
.#.....#...#.#.#.
##.#########.#.#.
..B#.........#.#.
.###.###S#####.##
...#...C...#.....
.#.##R.#.#.#####.
.#..A....#.......
17 17
.......#t......#.
##.###.#####.#.#.
...#C........#...
.###############.
.....#.#.....#...
.###.#.#.#b#.#.##
...#.#.#...#.#...
####.#.#.###.###.
c....#...#.....#.
.#####.###.###T#.
.#.......#.......
.#.###########.##
.#.....#....!#.#@
.#####.#.#####.#.
...#...#...#...#.
.#.#######.#.###.
.Q........a#.....
17 17
........T..#.#!#.
.#####.###.#.#.#.
.#...#.#@....#.#.
.#A#.#.#####t#.#.
.....#.#...#...#.
######.#.#b#.###.
.....#.#.#...#...
.###.#.#.q####.##
.#.#...#.#.......
.#.#.###.#.#####.
.#.#.#...#.#...#.
.#.#.#.#####.#.#.
.#...#...#.b.#.#.
.#######.#.###.#.
...#...#.#S#C#.#.
.#.#.#.#.#.#.#.#.
.#...#.....#.....
