abcdefghijklmnopqrstuvwxyz-=[];/
ABCDEFGHIJKLMNOPQRSTUVWXYZ_+{}:?
OOOOOOOOOOOOOOOOCCCCCCCCCCCCCCCC
13
17 17
.....#.......#...
.###.#.a##.#.#.#.
...#.#.#...#...#@
####.#.#.########
.....#.#.#......t
.##A##.#.#.#####.
...#...#.......#.
##.#.###########.
...#.#.#.........
.###.#.#.#.#####.
...#...#.#.#...#.
##.###.#.##a.#.##
.....#.#.....#...
.###.#.####S####.
.#...#.....#.....
.#########.#.####
...........#....!
17 17
.........#.......
.#######.#######.
.#...............
.##b############.
..b......#....@#.
########.#.#A###.
.........#.#.....
.###.#b###.#.####
...#.#...#.#...#.
##.#.#.#.#.###.#.
...#.#.#.#...#...
.#####.#.###.###.
.....#!#.#.....#.
####.###.#.#####.
.....#...#...#...
.#####.###.#.#.##
.......#...#.....
17 17
.....#..........a
.#####.##r##.###.
.#.......#...#...
.#.#####r#.#####.
.#...#.#...#...#.
.###.#.#.###.#.#.
.#...#.#...r.#.#.
.#.###.a##.s.#.##
.#.#.....#...#.#!
.#.#.###.#####.#.
.#.#...#@#...#.#.
.#.#.#.###.#.#.#.
...#.#.S...#.#...
.###########.####
.#...........#...
.#.#b#######.###.
.C.#.............
17 17
...........#...#.
.#######.#.A.#.#.
T.....@#.#...#...
.#######.###.#Sb#
.#.......#...#...
.#.###########.#.
.#.............#.
####.#####.#####.
...#.#...#...#...
.#.#.#.#.#####.#.
!#.#.#.#.....#.#.
##.###.#####.#.#.
.#...#.....#...s.
.###.#####.#####.
...#.......#...#.
.#.#########.###.
.#...............
17 17
...........#.....
####.###.###.###.
.....#...#...#...
.#####.###.###.##
...#@..#...#!Q...
.#.#####.###.###.
.#.....#...#.#...
.#####.#.###.#.##
.#...#...#...#.#.
.###.#####.###.T.
.#.....#...#...#.
.#.###.#.#####.#.
.#...#.#.......#.
.#.#.#.#########.
.#.#c#...........
.###.###########A
.....#....B......
17 17
...#.....#.....#@
.#.#.###.#.###.#.
.#.#...#...#.#.#.
.#.##s.#####.#.#.
.#.....#...#...#.
.#########.#.###.
.#...#...#.......
.#.#.#.#.########
.#.#.#.#.........
.#.#.#.#########.
.#.#...#.#.....#.
.#.#####.#.###.#.
.#.......#...#...
.#######.###.####
...#.....#.#!#...
.#c#.#####.#####.
.#...............
17 17
.........#.......
.#######.#.###.#.
...#.....#...#.#.
##.#.##T.#####.##
.#.#...#.#...#...
.#.#b#.as#.#.###.
.#...#.....#...#.
.###.#########.#.
...#.#@#...#!..#.
.###.#.C.#.#####.
...#.#...#.......
##.#.#####.#.###.
...#.....#.#...#.
.#######.#T###.#R
.........#.#...#.
.###########.###.
.............#.R.
17 17
.#...............
.#.#####.#######.
.#.#.....#.....#.
.#.#.#####.#.#R#.
...#.#.#Q..#.....
####.#.#.########
.....#.#.........
.#####.#########.
...#.....#.......
.#.#.c.###.######
.#.#.#...........
##.#.###########.
...#@#...#.....#.
.#####.#.#.###.##
.....#.#.....#...
.###.#.S########.
c..#...#!........
17 17
..T..#...#.......
.#.###.#.#.#.###.
.#.....#...#.#...
.###########.#.C#
...#.....#...#.#.
##.#.###.#.###.#.
...#.#.#...#.#.#.
.###.#.#####.#.#.
.#...a.....#.#.#.
##.#####.#.#.#.#.
!#.#.....#...#...
.#r#.###.#######.
.#.#.#@..#.......
.#.#.#####.######
.#.#.....#.#.....
.#.#.###.s.#.###.
...#...#.....#...
17 17
b..#...#.........
.###.#.#.#.######
.....#.#.#...#...
.#####.#.###.#.#.
..a..#...#...#.#.
B#####.###.###.#.
.....#...#....R#.
.###.###.#######.
.#...#.....#.....
.#.#########.###.
.#.....#.....#.#.
.#####A#.#####r#.
.#!#.....#.....#.
.#.#######.###.#.
.#.....#@b...#...
.#####.#.###.####
.......a.........
17 17
.............#...
##.#########.###.
...#.....#C....b.
.#.#.###.#######.
.#.#.#...#...#...
.#.#.#.###.#.###.
.#.#.#.....r...#.
.#.#.########A.#.
.#@Q.#.......#!#.
.###.#####.#.###.
...#.....#.#.....
##.#####.#######.
......T#.......q.
.#############.#.
.#.......B...#.#.
.#.######R##.#.#.
...........#...#.
17 17
.....#...........
.#.#.#.#R###.####
.#.#.#.#...#.....
##.#.#.s.#######.
...#.#.#...#.....
.###.#.###.#.###.
...#.#.#...#.#.#.
##.###.#.###.#.#R
s..#.....#...#...
.#a#.#####.###.##
...#...#...#...#@
.#.###.#.###.###.
.#.....#.#.....#.
.#####.#.#####.#.
.#..!#.#.....#...
.#.#########.###.
.#...........#...
17 17
.................
.T##.############
...#...#.........
##.###.#s#######.
...#.#.#.#...#...
.###.#.#.#.#.#q##
.#..r#.#.#.#.#...
.#.#.#.#.#.####B.
.#.#.#...#.#...#.
.#.#######.#.#.#.
.#..b........#.#!
.###.#########.##
...#.#.......#...
##.###.#####.#.#.
...#...#..@#...#.
.###.###.#######.
.....#...........
