abcdefghijklmnopqrstuvwxyz-=[];/
ABCDEFGHIJKLMNOPQRSTUVWXYZ_+{}:?
OOOOOOOOOOOOOOOOCCCCCCCCCCCCCCCC
7
13 13
.....#.......
.#.#.#######.
.#.#...#...#.
.#.###.#.#.#.
.#.#@#...#.#.
##.#.#####.#.
...#...#...#.
.#####C#.###.
.#.T...#...#.
.#.#######.#.
!#...#..t#.#.
##.#.#.#.#.#.
...#...#.....
13 13
@#....Ra.....
.#.#.#.###.##
.#.#.#...#...
.#.#.###.###.
...r.#.......
.###.########
.#.#...a.....
.#.T####R###.
.........#...
###t####.#.##
...#.....#.#!
.###.#####.#.
...a.....#...
13 13
.#!......#...
.#######.#.#.
......A#...#.
.#####.#####.
...#.#...#@#.
##.#.###.#.#.
...#.....#.#.
.#####s#.#.#.
...#...#.#.#.
.#.#.#.#.#.#.
.#.#.#.#...#r
.#.#.#.#####.
.#..c#.......
13 13
..@#.........
.###.###.###.
.....#.#..Q#.
.#####.###.##
.#.......#.#!
.#####.#.#.#.
...#...#.#q..
##.#.###.####
.#...#.#.#...
.#####.#.###.
.......#.#...
.#.#####.#.#c
.#..B......#.
13 13
.#...........
.#.#########.
...#......@c.
.#t#t#.#####.
.#.....#.....
.###.#.#.####
...#.#.#.#..!
##.#.#.#.#.##
..S#.#.#.B.#.
.###.#.#.#.#.
...#.#.#.#...
##.#.#.#.###.
.....#.#.....
13 13
...........#.
.#.c######.#.
.#.#....B#A..
##.#.#######.
...#.........
.a###########
.#b..........
.#.######b##.
...#......@#.
.#####.#.###.
.......#.#...
####.#####.#.
.....#!....#.
13 13
.....#t......
.###.#######.
...#...#...#.
##.###.#.#.#.
.s.#.....#.#.
.#########.#.
.......#@#.#.
.#####.s.#.#.
...#.#.#...#.
##.#.#.###.#.
...#.#...#.#.
.a##.###.#.#.
.....#!..#...
