abcdefghijklmnopqrstuvwxyz-=[];/
ABCDEFGHIJKLMNOPQRSTUVWXYZ_+{}:?
OOOOOOOOOOOOOOOOCCCCCCCCCCCCCCCC
3
17 17
@....#....C..#a..
####.#.#.###.###.
...A...#...#.#...
.#.###.###.#.#.#.
.#...#...#Q#...#.
.###.#####.#####.
...#....a#.....#.
##.#####.###.#.#S
.#.#..T#...#.#.#.
.#.C.#####.###.##
.#.c.....#..!#...
.#.#.###.#####.#.
...#.#...#...#.#.
.#####.#.#.###.#.
.#.....#.#.....#A
.###.###.#######.
.....#...........
17 17
B#.........#.....
.#.#####.#.#####.
...#@#!#.#.#..R#.
.###.#.#.#.#.#.#.
.....#.#.#...#...
######.#.##Q####.
.......#.#...#...
.#######.#.#.###.
.#.....#...#t..#.
.#.###.#.#####.##
.#...A.......#...
.###.#####.#####.
.#...#...#.#.....
.a####.#.###.###.
q....#.#.....#..c
#C##.#.#######.#C
.......#.s.......
17 17
...........#.....
.#.#######.#.###.
.#.......#..T#@..
.#######.#.######
...#.#...#.#.....
##.#.#.#####.##B.
.B.r.#.....#b..#.
.#.#.#####.Q##.#.
...#.....#.#...#.
.###.###.#.#.###.
.....#.#B#r..#...
#c####.#.###R#.#.
...#...#...#!#.#.
.#.#.#.###.#.#.##
.#...#.#...#.#...
.#####.#.###.###.
.....#.....#.....
