abcdefghijklmnopqrstuvwxyz-=[];/
ABCDEFGHIJKLMNOPQRSTUVWXYZ_+{}:?
OOOOOOOOOOOOOOOOCCCCCCCCCCCCCCCC
1
17 17
..A........#...#.
.###.#######.#.#.
.#.#....b..#!#.#.
.#.####A#T.###.#.
.#...#...#....a#s
.#.###.#.#####s#.
.#.#...#..R......
c#.#.#####.#####.
.#...#.Q.#.....#.
.#####.#.#.###.##
.....#.#.#...#r..
####q#.#.#####.#.
...#...#...B.#.r.
.#.#########.###.
.#...#.....#...#.
.#T###S###.r##.#.
@#.......#.t....C
