abcdefghijklmnopqrstuvwxyz-=[];/
ABCDEFGHIJKLMNOPQRSTUVWXYZ_+{}:?
OOOOOOOOOOOOOOOOCCCCCCCCCCCCCCCC
15
17 17
.....#.....#.....
.###.###.#.#.###.
...#...#.#.....#.
.#####.#.#A#####.
.#..!t.#...#...#.
.#.###.#.###.#.#.
.#.....#@#...#.#.
.#####S###.###.#.
.#...#.....#.#.#.
.###.#.#.###.#.#.
...#...#.#.....#.
##.#.###.#.#####.
.#.#...#.#...#...
.#.#####.###.#.#.
...#.....#...#.#.
.###.#####.###.#.
.....#.........#.
17 17
...#.....#.......
.#.#.###.#.#####.
.#.....#.#.#.....
########.#.#.####
.......T...#..C..
.#####.#####.###.
.#...T.....#...#.
.#########.#####.
.....#...#.......
#B##.#.#########.
...#.#........@#.
.#.R.#######.###.
!#.#.......#...#.
##.#.#####.##Q.#.
...#.#q..#...#.#.
.#####.#.###.#.#.
.......#.....#...
17 17
.....#...#.......
.###.#.#.#.#.###.
.#.#...#.#T#.#...
.#.#####.###.###.
.#.....#...#...#.
.###.#.###.#.#T#c
...#.#...#.#.#...
.#.##R.#.#.#####.
.#...#.#@#...#...
.###.#.#####.#.#A
...#.#.......#...
####.#.#########.
.....#b#.........
.#####.###.#####.
...#!#...#.#.#...
.#.#.###.#.#.#.##
.#...#.....#.....
17 17
.....#...........
##.###.###.######
...#...#.#...#!..
.##b.###.###.###.
...#.....#.#...#.
.#.#####.#.###.#.
.#.....#.#...#...
####.###.#.#.####
.....#...#.#.....
.#####.#tb####.#.
.#.....#.....#.#.
.#.#######.#.###.
...#...#...#.....
.a##.#.#.#C#####.
.....#.#...#..@#.
#####T.c##.#.###.
...........#.....
17 17
.#...............
.#.###########.t.
.#...#.....#...#T
.###.###.#.#.###.
...#.....#.#.#.#.
.#.###.#B###.#.#.
.#...#.#.....#...
####.#.#.#####.##
.....#.#.....#..@
.#Ct##.#####.####
...#...#.#...#...
.#.#.###.#.###.#.
.#.#.#...#.#...#.
.#.#.#.#.#.#.###.
.q...#.#.#.....#.
.#####.#.#######.
.......#.....#!..
17 17
@..#.....#.......
##.#.#.#.#b#####.
...#.#.#.A...#...
.#.#.#.#####.#.##
.#.#.#.......#...
.###.#s######R##.
...#...#.......#.
.#.S##.#####.###.
.#...#...#...#...
.###.###.#.###.#.
...#...#...#...#.
.###.#####.#.####
.#...#.....#.#..!
.#.###.####a.#.##
.#.....#...#...#.
.#########.#####.
.................
17 17
...........#B.S..
.######t##.#####.
...#!....#.......
.#.#####.#####b##
.#.....#...#.....
.###.#####.#.###.
...#.#...#.#.R...
##.#.#.#.#.#.###.
.#.#...#.#.#...#.
.#.##b##.#.###.#.
...#.#...#...#.#.
.#R#.#.#####.#.#.
.#...#.#.R.#...#.
.s.#.#.#.#.#####.
...#.#.#.#...#...
#Q##.#.#.#.#q#.##
@....#...#.......
17 17
.........#.....#@
.#######.###.S.#.
...#...#...#.#.#.
.#.#.#####.#.#.#.
.#c#.........#.#.
.#.###.#######.#.
.#...#.#!....#...
####.#.#####.###q
B....#.#...#.....
.#####.#.#######.
.#...#...#.....#.
.#.#r#.###.#.###.
...#.#.#...#.....
.###.###.########
...#.#...#...#...
##.#.#.###.#.#.#.
...#.......#...#.
17 17
..sS.........#.c.
.###.#####.#.#.#.
.#...#...#.#.#.#.
.#.#####.#.#.#C#.
.#.#.....#.#.....
.#.#S#####.#b####
...#.#...#.......
.###.#.#.###c#.#.
.....#.#.....A.#.
####.#.#####.#.#.
.....#.#...#.#.#.
.#####.#.q.#.###.
.#.#!#...#.#.....
.#.#.###.#.#####.
...#...#.#.....#.
##.###.#######.#.
@....#.........#.
17 17
.....Q...#.......
.#########.#.###.
...........#.#.#.
.##q########.#.#.
.#.....#...#.#.#.
##.###B#.#.#.#.#.
...#..q.c#.#.#...
.###.#####.#.####
.#...#...#...#...
.#####.#.#.###.#.
.#.....#.#.#...#.
.t.#####.###.###B
.#t....#.....#...
.#.###########.#.
.#.#..A........#.
.#.#.###########.
.S.#!#@..........
17 17
.......#.........
.#.###.#.###.####
.#.#.....#...#...
.#.#.###b#####.#.
.#.#...#!.....a#.
##.##########R##.
...#.....#.....#.
.###.#.Q.###.#.#.
.....#.#.....#.#.
.#####.#########.
.....#.........#.
#Rt#.#########.#.
..@#.#.........#.
.###.#.###.#####.
.#...#...#.#...#.
.#.#####.###.#.#.
.......#.....#...
17 17
.............#...
c###.#######t###.
...#.......q.....
.#.###.###.#####.
.#...#.#...#...#.
.###.###.#####.#.
...#...#.....#...
##.###.#.###.#S#.
...#.#.#...#...#.
.###.#.#######.#.
.#...#.#...#...#.
.#.###.#.#.#.###.
.#.......#.#...#@
.###.#####.###.R#
...#...#!#...#...
.#.#####.###.###.
.#.......#.......
17 17
.....#...#...#..Q
.#.#.#.#.#.###.#.
.#.#.#.#.#.....#A
.#.#.#.#.###.###.
.#.#...#...#.#...
.#.#######.###.#.
.#...#.........#.
.###.###r#bb####.
...#.....#.......
##.#####.######S#
.#.#.....#.......
.#.#.###.#.#####.
...#.#...#!#...#.
.###.#########.#.
.#A#...........#.
.#.#c#####.###Q#.
........@#.......
17 17
.........#.......
.###.#####.#####.
..@#.......#.....
######.#####.###.
.....#.#C..#.#.#.
.###.###.#.#.#.#.
..!#...#.#...#...
######.#.#####.##
.......#.....#...
.A##b###.###.####
.#.....#...#.....
.#.###.###.#####.
.#.#.#.s.......#.
.#.#.#.###.#####.
...#QQ...#.#.....
####.###.###.###.
.............#...
17 17
.....#...#.#!....
.###.#.#.#.#####.
...#...#...#.....
.#.#######.#.t###
.#.#.......#.#...
##.#.a######.#.#.
...#......@#...#.
.####b##.#######.
.....#...#.......
####.#.###.######
.....#.#...#.....
.#######.###.###.
.......#.#...#...
.#####.#.#q#.###.
.#.#...#...#...#.
.#.#.#####.###.#.
...#...........#b
