abcdefghijklmnopqrstuvwxyz-=[];/
ABCDEFGHIJKLMNOPQRSTUVWXYZ_+{}:?
OOOOOOOOOOOOOOOOCCCCCCCCCCCCCCCC
7
17 17
Sb.#.#.....#..!#.
.#.#.#.###.#.###.
.#...#...#...#...
.#######.##A##.#.
.#.....#.#.....#.
.#.#.###.#.###.#.
...#.....#.#...#.
.#r#########.###.
...#.......#.#@..
##.#.###.#.#.####
...#...#.#...#...
.#C#####.#####.#.
.#.....#.......#.
.#.###.#.#######.
...#.#.#...#...#.
####.#.#####.#.#.
...Q.........#...
17 17
.....#...#...#...
s###.#.#.#.#.R##.
...#..R#.S.#..T..
.#.#####.#######.
.#...#t..#.c.#@#.
.###.#.###.#.#.#.
...#.#.#...#.#...
####.#.#.###.####
.....#.#.#.#.....
.#####.#.#.#s###.
...#...#...#.....
.#.#######.#.###.
.#...#q....#.#.#.
.###.#.##R##.#.Q.
...S.#...#!#.#.#.
##.#.###.#.#.#.#.
...#.....#...#...
17 17
...#...#...#!#...
.c##.#.#.#.#.#b##
.....#.#.#...#...
.#####.#.#######.
.#.....#.......#.
.#.SQ###C#####A#.
.#...........#...
.t#q####.###.###.
.......#.#...#...
######.#.####c.##
..@#...#.#.....#.
.###.###.#.#####.
.#...#.#.#.#.....
.#.###.#.#.#.###.
.#...#.#.#...#.#.
.###.#.#.#####.#.
.......#.........
17 17
.........t...#...
.###.#####.#.#.#.
...#.......#...#.
##.#############.
.#.#.....#.......
.#.#.#####.#####.
...t.#...#...q...
.#####.#.###.#.r#
...#!#.#.#...#...
##.#.#.#.#.######
...#...#.#.......
.#######.#######.
.......#.....#...
##A###.#####.#.##
.....#...#@#...#.
.#######.#.#####.
...c.............
17 17
.............#..!
######.####A.#.##
..SR.#.#.....#...
.###.###.###.###.
.#.....#..T#...#.
.#####.#.#.#####.
.#...#.#.#.#.....
.#.#.#.###.#.####
...#.#.....#.#...
.#t#.#####.#.###.
.#.#B....#.#.#...
.#.#####.###.#.##
.#.....#.....#...
.#.#.#.#######.#.
.#.#.#.......#@#.
.###.#######.###.
.....#...........
17 17
.........#...#...
.###.###S#.#.#.##
...#.......#.#...
#T.###R####S.#.#.
.#.......#...#.#.
.#.#######.###.#.
.#.R..!#...#.#.#.
.#.#.###.###.#.#.
...#...#.#@..#.#.
.#####.#.###.#.#.
.#r#...#.#...#.#.
.#.#.###.#.###.T.
.#.#...#.#.#...#.
.#.###.#.#.#.###.
.#...#...#...#...
.###.#c#######.q.
..C............#.
17 17
.........#.......
.#####.###.#####.
...#.#.....#...#.
##.#.#########.#.
.#.#...........#.
.a.#.#########.#.
.#.#...#.#.....#.
.#.#.#.#.#.###.#a
...#.#.#...#!#.#.
.#####.#.###.S##.
...#...#..@#.....
##.#.############
.#.#.............
.#.#.####c###q.#.
.#.#.....#...#.C.
.#.#######.#.###.
...........#.....
