abcdefghijklmnopqrstuvwxyz-=[];/
ABCDEFGHIJKLMNOPQRSTUVWXYZ_+{}:?
OOOOOOOOOOOOOOOOCCCCCCCCCCCCCCCC
7
21 21
.#.....#.........#...
.#.#.#.#####.#.#.###.
.#.#.#.....#.#.#s....
.#.#.#####.###.#####.
...#.#...#.....#...#.
.###.#.#.#######.#.#.
.#...#.#@#.......#.#.
.#.###.###.##s##.###.
.#...#...#.....a.....
.###.#.#.###.#######b
...#.#.#.....#......A
##.#.#########.#####.
...#.#.........#.#...
.###.#.#########.#.##
.#...#.#....!#...#.#.
.#.###.#.#####.###.#.
.#...#...#.....#...#.
####.#####.#.###.###.
.......#...#...#.#...
.#######.#####.#.#.#.
..........s..#.....#.
21 21
....a..........#.....
.#########Q###.#####.
!#....b..#.#q..#...#.
##.#####.#.#.###.#.#C
.T.#.....#.#.....#...
.#T###.###.#########.
.#...#...#.#.........
.###.###.#.#.########
...#...#...#.#.......
##.t##.#.###.#.#.#C##
...#.#.#.#...#.#.#...
.###.#.#.#.###.#.#.#.
.#...#.#.#.#S..#@#.#.
.##C.#.#.#.#.#.###.#.
...#.#.#.A.#.#...t.#.
##.#.#.#.S.#.#######.
.#.#.#.#.#.#.#.......
.#.#.#.Q##.###.R####.
...b.#...#.....#.q..b
.###.###.#######.####
.......#.............
21 21
...#.............A...
.###.#######.###.#.Q#
.....#....Q..#...#...
.#####.#.#####.#####.
...#.#.#.#...#.......
##.#.#.##C.#.#.#####.
.#.#.#.....#.#.#...#.
.#.#.#####.#.###.#.#.
...T.#..!#.#.....#.#.
.#####.##t.#######.#.
@#...#.#.q.....#...#.
##.#.#.#.#####.#.####
...#...#..R....#.....
.#######.########Q##.
...#...#.B...r.....#.
R#.#.#.#.###.#.###.#.
...#.#.....#T#.#...#.
.####t####.###.#.###.
.........#.....#.#...
########.######s##.#.
...................#.
21 21
............r#...#...
.###########.#.#.#.T.
.#.....#.......#.#.#.
c#.###.#.######B.###.
.#.#...#.#.#...#.....
.#.#.###.#.R.#.#####.
.#.#.......#.#...#...
.#####.#####.###.##c#
.#...#.#.......#.....
.#.#.#.#.#######.###.
...#.#.#...#...#...#.
.###.#####.t.#.#####.
.#.#.....#.#.#.......
.#.#####R#.#.###.####
.#.....#...#...#.#...
.#.###.#######.###.#.
.#.#.........#.....#.
.#.T.##a############.
...#...#.............
######.#.############
@......#............!
21 21
......@#.......#.....
.#######.#.#####.###.
.#...#...#.......#...
.#.#.#.###########.##
.#.#...#...#.....#...
.#.#####.#.#.###.#.#.
.......#.#...#...#.#.
.#######.#####.#q#.#.
.#.......#...#...#.#.
.#.#######.#####.#.#.
.#.#.....#...#...#.#.
.#.#.###.###.#.###.#.
.#.#.#....c..#.#...#.
##.#.#########.#.###.
...#.#..b......#.#...
.###.#.###########.##
.#...B.#.........#...
.#.#.#.#.#####.#.###.
!#.#.#.#.#...#.#.....
##.#.#.###.#.#.#####.
...#.......#...#.....
21 21
.#.......#.........#.
.#.#####.#.###.###.#A
.....#...B.#.#...#...
.#####.###.#.###.###.
.#.#!#.#@#.#...#...#.
.#.#.#.#.#.###.#B#.##
...#.#.#.#...#...#...
##.#.#.#.###.###.###.
...#...#.........#...
.################r.#.
.#...#.......#.....#.
.###.#.#.###.#.#####.
...#Q..#...#.#.#.....
##.#.#####C#.#.#.####
...#.#...#.#...#.....
.#####.#.#.#########.
.#.....#.#.B...#.#...
.#.#####.#.#.#.#.#.##
...#...#.B...#r#...#.
####.###.#####.#.###.
...............#.....
21 21
.......#...........#.
.#####.#####.#####.#.
.#.........#.#.....#.
.#########.#.#.#####.
.......#...#.#.....#.
######.#.###.#####.#.
.......#.....#!#...#.
.#####a#.#####.###.#.
.#@......#...#...#.#.
.#########.q.###.#.#.
.#.........#...#.#.#.
.#.#########.#.#.#.#.
.#.#...#.....#.#.#...
.#.###.#.#####.#.###.
.#...#.#.#...#.#.#...
.###.#.#.#.#.###.#.##
.#.....#.#.#.....#...
.#.#####.#.#########.
.#..B#...#.#...#.....
.###.#.###.#.###.####
.....#.....#.........
