abcdefghijklmnopqrstuvwxyz-=[];/
ABCDEFGHIJKLMNOPQRSTUVWXYZ_+{}:?
OOOOOOOOOOOOOOOOCCCCCCCCCCCCCCCC
5
17 17
...........#.....
.#.####s##.###.#.
.#.#.......#...#.
.#.#######.#.####
.#A......#...#...
.#######.#.###.#.
.#...#...#.#...#.
.#.#.#.###.Q.###.
.S.#.#.C...#...#.
###b.#.######r.#.
...T.#.#c....#!#.
.#####.#.#.#####.
.#...#...#.#....r
.#C#.#####.#.C###
...#.#.#...#.#...
####.#.#.###.#.#.
@......#b......#.
17 17
.#.........#.....
.#.###.#####.###.
...#.#.......#...
.#a#.#B####A##.a#
.........#...b...
########.#.#BS##.
.....#...#r#.#...
.###.#.###.#T#.#.
.#...#.....#...#.
.#.#.#####.#.####
.#.#.#...#.#.....
.#.###.#.#.#####.
.#...#.#.#...#...
.###.#.#.###.#.##
...#.#.#..@#.#...
##.#.#.#.###.###.
...#...#.......#!
17 17
...#.............
.#.###.#.##r#####
.#...#.#.........
.###.#.#########.
..!#.#....@#...#.
####.###.###.#.#.
.....#...#...#...
.##Q###B##.#####.
.#.........#.#...
.#####.#####.#.##
...#Q..#...#.#...
##.#.###.#.#.###.
.#.#.....#.#....B
.#.#######.######
...#.....#.......
.###.###.#######.
.....s...........
17 17
.#.....#.........
.#.#.###.#######.
.#.t.....#.....#.
.#.#######.###.#.
.#.#@#...#..t#...
.#.#.Rq#.###.###b
.#...#.#...#.....
.#.###.###.####t.
...#...#...#.....
.###.###.###.###.
...#!#a..#.....#.
##.###.###.###.##
...#...#.a.#q#...
.###.#c#.#B#.###.
s#.#...#.....#...
.#.###.#######.#.
.....#.........#.
17 17
.....#...#...#..!
.###.#.#.#.#.#.##
.#R....#...#.#.#T
.#########.###.#.
...#...#...r...#.
.#.c.#.###.#.r##.
.#...#...#.q.....
.#######.#.#####.
.......#.#.....#.
########.#####.#.
.....#...#.....#.
.###s#.#.#######.
.#.c...#.#.......
.#######.#.######
.....#Q..#.#@....
.###.#####.###.#.
...#...........#.
