abcdefghijklmnopqrstuvwxyz-=[];/
ABCDEFGHIJKLMNOPQRSTUVWXYZ_+{}:?
OOOOOOOOOOOOOOOOCCCCCCCCCCCCCCCC
5
17 17
................C
.###############.
.#.....#.q...#...
.#.###.#.###.#.##
.....#.A...#.#.#.
######.#####.#.#.
!....#.....#...#.
####.#.###.#.c##.
...#.#.#...#.....
.#.#.###.#######.
.#.#...#A#...#...
.#.###.#.#.###.#s
.#.#@#...#.....#.
.#.#.####s.#####.
.#...#...#...#q..
.#####.#.s##.#.#.
.......#......b#.
17 17
.................
c#######.########
.#.#...#...#....!
.#.#.#.###.#.####
.#.#.#S..#.#...#.
.#.#R###.#.###.#.
...#.#.t...#@#.#.
####.#####.#.#.#.
...#...B.#.#.#.#.
.#.###.#.#.#.#.#.
.#.....#.....#...
.#####.######A##.
...#.#.R.......#.
.#.#.#.#.###.###.
.#.#...#...#...#.
.#.#######.###.#.
.#...........#...
17 17
.#.........#.....
.#.#####.#.#####.
...#..!#.#...#...
.###.#####.#.#.##
.#.s.....#.#.#...
.#.#####.###.###.
.#.....#.....#...
.#####.#######.#.
.........#.....#.
########.#####.#.
.......#.#.....#.
.#####.#.#.#####.
.#.#...#.#.#.....
.#.#.#.#.#.#.####
.#.#.#.#...#.#...
.#.#.#######.#.#.
...#...........#@
17 17
...#...........#.
.#.#.#.#######.#.
.#...#.......#...
.###########.###.
.#...#q....#...#.
.#.###.###.#q#.#.
.#.#...#...#...#.
.#.#.#####.#.####
.#.#...c.#...#...
.#.#####.#####.#.
.....#.#.......#.
##r#.#.#########.
..@#...#.....#...
.#####.#.###.#.##
.........#...#...
.###############.
.....#!.......a..
17 17
.....#..B......#.
##.#.r##.###r#.#.
...#b#...#...#.#.
.###.#.###.###.#.
.#...#...#q..#.#.
.###.###.###.#.cT
...#.....#...#.#.
.#.#######.#.Q.#.
.#.#...A.#.#.#r#.
##.#.#A#.#.###.#.
!..#.#.....#...#.
####.#######.###.
.....#.....Q.#@..
.###.#.C########.
.#.#.#s..#.....#.
.#.#.###.#.###.b.
...#......t#.....
