abcdefghijklmnopqrstuvwxyz-=[];/
ABCDEFGHIJKLMNOPQRSTUVWXYZ_+{}:?
OOOOOOOOOOOOOOOOCCCCCCCCCCCCCCCC
7
25 25
.#.........#.s.....#.....
.#.#####.###.#.###.#####.
.#...#.#.T...#...#.......
.###.#.#.#.#####.#######.
.#.....#.......#...q...#.
.#.###########.###.#.###.
..T#.....#.......#.#.....
####.###.#########.#.####
.....#.............#.....
.#T########t############.
.#.#...#...#.....#.....#.
.#.#.#.#.#.#.###.#.###.#.
.#.#.#.#.#.#...#.#.#B#...
.###.#.#.#.###.#.#.#.####
.....#.#.#.....#.#.#...#t
.#####.#.###.#####.#.#.#.
.#.#...#.#@..#...#...#...
t#.#.###.#####.#.#######.
.#.#.#.....#...#.........
.#.#.###.S.#.#####.######
..q#...#.#...#!..#.#.....
##.###.#########.#.#####.
.#.#.#...#...#...#.....#.
.#.#.###.#.#.#.#######.#.
...B...#...#...#.........
25 25
...........#.........#...
####.####t.#.###.###.###.
.....#.....#...#...#...#.
.#########.#####.#.###.#.
.#...#..!#.....#.#...#.#.
.#.#.#.#######.#####.#.#.
...#.#.....#.#.#.....#...
####.#####.#.#.#.#######.
.#...#.....#.#.#.#.......
.#.###.###q#.#.#.####T.##
.#...#.....#...#.....#...
.###.#####.#.#######.###.
...#.....#.#.........#.#.
#A.#####.#.###########.#.
...#...#...#...S.#.......
.###.#.###R#####.#.######
.....#.......#...#.#.....
.#####.##s##.#.#.#.#####.
.#@..#...s.#...S.#.......
.###.###.#.###.#########.
...#...#.#.....#.....#...
##.###.#.###.###.###.#.##
.#...#.#...#...#...#...#.
.###.#.###.#######.#####.
.........#...............
25 25
...........#...#...#.....
.#####.R.###.#.#.#.#.###.
.#.....#.#!..#.#.#...#...
.#.#####.#####.#.#####.#.
.#.#.....#...#.#...r...#.
.C.###B#.#.#.#.#####.###.
.#.....#.#.#...#.....#.#.
.#####.###.#####.#####.#.
...#.#.....#...#.#.....#.
##.#.#######.#.#.#.##S##.
.#.....b.#...#.#.#.....#.
.#######.#.###.#.#.###.#.
.#.....#.#.#.....#...#.#.
.#.###.#.#.c##########.#.
.#.#.#...b...B.........#.
.#.#.#######.#.#.#.#####.
.#...#.......#.#.#.#...#.
.###.#.#######.#.#.#.#.T.
.....#...#...#.#.#.#.#...
.#######.s.###.t.###.##S#
.........#.....#.#...#...
##########.#####.#.###.##
........@#.#...#.#...#...
.###.#####.#.#.#.###.##c.
...#.........#.#.........
25 25
..B..#.....#...#.........
.####R.#.#.T.#.#.###.#A#.
.....#.#.#.#.#.....#...#.
.###.#.#.#.#.#########.#.
.#.#...#.#t#.#.#...#...#.
.#.#####.B##.#.#.#.#.###.
.#.#...#...#...#.#!#...#.
.#.#.#.###.###.#.###.#.##
...#.#.....#...#...#.#...
.###.#t###.#.#####.#####.
.#...#.#...#...#...#.....
.#.###.#.#####.#.###.####
.#.#.....t...#.#q#...#...
.#.##Q##.#.#.#.#.#.####B.
.#.....#.#.q.#.#.#.....#.
.#####.t.#.#.#.#.#####.#.
.....q.#...#.#.#.......A.
######.#B#####.#########.
...#...#.......#.........
.#.#.###.#######.#####c#.
.#.#.#...#@....#.....#...
.#.#.#.#####.#.###.###.#.
.#..c#.#...#.#.....#...#.
.#####.#.#.#########.###.
.........#...........#...
25 25
.......#...........#..!#.
.#####.#.#####.###.#.###.
.#...#.....#.#...#.#...#.
#T.#.#####.#.###.#.###.#.
...#...#.....#...#...#.#.
.b####.#######.#####.#.#.
...#...#...#...#@....#.#.
##.#.###.#.#.#######R#.#.
...#..C..B...#.........#.
.#####.#####.#.#########.
.#...C.#...#.#...#...#...
.#.#.#.#.#.#####.#.c.###.
...#.#.#.#.......#.#.#...
.#A#.S##.Rr#######.#.#.#.
...b...#.#.......#.#.#.#.
####.#.#.#.#####.#.#.#.#.
...#.#.#.#.#.....#.#...#.
.c.###.#.#.#.#####.S####.
.q.....#...#.#...#.#.#...
.#.#########.#.#.#.#.#.##
.#.#.....#..r#.#...#...s.
.###.#R###.###.#######.#.
..A#.#...#.#.........#.#.
.#.#.###.#.#########a#.#.
.#.....#.............#...
25 25
..S#...............t.#...
.#.#.#####.##q######.###.
.#.#...#...#...#.........
.##R##.#.###.#.#.########
.......#.#...#....a#.Q...
.###b###.#.#########.###.
...#.....#.#...#.....#...
##.#.#####.#.#A#.#####.##
...#...#...#T..#.#...T.#.
.#####.#.#####.#.#.#.#.#.
.#.....#...#...#...#.#.#.
.#.#######.#.#######.#.#.
.#.#.........#.....#.#...
##.#.#########.R.#S#.###.
...#..@#.......#...#...#.
.#######.#########.###.#.
.........#.......#...#!#.
.###########.###.#.#.###.
.#.........#...#.#.#.#...
.#.###.###.###.Q##.A##.##
.#.#...#.#.#s..#...#...#.
.###.###.#.#.#.#.###.###.
...#...#.#a..#.#...#.#...
##.###.#.#####.###.#.S.#.
.......#......R..#.....#.
25 25
....@#!..#.......#.......
.#######.#.###.#.###.###.
.....#...B.#...b...#.#.#.
.###.#.###.#.#####.#.#.#s
...#.#...#.#...#.#.#...#.
#C.#.#b#.#.###.#.#.#####.
...#.#...#.#...#.#.#...#.
.###.#.#####.B#s.#.#.#.#.
.#.#.#...#...#...#...#...
.#.#.###.#.###.#.#######.
...#...#.#...#.#...#...#.
####.###.#C#.#####.#.a.#.
...#...#.#.#.....#.#.#...
.C.###.#.#######.#.#.##B#
.c.....#.....#...#.#.#...
.#####.a####.s.###.#.#.#.
.#...#...#...#...#...#.#.
.#.#.#####.#####.#.#####.
.#.#.......#.....#.#...#.
.#.#########.#####.#.#A#.
.#.#...#.....#...#...#.#.
.R.#.#.#.#####.#.#####S#.
.#a..#.#.......#.#.....A.
.#####.#########.#.s####.
.................#.......
