abcdefghijklmnopqrstuvwxyz-=[];/
ABCDEFGHIJKLMNOPQRSTUVWXYZ_+{}:?
OOOOOOOOOOOOOOOOCCCCCCCCCCCCCCCC
7
17 17
..........x..#...
.###e#.###.###.#.
@#...#...#..U..#.
##.#.#########RW.
...#...#.........
.#####.#.##t####.
...#...#.#....f..
.#.#.c##.#V#####.
.#.#.#...#.#..!#.
.#e#.#.#.###.###.
.#.#...#.#...#..F
##.#####.#.###.##
...#.....#.#...#.
.#######.#.###.#.
.#r....#.#...#...
.#.###.#####.###.
....c#.......#...
17 17
.....#...........
.#.#.u.###.#.####
.#.#@#...#.#.#..!
.#.###.###.###.##
.#.#...#A..#...#.
##V#.###.#b#.#V#.
...#...#.....#...
.####X.#######.#.
.....#.c.......t.
##.#.#.###.t####.
...#.#.#.d.#...#R
.###.#.#.#####.#.
...#.#...#.....#.
.#.#####D#.###.s.
.#.......#...#.f.
.###V###.#.#.###.
.......#..uU.....
17 17
.....#.........#.
.###v#.###.###.#.
.#.#...#.#.#...#.
.#.#####.#.#.###.
.........#.#...#.
w#########.###.#.
.X.........#...#.
##.#########.#W#.
...#.....#.#.....
.###.###.#.###QW.
s..#.#...#.......
.#.#.#.###v#####.
.#...#...#.....#.
.#R##C##.#.###b#.
...#...#.....#.#.
#B.#.#.#######.#.
.....W@#!......#.
17 17
.........e...#@..
######.#.#.#.#e#.
.......#...#.....
.###############.
...........T...#.
s#############.##
.#.......#...#...
.#.#####.#.#.###.
.#...#.....#...#.
.###.#########.#.
...#.#....q#..S..
##.#.#.C##.#####.
.#.#.Q.#.#...#...
.#.#####G#d#.#.##
.#.....#...#.#.#!
.#####.#.#.#.###.
.........#.#.....
17 17
.....#.......#..@
.###.#d#S#.#.#.##
.#....F..#.#.#...
.#.#x#a#.A.G.###W
.#.#..t#..G#.....
.#q#.#.#c#b#####.
.#.#.#.#.......#.
.###.#.#.#.#####.
.C...#.#.#.x.....
.#####.#.#.#.####
.#.....#.b.#.#...
.#.#####.#.#.#.##
.#...#...#.#.#...
####.#.#.###e###.
.....#.u.........
.#r######Q######.
..............!#.
17 17
....@#...U.......
.C.Q#b.#.##D.###.
.#.#...#...#.#...
.###.#####.#.####
...#.#...#.#b#...
.A.#.###.#.#.#.#.
.#.t...#...#...#.
##.#T#.#.##q.###.
...#.#!#...#...#.
.#.#.#####.####F.
.#...#.#...#D....
.###.#.#.###.###.
.#....A#...#.#...
.U####Q###.#.#.##
...g.....#.W.#.#.
.#######.#.#.#.#r
.......#.f...#...
17 17
.s.......B.x.....
.#.#V#####.#.#v#.
...#.....#...#...
.#####.#.#####.##
.#.....#.#!...a#e
.#q#.###.#######.
.#.#...w.#A......
.#####.#.#r###.B.
.......w.#...#.#.
#b#X####.#.#.###.
.......#.#.#.....
.###.###.#.#b###.
...#...#.#.#...#.
##.###.#.#.#.###.
@#.#q#.#D..B.#E..
.#XBu#.#u###.#.D#
.....#...........
