abcdefghijklmnopqrstuvwxyz-=[];/
ABCDEFGHIJKLMNOPQRSTUVWXYZ_+{}:?
OOOOOOOOOOOOOOOOCCCCCCCCCCCCCCCC
7
17 17
.............#...
.#########.#.###.
.#A........#.....
T#.#######.######
.#.#...v.#.f!....
.#.###.###.#v###.
.#...#.....#.....
.#U#.#######.####
.#W#.........#...
.#.####F######.#.
.#..w......b...#.
.#####.#########.
.......#...#...#.
#####D##.###.#.#.
.......#..C..#...
.###v#.a.###c####
....@#...........
17 17
.......#.........
.#.###.##A.###.##
.#.#.#...#...#...
##.#.###.###.###.
...#..w#.#.....#.
.###.#.#.#######.
...#.#.#..tf...#.
#e.###.###.#.#.#.
.#.#.....#.#.#.#.
.#.#.#####.#.#.#.
.#!#.....#R#.#...
.##D.b##.#.#.tr#.
...#...#...#.#@#.
.#####.#####.#.#.
.e...#.#.....#...
.###.#.#.###S#.B#
...#.....#...F...
17 17
.....#.......#...
##.#.r####.#.###.
...#...V...#...#.
.#############.#.
...#....!#...#...
.#.#.#####.#.###.
C#.#.#.....#.#...
##.#.#######.#.##
...#.....#...#...
.#.#####.#.C.###.
.#...#...#.#f..#.
.#.V##.###.###.#.
.#.#...#...#...#.
.#.#.###.#.#####.
.#.#..Q#.#D#.....
.#####.Q.#.#.####
.......#.#......@
17 17
.....#.#.....#...
.###.#.#.#.###.#.
...#...#.#.#...#.
.#.#####.#.#.###.
.#......e#.#.#...
.q########.#.#.#.
.....#...#...#.#.
.#####.#.#####.#.
.#!#...#.#...#.#.
##.#.###.#.#.#.#.
...#.#.....#.#.#.
.###.######D.#.#.
.s.....#.....b.#.
.###.#.###.###.#.
...#.#...#.#..v#.
##.#####.#.###.w.
.........#.....#@
17 17
.............#B..
.####T##.###.###.
.#.#...#.#.#.#...
.#.D.#.#.#.W.#.#.
...#.#.#.#a....#.
##.#.#.#.#.######
...W.#.#.#...#...
.###.#.#.#####a#s
..@#.#.#.#!..#.#.
##d#.#.#.#v#.#.#.
...#.#.....#.#.#.
.#.#.####f##.#.#.
.#...#.....#...#.
U###.#.###.#####.
.#..T#...#.......
.######w.########
.................
17 17
.........F...#...
.##R####F#.#.#.#.
.......#.#.#...#.
.#u###.#.#.#####.
.#...#.#Q..#...#.
.###u#.#####.#.E.
.....#.......#r#.
####.##SU#####.#.
...F.#@......#.#.
.#.#.#####.###.##
.#.d.....#...#q..
.T######.#.#.###.
.#.....#.#.#...#!
.#.###.#.#.###.##
.#.#.#.#.#.#...#.
.#.#.#.#.#r#.#.#.
.....#.......d...
17 17
...#...#...#..B..
.#.#.#.#.#.#####.
.#...#...#.....#.
.U############.#.
..S#.....#...#...
.#.#.###.#.#V##c.
.#.D!#...#.....#c
.#.###.###.#.###.
.#...#.T...#...#.
.###.#.###.###.#.
...#.#...#.B.#.d.
##.#.###.#.#.####
...#.b...#...E...
s###.B.###r#####.
.#...#...#....@#.
.#.w####.#.#.###.
.#.......#.#.....
