abcdefghijklmnopqrstuvwxyz-=[];/
ABCDEFGHIJKLMNOPQRSTUVWXYZ_+{}:?
OOOOOOOOOOOOOOOOCCCCCCCCCCCCCCCC
7
17 17
...#!..#...b.....
.#.###.#.#.#.#.#T
.#...#.#.#.#.#.#.
.###.#.#.#.#.#.##
.#.#.#.#.#...#...
.#.#.#.#.#######.
...#...#.......#.
##.###R###t#.###.
.#.........#.#...
.#######t#.###.#.
.....#...#...#.#.
.#.#.#.#####.#.#.
.#.#.#.#.....#.#.
##.#.#.#.#####.#.
...#...#.#.....#.
.#######.#.#####.
...Cr.....c#@....
17 17
.............#...
.#####.#.#####.#.
@#...#.#.#!....#.
##.#.#.#########.
..B#.#.........#.
.###.#####.###.#.
.#...#...#.#...#.
.###.#.#.#.#.###.
...#...#...#...#.
t#.#######Q#####.
.#s#.......#.....
.#.#.#####.#.####
.#.#.#.....#.#...
##.#.#.R##.#.###.
...#.#...#.#.....
.###.###.#######.
.......#.........
17 17
a#.....Q!#@#..C..
.#.###.#.#.#.#.#.
...#.#...#...#.r.
.###.#######.#.##
...#.......#.#...
##Q#.#####.###.#.
.#...#...#...#.#.
.#######.#S#.###.
...........#.....
.#.#######.#t###.
.B.#...#.......#.
.###.#.#######b#.
.#...#...........
.#.#####Q########
.#.#...........#t
.#.#######.###.#.
...........A.....
17 17
.....#...........
.###.#.#####.####
...#@#.#A..#.....
c#.###.#.#.#####.
.#.......#.#...#.
##########.#.###.
....b..#.#.#.#...
.#####.#.t.#.#.#.
...#.#.#.#.#.#.#.
##.#.#.#.#T#.#.##
...#...#.....#...
.###.###########.
.#...............
q###############.
.#.....#.#.......
.#.A##.#.#.####c#
.....#!#.........
17 17
...........#.....
.#########.#.#.#.
.#...t.#.#.#.#.#A
r#.#.#.#.#.#.#.#.
.#.#.#...#.#.#.#.
.###.##b##.###.#.
.#!#.......#...#.
.#.##q####.#.###.
.#.......#...#.#.
.#######.#####.#.
.........#...#...
##########a#.#.##
...#.........#.#.
.###.#####.###.#.
.....#...#...#...
.#####.#.###.###.
.....T.#..@#.....
17 17
.....#.....#.....
.#####.###.A.#.##
.....R...#...#...
.########T######.
.....#...........
##.#t#.##########
...#!..#B....sR#.
.########r##.C.#.
.....#@......#r#.
##C#.###.#####.#.
...#.#...#.....#.
.###.#.###.#####.
...#.#.#.#.......
.#.#.#.#.###r###.
.#...#.#...#.....
t#####.#.###.####
.......#.........
17 17
.#.....#....!#@..
.#.#.#.#.#######.
...#.#.#.#.......
.###.#.#.#.###c#.
.#.#.#.#.#.#...#.
.#.#.###.#.#.#.##
...#....a#...#...
c#.#########B###.
.#...#.......#...
.###.#.#####.R.##
...#...#...#.#...
.#.#####.#.#.###.
.#.....#.#...#...
.#####.#.#####.a.
.S.#.#.#.......#.
t#.#.#.#########.
.R...#...........
