abcdefghijklmnopqrstuvwxyz-=[];/
ABCDEFGHIJKLMNOPQRSTUVWXYZ_+{}:?
OOOOOOOOOOOOOOOOCCCCCCCCCCCCCCCC
7
9 9
...#r....
.###.###.
...#.#...
##.#.#.##
...#.#.#@
.###.#.#.
.....#!#.
.#######.
.........
9 9
@..#!#...
##.#.#.#.
..C#...#.
.#######.
...#.....
t#.#.####
.#...#...
.##R##.#.
.......#.
9 9
.......#.
##.###.#.
...#.....
.#######.
a....S...
.###.#.##
.#.#.#.#@
.#.#.#.#.
...#!#...
9 9
!.q....#.
###s##.#.
.....#.#.
.###.#.#.
.#@..#...
.#######.
B#.....#.
.#.#.###.
...#.A...
9 9
.....#!..
.###.###.
.#..r#...
.#####.##
.......#@
.#######.
...#...T.
##.###.#.
.......#.
9 9
.#.......
.#.###.#.
...#!#.#.
.###.#.#.
..B#.#@#.
.###Q###.
.#...#..b
.c.###.#.
.#.....#.
9 9
........c
####S###.
!..#.#...
##.#.#.##
.#.#.#..@
.#.#.####
.C.#.....
.#.#####s
......R..
