abcdefghijklmnopqrstuvwxyz-=[];/
ABCDEFGHIJKLMNOPQRSTUVWXYZ_+{}:?
OOOOOOOOOOOOOOOOCCCCCCCCCCCCCCCC
7
33 33
.........a...............#.......
.#########.#############.###.###.
.#.#...#...#.........#.#.....#...
.#.#.#.#.###.#######.#.#######.##
.#.#.#.#.......#.....#.......#.#.
.#.#.#.#######.#.t####.#A#.###.#.
...#.#.#...#...#...#.#...#.....#.
##.#.#.#.#.#q#####.#.###.#######.
.#.#.#.#.#.#...#...#...#.#.......
.#.#.#.#.#.#.#.#.###.#S#.#######.
...#.#...#...#...#.........#.....
####.#############.#######.#.###.
...#...#...#...#..B#.....#...#...
.#.###.#.#.Q.#.#.###.###.########
.#.....#.#...#.....#.#...........
.b######.t##q#######.###########.
.#...............#...#!#.......#.
.#c#############.#.###.###.##q.#.
.......#.#...#...#...#.#...#...#.
.####r.#.#.#.#.#####.#.#.###.###.
.#...#.#...#.....#.#...#...Q...#.
.#.#.#.#.#######c#.#######C###.#.
...#.#.#...#...#...q.......#S..#.
a#####.#.###.#.#################.
.......#.r...#.........#.........
.#######.#.###########.#.########
.#.......#.#.r...#...#.#...#.....
.#.####c##.#.###.#.#.#.###.###.#.
.#@#.....#...#.#...#.#...#.....#.
.###.###.###r#.#R###.#.#########.
...#.#.#...#.......#.#.#...#...a.
.#.#.#.#.###.#.#####.#.#.#.#.#.#.
.#.....#.....#.......#...#...#...
33 33
.#..........Q#.......#...#.......
.#.#.#######.#.#####.#.#.#######.
.#.#.......#.#.#.#...#.#.#.......
.#.#######.###.#.#.#S#.#.#.#####.
.......#...#...#.......#...#.....
.#######.#.#.#############t#####.
...#.....#.#.#.......#.........#.
##.#.#####.#.#.#####.#.#######.#.
...#.#...#.#.#...#...#.t.......#.
.###.#.###.#.###.t.###.#.#######.
...#.#.....#...#.#.....#.C.....#.
##.#.#.#######.#.#######.#####.#.
...#.#.#.....#...#.......#...#...
.###.#.#.###.#####.#######.#.###.
...#.#...#...#...#.........#...#.
####.#####.#####.#############.#.
...#.#@#....r......#......B#...#.
.#.#.#.#.#########.#####.#.#.###.
.#...#...#t......#...q...#.#.#.#.
.#####.###.#####.###.#######.#.#.
.#...#...#.#...#.#!#.#.......#.#.
.#.###.###.#.#.#.#.###.#######.#.
.#.#...#...#.#...#.....#.#.....#.
.#.#.###.s##.###########.#.###.#.
.B...#.....#.#.........#...#.#...
.#####.#####.#.#######.#.###.####
.#...#...#...#.#...#.#...#.....#.
.#.#.#.###.#.#.#.#.#.#######.#.#.
...#...#...#.#...#.#...#.....#...
.#######.###.#####.#.#.###.#####.
.....#.#.#.......#...#...#.#.....
####.#S#.###############.#.#.####
.....a.#...................#.....
33 33
.....#.......#.......#...........
##.###.##r.#T#######.#.###.#####R
...#...#.#.#.........#...#.#...#.
.###.###.#.##T####.####R.#.#.#.#.
.#...#...#.#.......#.....#...#.#.
.#.###.###.#########R#####.###.#.
.#.#.#...#...........#A..#.#...#.
.#.#.#.#.#############.#.###.###.
...#.#.#.........#.#...#.#...#...
.###.#.###.###Q#.#.#.###.#.###.##
...#.....#...#.....#.#...#.#Q#...
##.##q##.###.#####.#.#.###.#.###.
R#.....#...#.....#.#.#.....#.....
.#####.#.#######.#.#.############
...#...#.#.......#.#.............
##.#.#####.#######.##########R##.
...#...#...#.....#.....#.....#...
.#####.#.###.###.#####.#.###.b.##
...A.#.#...#.#...#..@#.#.#...#...
##.#.A.###.#.###.#.###.#.#.#####.
...#.#.....#...#.#.....#.#.....#.
.###.#####.###.#.#######.#####.#.
.#...#.#.....#.#.......#.#...#.#.
.###R#.#.#####.#######.#.#.#.#.#.
..Q#...#.#...#...#.#...#...#.#...
##.#.##B.#.#.###.#.#.#######.###.
...#.#...#.#...#.#b....#.....#.#.
.#.###.###.###.#.####s.#.#q###.#.
.#.#.....#.#...#...#...#.#...#.#.
.#.#.#####.q.#####.#.###.#.#.#.#.
.#.#r..#!..#.#.....#...#...#.#...
.#####.#####.#.#######.###b#.#.##
........s..#...#.............#...
33 33
...#.......#...#.................
.#.#.#.B##.#.#.#.###t#####.#####.
.#...#...#.#.#.#.#.#.....#.T...#.
.#######.#.#.#.#.#.#.###.#######.
.#.....#.#.#.R...#.#...c...#...#.
.#.###.#.###.#####.###.###.#.#.#.
.#...#.#.....#.....b...#.....#...
.#####.#######.###.#.###.########
.......#...#cR.#...#...#.#.....#.
######.#.t##.#.t##b###.###.###.#.
.#...#.#.....#.......#.....#...#.
.#.#.#.#.###########.#######.###.
...#.#.#.....#...#.......#...#...
.##S.#.#####.#.###.#####.#.#####.
.#s..#.#...#.#...#.#...#.#.#.....
.#.###.#.#q#.#.#.#.#.#.#.#.###.#.
.#...#.#...#.#.#.#.#.#.#.#...#.#.
.###.#.###.#.###.#.t.#.#.###.#.#.
...#...#...#...#.#.#@#.#.#.#.T.#.
##.#####.#####.#B#.###.#.#.#.#.##
.#...#.....#...#.#...#...#.#!#...
.###.#####.#.S##.###.#.###.###.#.
...#.....#...#.....#.#.....#...T.
.#######.c.###.###.#.#######.###.
.#.....#.#.....#...#...........#.
.#.###.#.###########.######a####.
.A...#.#.......#...#.........A...
.###.#.#######.#S#.#Q#########.#.
.....#.....#.#.#.#...#.........#.
.#T###.###.#.#.#.###.#.##########
.#...#...#...#.#.#.#.#...........
.#.#.###.#####.#.#.#.########B##.
...#...#.........#...............
33 33
...a...b.........#...........C...
.#.##q####.#######.##b##.###.#.##
.#.......#.#.......#.....C.#.#...
.#######.###.#####.a.#####.#.#.#.
.#...#.#...#.#...#.#...#.#...#.#.
.#.#.#.###.#.r.#.#####.#.#.#####.
...#.#..q#...#.#.......#...#.....
####.#.#######.###Q#c##C.###.#.##
.b.#.B.#...#...#...#...#...#.#...
.###.#.#.#.#.###.#.###.a##.#.###.
...#...#.#...#...#...#.#...#...#.
.#.###.#.#.###.#####.#.s.#######.
.#.....#.#.#...#.....#T..........
.c#####A.#.#.###.#####.######T###
...#.....#.#...#...#.....#.......
#c.#.###.q#R##.###.#C#S###.#####.
.#.#.#...#...#..!#.#.#.....#...#.
C#.#.###T#.#.#####.##t.######A.#.
.#.#.......#.....#.....#.......#.
.#.A############.#######.#####.#.
.#.#.....#.........#c........#.#.
.#.#.###.#.#########.#######.#.#.
...#.#...#...#.......#.......#.#.
.a##.###.###.#.#######.###.#####.
.#.....#...#...#...#.#.#...#.....
.#####.#########.#.#.#.#####.####
.#...#...........#...#.#.....#S..
.#.#.Q.A####.#.#######.#.#######.
.#.#.#.....#.#.#.....#.#.#....b#.
.#.#.#####.#.###.#B#.#.#.#.###.#.
.#.#.....#@#...#.#.....#.#.#.#...
.#.#####.#####.#.#######.#.#.###.
...#...........#...........#.....
33 33
.r.#...#.........#.......#.......
.#.#.#.#.#######.#.#####.#.###.##
.#.#.#...#.......#.#.R...#.#.#...
.#.#.#####.#######.#.#####.#.###.
.#t#.#...#.....#...#.......#.#...
.###.#.#.###.#.A.###########.#.##
.R...#.t...#.#.#.#.....#.T...#...
.#.###.###.###.#.#.###.#.###.##r.
.#.#.#...#...#.#...#...#...#...#.
.#.#.###.###.#.#####.#######.#Q#.
...#..B#.#.#...#...A.A...#...#.#.
.###.###.#.#####t#.#####.#.#.###.
.#...#b..#qQ.....#.....#...#.#...
.###.#.#######.##Q.#######.###.#.
.....#.......#.#...#.......#...#.
A###.#####.#.###.###.#######.###.
...#.a.#!#.#...#.....#.#...#.#.#.
.###.#.#.#####.#.#####.#.#.#.#.#.
..qT...#...#...#...#...#.#...#.#.
##.###.###.#.#####.#.#.#.#####.#.
..q#...#...#.#T#...#.#.#...#.....
.##Q.#T#.###.#.#.###.#.#T#.######
.....#.#.q...#.......#...#.......
.#####.########B########.#######.
.....#.....#...........#.#c.s..#.
####.#.#####.#.####s##.#.#####.#.
...#.#...sr#.#.....#...#.......#.
##.#.###.#.#.#####.#.###########.
...#...#.#...#c..#.#.#...........
.#.###.#######.#.#.#.###.#######.
.#..@#.#.....#.#.#.b.....#.....#.
.#####.#.###.#.#.c.#######.#.###.
.........#.....#...#.......#.....
33 33
.#.............#.......#.#.......
.#.#######.#.###.###.#.#.#.##B##.
....C#...#.#.....#...#...#.#.....
.#####.#.#####.###.#######.a.###.
...#...#.#...#...#.........#T..#.
##.#.###.#.#.###############.#.##
...#.#...#.#...........#...#.#...
.###.###.#.#####.#####.#.#.#####.
.#@#...#..Q#.....#...#...#.......
.#.###.###########.#.######s####.
.#...#.......#...#.#...#.......#.
.###.#######.#.#.#.###.#.#.#####.
...#.#.....#...#...#...#.#...#...
##.#.#.###.#.#######.#####Q#.#.##
.....#.#!#.#.....#...#...#...#.#.
.#####.#.#.###.###.###.#.#.###.#.
.#...#.#...#...#...#...#...#...#.
.#.#.#.#####.###.###.#####a#.###.
.#.#...#.#.....#...A...#...#...#.
##.#####.#.#######.#s#.#.#.###.#.
...#.#.....#.#.....#...#.#.......
.###.#r#A###.#.#####.###.C######.
...#.....#...#...#.......#.....#.
##.#####.###.###.#.#####.#.###.##
.#...#.#...#.#...S.#...#.#...#...
.###.#.###.#.#.#B###.#.#####.###.
.#...#.......#.#.#...#.....#.#...
.#.###.######c.###.#######.#.#.##
...#.....#...#.#.......#...#.#...
.#########.#.#.#.#######.###.###.
.#.....#...#.#...#.....#......b#.
.#.###.#.###.#####.###.#########.
...#....a#.........#.............
