abcdefghijklmnopqrstuvwxyz-=[];/
ABCDEFGHIJKLMNOPQRSTUVWXYZ_+{}:?
OOOOOOOOOOOOOOOOCCCCCCCCCCCCCCCC
7
21 21
...#...............#.
.##q.#######.#####.#.
...#...#...q...#.#.#.
.#.###.#.#.###.#.#.#.
.#.#.....#..@#.#...#.
.#.#.#####c###.#.###.
.#...#.........#.#...
####q#.#########.###.
...#.#.........#.....
.#.#####.#####.#####.
.#.#...#.#...#.#.#...
.#.#.#.###.#.#.#.#.##
.#.#.#...#.S...#.#...
.#.#.###.#.#####.#Q#.
.#...#.....#...#...#.
.#####.#####.#.b##.#.
.#.#.....#...#...#...
.#.#.###A#.#####.####
.#.....#...#.....#..!
.#######.###.#b###.##
...........#.........
21 21
.....#.......#.....#.
.###.#.#.###.###.#.#.
...#...#.#.#.....a...
##.#####.b.#########.
.S.#...#.#.#.......#.
.###.###.b.T.#.###.#.
.....#...#.#.#.#...#.
#T##.#.###.#.#.#####.
.....#...#...#.#.....
.#######.#####.#.####
.......#.a.#...#.#...
######.S##.#.###.#.##
.......#...#.b...#...
B#######.###.#.#####.
.#.....#...#.........
.B##.#####.##########
...#.....#...#.......
##.#.#.#####.Rq#####.
@#.#.#.#.....#.#.#...
.#.###.#.#####.#.#.##
.......#.........#..!
21 21
..b..............#...
.###############.#.#.
.#.#!..#.......#.#.#c
.#.#t#.#.#####.#.#.#.
.#...#...#.....#.#.#.
.#.#.#####.#####.#.##
.#.#...#.#.#...#.#...
.###.#.#.#.#.#.r.#.#.
.....#.#.#...#...#.#.
######.#.###########.
.#.....#.....#.....#.
.#.#C###.###.#.###.#.
.#.....t.#.#.#.#.#...
.#####.#.#.#.#.#.###.
...#...#.#...#.#.....
.#.#.###.#.###.#.##b#
.#.#.#...#.....#.#...
.###.#.#########.#.#.
...#.#.#..@c...#...#.
.#.#.#.#.###.#.#####.
.#.....#.....#.C.....
21 21
.......#...#!#.......
.#.###.###.#.#######A
.#...#...#.#.........
##C#.###.#.#########.
.....#...#.......#...
.#####.#######.#.#.Q#
...#.....#.....C.#.#.
.#.#####.#.#####.#.#.
.#...#.....#a....#...
.###.###############.
.#.#...............#.
.#.###############.#.
.....#..A......#@#.#.
####.#####.###.#.#.#.
c....b.....#...#.#.#.
.T####.#####.###.#.#.
.#.....#.....#...#.#.
.###.#.###.###.##b.#.
...#.#...#...#...#.#.
##.#####.###.###.#.#.
.........#.......#...
21 21
...........t...#..b..
.#####t#.#.#.#.#####.
.....#...#.#.#.#...#.
#S##.#.C##.#.#.#.#.#.
..a..#.#...#.#Q..#...
######.#.###.#######.
.....#.#.#...#.#A..#.
.###.#.#.#.###.#.#.#.
.#.....#.#...#...#.#.
.#####c#####.#####.#.
.........#!..#.....#.
.#######.#####.####r.
T#@....#.......#.....
.###.#.###.##C.#.####
.#...#.#...T.#.#.#...
.#.##q##.###.#.#.###.
.#.....#.#.....#.....
.#####.#.#####.#####.
...#...#.#...#.....#.
##.#.#.#.#.#.#######.
.....#.#...#.........
21 21
...#.........#.....#.
.#.C.#C#####.#.###.#.
.#.#...#...#...#...#.
.#####.#.#######.###.
.....#.#.......#.#...
.#.###.##R.#.###.#.#.
.#.#.......#.#...#.#.
##.C.#########.###.#.
...#.#@#!....#.#...#.
.#.S.#.#####.C.#####.
.#.#.#.....q...#...#.
.#.#.###.#.#####.#.#.
.#.#...#.#...#...#...
.#.###.s##.#.###.###.
.#.#.#....r#...#.#...
.#.#.#########.#.#t##
.#.Q...#.....#...#...
.#.###.#.###.#######.
.#.....#.#....T#...#.
.#######.#.#####.#.#.
.........#.......#...
21 21
.#...............#...
.#.#####.#######.###.
..R....#.#...#...#...
########.#.#.#.###.#.
.........#.#.#.....#.
.#########.#.#######.
s........#.#.......#.
.#######.#.#######.##
.#.....#...#.....#...
.#####.#####.###.###.
.............#...#...
b#############.###.#.
.................#.#.
.#################.#.
@#.......#.........#.
##.#####.#.#########.
...#...#...#.......#.
.q##.#######.#####.#.
!#...#.....#.#.R...#.
##.###.#.###.#.#.#t#.
..C....S...C...t.....
