abcdefghijklmnopqrstuvwxyz-=[];/
ABCDEFGHIJKLMNOPQRSTUVWXYZ_+{}:?
OOOOOOOOOOOOOOOOCCCCCCCCCCCCCCCC
7
17 17
.....#..........A
.#b#.##A.######R.
.#.......#.......
.#########.######
.....#.#...#....!
.###.#.#.###.####
.#...#.....#.#...
##.#######S#.#.#.
...#.........#@#.
.###a#####B#####.
.....#........R..
.#s#####.##A####.
.......#.#.s.#...
######.#.#.#.###.
...#...#...#...#.
.#.#.#########.#.
.#..........Q..#.
17 17
...S.#!#.....#...
.#####.#.###.###.
...#...#.#...#...
##.#.###.#.###.#.
...#...#.#.....#.
.####a.#.#######.
.....#...#.....#.
####.#####.###.#.
.........#...#.#.
.#S#####.###.#.#.
.#...b.....#.#.#.
.#.#.#.#####.#.#.
...#.#..@#...#...
.###.##Q##.####R#
...#.#.....#..Q#.
##.#.#.#####.#.#.
...q.........#...
17 17
............@#...
.###.#########.#.
.#.#...#.......#.
.#.###.#.######q.
.#...#...#.....#.
.#.#.#####.#####.
...#.....#...#...
########.###.#.##
.#...........#...
.B.##a#r########.
...#.....#.....#.
.###.#####.###.#r
.....#.....#...#.
#B##.#.#.#####.#.
...#.#.#.#...#...
.#.#.#.###.#.###.
.#...#.....#!#...
17 17
.........Q.......
.#########.#####.
...#....!#...B...
.###.#####.#.####
.#...#.#...#.....
##.###.#.#######.
.q.#...#.#...#@#.
.###.###.#.#.#.#.
...#.......#...#.
##.#####.#######.
.#.#...#.#.......
.#.A.#.###.#####.
...#.#...#.....#.
.###.###.#####.#.
...#...#.#A..#.#.
##.###.#.#.#.#.#.
.......#...#...#.
17 17
.....#.....#.#...
.#.###.#.#.#.#.#.
.#...A.#.#.#...#.
########.#.#####.
.........#...#...
.#######Q##Q.#.#.
.#.....#...#...#.
.#.###.###.#####.
...#.#...#.....#.
.###.###.#.###.#.
.....#...#...#...
######.#####.####
.......A.....B...
.#########.###.#.
.#!......#.#@..#.
.#######.#.q####.
.........#.......
17 17
.......#...#.....
.#####.#.#.#.###.
.#@....#.#...#.#.
.###.###.#####.#.
...#.#...#.....#.
##.###.#######.#.
...#...#.......#.
.###.###.#.#####.
.#!..#...#.#.....
.###b#.#####.####
.......#.....#...
B###.###.#####.#.
...#...#.....#.#.
##.###.#####.#.#.
.#...#.....#.#.#.
.###.#.#####.###.
.....#........b..
17 17
.................
.###############.
.....#.......#!#.
s###.s.###.###.#.
.....#.#.#.#...#.
.#####.#.#.#.###.
.#.....#...#.q...
.#.#########.#.##
.#...#.....#...#.
.#.#.#.###.#####b
.#Q#.....#.......
.###########.####
...........#.....
##########.###.#.
........@#...#.#.
.###.#######.###.
...#.............
