abcdefghijklmnopqrstuvwxyz-=[];/
ABCDEFGHIJKLMNOPQRSTUVWXYZ_+{}:?
OOOOOOOOOOOOOOOOCCCCCCCCCCCCCCCC
7
35 35
...c.......#.....#.....#.....#.....
.#.#######.#.#.###.#.###.#.#.#####.
.#.#.......#.#.....#.....#.#.....q.
.#.#.#####.#.###########S#.#######.
.#.#.#.....#.#...#@......#.....#...
.#.#.a.#####.#.#.###.#.#####.#.s##.
b#...#.#.#...#.b.....#.#...#.#...#.
.#####.#.#.###.t####.#A#.#.A####.##
.#.......#...#.#...#.#...#.....#...
.###########.#.#.#.T.#.R######.a##.
.............#.#.#.#.#.#.#.....#...
.#############.#.#.###.#.#.#####.##
.#.........#...#.#.....#.......#.#.
.C##R#.#q#.A.###.#####.#######.#.#b
.#...#.#.#...#...#...#.#.....#...#.
.#.#.#.r.#.###.###.#.###.###.#####.
...#...#...#...#...#...#.#...#.....
####.#######.#.#.#T###.#.#.#######.
...#.#.......#.#.#.#...#.#.#.......
.###T#.#.#######.#.#.#.#.#.#.#.###.
.#...#.#.#.........#.#.#.#.#.#...#.
.#.###.###.#########.C.c.#.###.#.##
.#...#...#...#...#...#.#.#...#.#...
.###.###.###.#.###.##a.#.###.#####.
.....#.#...#...#...#...#.#.#.#...#.
.a####.b##.#.###.###.###.#.#.#.#.#.
.....#...#...#...#.....#.#.#...#.#.
####.##s.#####.#.####B##.#.#####.#.
.....#...#...#.#.#.......#...#!..#.
.#####.#.#.bs#.###.#######.#.#####.
.#.....s...#.#.....#.....#.#.......
.#.####b####.#######.###.#.#######.
A..#....A..#.#.....#...B.........#.
####.###B###.###.#.#############c#.
...........r.....#.................
35 35
.....#c..............#.....#.......
.###.q.######C####.#s#.###.#.###.##
.#...#.#..T#....@#.....#...#...#...
.#####.###.#.#.#########.#####.###.
.#...#...#...#...r.....#.......#.#.
.#.#.###.#.#####.###############.#.
...#.#...#.....#...............#s#.
####.#.###########.q##.#######.#.#.
.....#...........#...#.#.....#...#.
.###############.#C###.#.###.#.###.
.....#.........#.....#.....#.#.#...
#a##.#.#C#####.####s.#######.###.#.
.....#.....#.#.........#.....#...#.
.#########.#.#########.#.#####.###.
.#.......#...R...#...#...#.....#...
.#.###.#####.#####.#.#####.#.######
...#.#.......#.A.#.#.......#.#.....
.###r#########.#.#.#########.#.###.
.#.....#...#...#...#......Q#.#.#...
.#.###.#.#.#.###B###.#####.#.#.#.##
.#.#...#.#.#.#.....#.....#...#.#...
.###.T.#.#.#.#.###.#####.r####.###.
.....#.#.#...#...#.....#.#.#...#...
#t##.###.#######.t####.#.#.#.###.#.
...#.#...#.......#.....#...#.#.#.#.
.###.#.###.#######.#####.##B.#.#.##
.....#.....#.......#....b#...#.#...
.###########.#######.#####.###.###.
.....#...T...#.....#.#.....#...#...
####.#.###.#####.##b.#.#####.###.##
.......#...b...#.....#.#.....#!..#.
.#######.#.#.#.#.#####.#####.#####.
q..#.#...#.#.#.#.....#.#.......#...
##.#.#.#####.#.#######.#.#####.###.
.....#.......R...........#.........
35 35
.........#.....#.......#.........#.
.#####.###.###.#.#####.#.###.###.#.
.....#.#...#.#...#...#.b.#.#...#...
.###.#.a.###.#####.###.#.#.###.###.
.#...#.#.....#.....#...#.....#.C...
.#.#########.#####.#.#######.#.####
.#...#.....#.......#.......#.#.....
.###.#.c.#S#######.###.###.#.#####.
...#...#.....#.r.#...#.#.#.#.b...#.
##.#######.#.#.q####.#.#.#.#.###.#.
...#.......#...#.....#.#...#...#.#.
####.#########.#.#####.#.#####.#.#.
.....#.....#...#.#.....#.#.......#.
.#####.#####.###.#.#T###.#.#######.
...#.#...#...#...#.#...#.#...#.....
.#.#.#.#.#.###.###.#.#.#.###.#.####
.#.#...#...#...#.#.#.#...#...#.....
.#.#####.###.###.#.###.###.#####r#.
.#.....#.#...#...#...#.#...#.....#!
.#####.#.#.#####.###.###.#####.#.##
.#...#.q.#.....#...#.....#...C.#...
##.#.#.#.#####.#.#.#########.#####t
.R.#q..#.#.....#.#.........#.......
.#####.##A.#######.######s.#######.
...#.#.#...#.......b...#.........#.
.#.#.#.#.###.#.###.#.#.#########.#.
.#c#...#.#...#...#.#.#.....#...#...
.#C#.###.###.###.#.#.#####.#.#.###.
.#.#r..#...#...#.#.#.#...#.#.#.#...
.#.######B.#####.###.###.#.#.#.#.##
.#...#.....#...#.......s.#...#.#.#.
.###.#.#####.#.###.###b#.####t.#.#.
.b.#.#...#...#...#.#...#...#...#...
##.#.###.###.###.###.#.#####.#####.
...#.........#.R.....#.......#@....
35 35
.....S.........#.....#.......R.....
.#.C.#.######b.#.###.#.#####.#.###.
.#.C.#.....q.#.#@#...#.#.#...#.#.#.
##.#.#####.#.#.##c.Q##.#.#.###.#.#.
...#.......#.......#...#.#.#...#...
.#######.c####.#####.###s#.#.######
.#.....#.#...#.#.....#.#...R..A....
.#.###.###.#.#.#.#####.#.#########.
...#...Q!..#.#.#...#...#.#.....#...
###S.#.#####.###A#.#.#.#.###.#.#.#.
.....#.....#.......#.#.#.#...#...#.
.#########.#########.#.#.#.########
.........#...#.....#.#...#.........
.t######.##c##.#.###.#####.#######.
...#...#.....#.#.....#.......#.t.#.
##.#.#.#####.#.#############.###.#.
...#.#.....#.#.............#.#...#Q
.###.#####.#.#############.#b#.###.
.#.#...s...............#.#.#...#...
.#.###.#############T#.C.#.#####.#.
.#...#.......#.......#...#.#...#.#.
.#.#########.#.#####.#####.#.A.#.#.
.s.......A.#.....#...#...#.#.#...#.
.#.#####.#########.###.#.#.#.#####.
.#.....#.....#.#...#...#...#.....#.
.s########.#.#.#.###.###########.#.
.......#.B.#T..#...#.#...........#.
######.#.#####.###.#.###.###.#####.
.....#.#.#.....#.#.#...#..r#.#...#.
.#.###.#.#####.t.#.###.#####.#.#.#.
.#.#...#.....#.#.#...#....s..#.#...
.#.#.#######.#.#.###.#########.####
.#.#.#.....#.#...#.#.......#...#...
.#.#.###.#.#.###.#.###.#####.#####.
.#.......#...#aq.....#.............
35 35
.....#.....................#.......
.T##.#.#c##c####.#R#######.#####.##
.#.#.....#.......#.#.....#.....#...
.#.##R##.#.#######.#.###.#####.#.#.
.#.#...#.#.c...#...#.#.#...#...#.#.
.#.#.#.###.#.#.#.#.#.#t#.###.B#t.#.
...q.#.....#.#.#.#....A#...#...Q.#.
##.#.##T.#####.#.######A##.###.###.
.#.#.#...#...#.#.#...#...#...#.....
.#.#.###.#.#.#.#.#.#.#.#.###.#####.
.#.#...#.#.#.#.#...#.#.B.#...#.T...
.a.###.C##.#.#.###.###.#.#.###.####
.#.#.#.....#.#.....#...#.#...#.....
.#.#.#######.####c.#.###.#q#.#.####
.#.#.......#.....#.#.#.....#.#.#.a.
.#.#######.#####.#.a.#####.#.#.#.#.
.#.......#.....#.#.#.#...#.#.#.#.#.
.#######.#####.#.#.#.#.#.#.#.#.#.#.
.......#.#.....#.#.#...#.#.#...#.#.
####.###.#.#####.#.##A##.#.#.###.#.
.....#.....#.....#.....#.#.#.#...#.
.###.#.#####.#R#####.###.#.###.###.
.#...#...#...q.......#...#...#.#...
.#S#.###.#.###.#######.#####.#.#.##
...#...#.#...T..@#...#.#...#...#.#.
.#.###.#.###.#####.#.#.###.#####.#.
.#...#.#.#.#.....#.#.#.#!#..Q..#...
.###.###.#.#####.#.#.#.#.#.#.#.###.
...#...#.......#...#.#...#.#.#.#...
##.###.#c#####.#####.#####.#.###.##
.....#...#.....#R..#...#...#.#...#.
.#####.#.#.#######.#.###.##T.#.s##.
...#...#.#.........#.#...#.#...#...
##.#.#############.#.#.###.#######.
...#...............#...............
35 35
.#.......#.......#.................
.#.Q.##a.###.#.#.##t##.#######.T#q#
...#.#.....#.#.#.#....c#...#...#...
.###.#####.###.#.#.#.##T##.#.###.#.
.#...#...#.....#.#.#.#...#.c.#...#.
.#.###.#.#######.#.#.#.#.#####.###.
.#.....#...#..s#...B.q.#...q...#...
.#########.#.#######.#.#########.##
.........#.#.......#.#.#.......#!#.
####.#C###.#.#####.#.#.#######.###.
.....#R....#..@#...#.#.......#q....
.#####.######b##.###.#######.#####.
...#.#.....#...#.....#..b..#...#...
##.#.###Q#.#.#.#.#####.###.###.#.c#
.#.#...#.#...#.#...#...#...#...#...
.#.#.#c#.#####.#####.###.##c.#####.
.#.#.#...#...#...#.....#.#...#...#.
.#.#.###C#.#####.#.#####.#.###.#.#.
.#...#...#.....#.#.#.#...#.....#.#.
.#####.#######.#.#.#.#.#########.#R
...#...#.......#...#.#.........#.#.
.###.###.###########.###.#######.R.
.#...#...#.............#.#.....r...
.#.#####.#.#######.###.#.#.###.###.
...#.....#.#.....#.#...#.....#...#.
.###.#.###.#.#.###.#.###########.#.
.#...#.......#.#...#...#.#...#...#.
.rC#.#####s#####A#####.#.#.#.#.#.#.
...#.#...#.#.....#...#...#.#.#.#.Q.
##.###.#.###.q####.###.###.#.#.#.#.
.#.....#...#...#.#.....#...#...#.#.
.#########.###.#.#.#####.r###t.###.
.#.......#.#...#.#.#...#.#...#.#..r
.#.#####.#.#.###.#.###.#.#.#.###.##
S......#.....#.........#...#.......
35 35
.........#a....#.....#..c........#.
.#.#######.##T.#.#.#.#.#.#######.#.
.#.#.........#...#.q...#.#...#.....
##.#.###########.#.#####.A.#.#####.
Q..#.#...#.#...#.#.#...r.#.#...#...
.###.#.#.#.#.#.###.#.###.#.###.#.##
...#.#.#...#.#.#...#.....#.#r#.#...
##.#.#.#.###.#.#.#####.###.#.#.###.
...#.#.#.#...#.#.....#...#...#...#.
.###.#.###.###.#.###a#.###.#####.#.
...#...#...#...#.#...#.#...#.....#.
##.###.#.###.###.#.#####.###.#####.
...#...#.#.....#.#.....r.t.#.....#.
.###.###.T####.#.#####.q##.#####.##
.......#...#.#.r.#...#.#...#...#...
.#######.#.#.#.#.#.#.#.#.###.#####.
.#....!#.#.#...C.#.#...#...#...#...
.#.###a###.#.#####.###.###.###.#.##
.#.....#..S#.....#...#...#.....#...
######.#.#######.###.###.#####.###.
.....#.#.....#...B.#.#.....#.....#.
.###.Q.#.S##.#####.#.#.###Q#.#####.
...#...#.#.#.....#...#.#...#...#...
##.#####.#.#####.###.#a#.#.###.#.#.
...#...#...#...#...#.#...#.....#.#.
.t##.#####.#.#####.###.#########.##
.#...#.......#...#...#.#.....#.#...
.Q##.#.##r####.#.#.#.#.#.###.#.###.
...#...#.......#.#.#.....#.....#...
##.#####.#######.#.#############.#.
.#...#...#.....#.#.#.........#...#.
.###.#.###.##a.#.#.#.#######.#.##A.
.....#.#@#.#...b.#.#.#.......#.#.#.
.#####.#.#.#.###.###.#.#######.#.#.
.......q...#.........#.........#...
