abcdefghijklmnopqrstuvwxyz-=[];/
ABCDEFGHIJKLMNOPQRSTUVWXYZ_+{}:?
OOOOOOOOOOOOOOOOCCCCCCCCCCCCCCCC
7
17 17
...B...#.........
.###.#.#.#.######
...#.#...#.......
S#.#s#######.###.
...#.#@#...#.#...
.#.#.#.#A#.###.##
.#.#.C.#.#...#...
.###.#.#.###.#.#.
S......#.#.#.#.#.
.#####.#.#.#.###R
.#...#.#.#.#.#...
.#.#.###.#.#.#.##
.#!#.....#...#...
.#########.#####.
...t.#...q.Q...#.
####.#.#.##C##.#.
.......#.....#...
17 17
.........#.......
.#######.#.###.#.
...#...#...#.#.#.
##.#.#.###.#.#.##
...#.#...#...#b..
.###.###.###.###.
.#...#!#.#.#.#...
.#.##T.#.#.#.#.##
.#.#.#.#.#...#...
.#.#.#.#.#.#####.
.#...#...#.#...#.
.###.#####.###.#.
...#...#.......#.
##.###.#.#######.
...#@#.#...#.....
.###.#.#####.###.
.....#.......#...
17 17
...#...#.....#...
.#.#.#.#.#####.#.
.#S..#...#.....#.
.###.#####.#####.
...#.#...#...#...
.#.###.#.###.###.
.#.#...#..!#.r.#B
.#.#.#########.#.
.#.#.......#...#.
##.###T###.#.###.
...#.....#...#...
.a.#.#########.##
.#.B.#.......#.#.
.#####.#####.#.#.
.#...#.#@#...#.#.
.#.#.#.#.#.###.#.
...#.....#.......
17 17
.................
##.#############.
...#.....B.....#.
.#####.#.#.#.###.
.#.....#.#@#...#.
.#.#.###.#####.#.
.#.#...#.#...#.#.
.#####.#.#.#.#.#.
.#q..#.#...A...#.
.#.#.#.###T#####.
...#.#.#.........
.#R#.#.#.#####.##
.#.#.#...#...#.#.
.#.#.#####.#a#.#.
...#.......#.#.#.
##.#########.#.#.
.....#!......#...
17 17
...........#.....
.###.###c###.#A#.
.#...#...#...#...
##.###.#.#.###.##
...#...#.#.#.#!#.
.###.###.#.RC###.
.#...#.#.A.#.....
.#.###.#.#.#.###.
...#...#...#...#.
.###.#.#######.#.
.....#...#@....#.
########.#######.
.......#.......#.
##.###.#a#####.#.
...#.......t...a.
.##########A.###.
.A...............
17 17
...#....@#...#...
.#.#.##C##.#.#.#.
.#...#.....#...#.
.####S.#########.
...#!..#.....#...
.#.#####.###.#.##
.#.....#.#.#...#.
r#####.#.#.#####.
.#...#.#.#.......
##.#.#.#.#.#####.
...#...#...#.....
.#.##ca####S.#t##
.#.#.......#.#...
.#.#.##C.#.#.###.
.#.#...#.#.#.#...
.#####.#.###.#.#.
.......#.......#.
17 17
...#.............
.#.##Q##########.
.#.....#.....#b..
.#####.#.###.#.#C
.#...#.#.#.....#.
.#.###.#.#####S##
.#...#.#...T.....
.###.r.#.#####t#.
.#...#!#.#.....#.
.#.#.Q##C#.#####.
...#.#...t.#...#.
####.#.#####.#.#.
...#.#.#c..#.#.#.
.c##.#.#.#.#.#.#.
.#...#@#.#...#...
.#.###q#.#######.
.........#.......
