abcdefghijklmnopqrstuvwxyz-=[];/
ABCDEFGHIJKLMNOPQRSTUVWXYZ_+{}:?
OOOOOOOOOOOOOOOOCCCCCCCCCCCCCCCC
7
17 17
...............#.
.T#q####.#.###.#.
.#...#...#.#!#..C
.###.#.#####.###.
...#.#.#...#...#.
##.#.#.#.#.###.q#
...#.#...#...#...
.#c#.S#####s.###.
.#...#..T..#...#.
.#.#.###.s.###.#.
...#.....#.#...b.
##########.#.#.#.
.....#.....#.#.#.
.#####.#####.###.
.....#.....#...#.
.###.#####.###.t.
..@#.........#...
17 17
...........#..q..
.###.#####.##uR#.
.#...#...........
C#.##############
.#...#.....#.....
.###.#.###.#.###.
.#@#.....#.....#.
.#.#q###s#####.#.
...#!........#.#.
##.##B######.#.#.
...#.......#.#.#.
.#########.#.#.#.
.#.....#...#.#.#.
.#.###.#.###.#.#.
.#.#...#.#...T.#.
.#.#.###.#.#####.
...#.....#.......
17 17
...a.#...........
.###.#####.###.#.
.#.#.#...#.#@#.#.
.#.#.#.#.#.#.#.#.
!#.#...#.#D#.#.#.
##.##Q##.#.#.#.##
.........#...#..U
.TT#############.
...#.....#...#...
##.#.###.#.#.#.#.
.#.#.#.#.#.#...#.
.#.#.#.#.#.######
.#...#...#...#..S
.#####.###.#.#.#.
.#...#.#...#...#.
.#.#.#.#########.
...A.............
17 17
.t.#......B......
.###c#######b####
.....#@#..!#.....
.#####.#.###.###.
...#...#...#...#.
##.###.###.#.###.
.#.......#.#.#...
c#######.#Qq##.##
B......#.#..r..#.
.#####.#.#######.
.#...#..T#.....#.
.#.#.#####.#.#.#.
.#.#...#.#.#.#U#Q
.##A.#.#.#.#.#.#.
.#r..#.#...#.#B..
.#.###.#U###.###.
...#.........#...
17 17
...#...#.c.......
.#.#.#.#.#.c####.
.#...#...#.#.#...
.###.#####.#.#.#.
...#.#...#..R#.#.
.#.###.#.###.#.#.
.#.#...#.....#.#.
##.U.#########.#.
...#.#.....r...#.
.#.#.#.###.#.###.
.#.#...#...#.#...
.#S##T##.###.###U
.....#...#@#q....
.###.#.###.#####.
.#...#.#...#.....
.#.#T#.#.###.###c
.#.......#!..#...
17 17
.....#.........#.
##.#.###.#####.#.
!..#.....c..C#.#.
####s#####.#Q#.#.
.....#.....#...#.
##.#.#.###.#.###.
...#.#...#.#...#.
.###.#####.###s#.
.#.d.........#...
.###########.###.
.....#...#.....#.
.###.#.#.#.#####t
.#.#...a.#@#...#.
.#.#####.###A#.#.
...#...#...Q.S.#.
##.###.###.#.#.#.
.........#...#...
17 17
..!#.............
.###############.
...............#u
##############.#.
.......B..@#...#.
.#####.#.###.###.
.....#.#...#...#.
####.#.###.###.#.
.....#.......#.#.
.###########.#.#.
...........#.#.#.
.#########.#.#.#.
.#...#.....#.#.#.
.#.#.#.#######.b.
.#.#.#.T.......#.
.#.Q.#.#.#######.
...#.#...........
