abcdefghijklmnopqrstuvwxyz-=[];/
ABCDEFGHIJKLMNOPQRSTUVWXYZ_+{}:?
OOOOOOOOOOOOOOOOCCCCCCCCCCCCCCCC
13
17 17
...#....A........
.###.###.#######.
.b...#.#.#.....#.
.#####c#.#.#.###.
.......#.#.#.#...
##.#####.#.###.##
...#.....#...#.#.
####.#######.#.#.
.....#.......#...
.#####.###.####B.
.#.....#.#.......
.#.#####.########
.a...#@..........
.#C#.#######.###.
...B.#.....#.#...
.#.#.#.##s.###.#.
.#!#...#.......#.
17 17
...S...#.........
.#####.#.#######.
.#@..#...#.......
.###.#####.#c####
.........#.......
##.#######.#####.
...#.....#...#...
.###.r##.###.#.#.
.#.#.#.....#.#.#.
.#.#.#####.###.#.
...#.....#.....#.
######.#.#######.
!#...#.s.......#.
.#.#.#####.###.#.
...#.#...#.#...#.
####.#.#.###.###.
.......#.....#...
17 17
...........#.....
.#.#######.#.###.
.#.....#@#...#.#.
.#####.#.#####.#.
...#...#.....#...
####.#######.#.##
.....#....!a.#.#.
.#####.#####.#.#.
.#...#.#...#...#.
.#.#.#.###.#.###.
.#.#...#...#.#...
.#.#####.###.#.#.
...#.#.....#.#.#.
####.#.###.#.###.
.......#.#.#.....
.###R###.#.####b.
.........#.T.....
17 17
.......r...#.....
.#######.#CS.#.##
.....#...#.#@#...
.###.#.###.#####.
.#...#...#.......
.#.#####.#######.
.#.....T...#q#...
.#####A###.R.#.##
..s..A...#.#.....
######.t##.###s#.
.....#.#...#...#.
.###.#.#.###.#.#.
...#...#...#.#!#.
##.#######.#.T##.
...#R.a..#...#.#.
.###.#.#######.#.
.C...#...........
17 17
...............#.
.#############q#.
.#...#!........#.
.#.#R##########q.
.s.....#.......#.
.S##.#.###.###.#.
...#.#.....#@#...
##.#.#####c#.###.
...#...#.....#...
.#####.#.#####.##
.......#.#...#.#.
##s#####.#.#.#.#.
.#.....#...#...#.
.#.#.###.#######.
...#.#...#.....#.
.###.#.#####.#.#.
...#.........#.a.
17 17
....s#.....#...#!
.#####.###.#.#.#.
.....#.#.#.#.#...
.###.#.#.#.#.####
...#.....#.#.#...
########.#.#.###.
.....#...#.#.#...
.###.b##q#.#.#.#.
...#.#.....#.#.#.
##.#.#.#####.q.#.
...#...#....a#.#.
.#######.#####.#.
.#.......#.#...#@
.#.#######.#.#.##
.#.....#.....#...
.#####.#########.
.................
17 17
...........#..!#.
Q##a##Q###.#.###.
.#...#.#...#.#...
.A.#.#.#.###.#.#.
.R.#.#.#...#...#.
.#.#.#.###.#####.
.#.#.....#...#@#.
.#.####c.#.#T#.#.
.#.....#.#.#.#.#.
.###.#.#.#.#.#.#.
...#.#.#.#.#...#.
##.###.#.#.###.#.
.#.#...#.#...#.#.
.#.#.###.###.###.
.#...#.#...#.....
.#####.###.######
.................
17 17
.#.....r.........
.#.#.###.#.c#####
...#.....#.......
.##Ra###.#######.
...#...#...#...#.
####.#.###.#.#.#.
.....#..!#...#.#.
.####q########.#.
...#.......#...#.
##.###.###c#.###.
.#...#.......R.#.
.###.###########.
..@#..........c#.
.#############.#.
.....#.......#.#.
.###.#.#.#####.#.
...Ct..#.........
17 17
...#...T.#...A.#!
.#.c.#.###.#.a##.
.#...#.#...#...#.
.#####.#.#####.#.
.#...#.#...#@#.#.
.#.#.q.#A#.#.#.#.
...#.#...#...#.#.
######.#.r##.#.#.
.....#.r.#...#.#.
.###.#.#.#.#t#.#.
.#.....#.#.#.#...
.#######.#.#.####
.#.....#.#.#.....
.#.###.#.#.#.###.
...#...#.#.#.#...
.###.#####.#.#.##
...#.........#...
17 17
.............#...
.#.#########.#.#.
.#.t.......#r..#.
.#.#.#####.#####.
.#.#@#...#.....#.
.#.###.#.###.#.#.
.#...#.#...#.#...
.###.#.###.#.####
.#.r...#.#.#.#...
.#.#####.#.#.###.
.......#.#.#.....
.#####.#.#.#####.
.#...#...#.#...#.
.#.#.#####.###.#.
.#!#.#...#...#.#.
q###.#.#.###.#.#.
...#...#.....#...
17 17
........@#.......
.#.#######.#####.
.#.#.......#...#.
.###.r########.#.
...............#.
##############.#R
.......#...b...#.
.#####.#.#######.
.#.....#.#...#...
.#S###.#.#.###.#.
.....#.#...#...#.
##.q.#.#####.###.
!#.#.#.......#...
.###.#########.##
...#.#.#....r#c#.
##.#.#.#B#.###S#.
.....#...#.......
17 17
.....#...#.......
.###.#.#.C.###.#.
...#.#.#.#.#...#.
.#.#.###.#.s.###.
.#.#.....#.#...#.
.#.#b#####.###.#.
.#.....#...#.#.#.
.#####.#.###.#.#.
.#...#.......#.#.
.#.#.#########.#q
.#.#..@#.....#...
.#.#####.#b#.##b.
.#.#.....#.#...#.
.#.#.#####.###.#.
...#.#...#...t...
####.#.###.#.###.
!....#.....#.....
17 17
...#...........#.
.#.###.T####B#.#.
.#.....#..r..#.#.
.#########B###.#.
.#.......#.q.#.#.
.#.#####.#.#.Q.#.
...#...#.#.#...#.
####.#.#.#####.#.
.....#.#....!#.#.
.####b.#######.#.
@#.......#.....#.
##.#####.#.#####.
...#..t..#.#...#.
.########C.#.#.#.
.....#...B.#.#.#.
.###.#.#####.#.#.
...#.........#...
