abcdefghijklmnopqrstuvwxyz-=[];/
ABCDEFGHIJKLMNOPQRSTUVWXYZ_+{}:?
OOOOOOOOOOOOOOOOCCCCCCCCCCCCCCCC
7
21 21
!..S.c...............
##.#.#.#####.######s.
.#.#...#.#...#.#.....
.#.#.###.#.###.#.##a#
...#.....#.#.#...#...
.#########.#.#.###.##
..a#.......#.#.#.....
##.#.#######.#.#####.
c#...#.......#...#...
.##T######.#R###.#.##
...........S...#.#...
.#########.#.#.#.###.
.........#.B.#.#...#.
.######R.#.#.#.###.#.
.#.......#.#.#...#.#.
.#.#.#######.#.###.#.
@#.#.#...#...#.#...#.
##.q.#.#.#.###.#.###.
...#.#.#.#...#...#...
.#####.#.###.#######.
.......#.............
21 21
.......#.............
.###T#.#########.#.##
...#...#...#...#.#...
.#.#.###.#.#.#.t####.
.#.#.....#...#.....#.
.#.###.###########.#.
.#.#.ab#.....#...#.B.
.#.#.###.###.###.#.#.
.#.#.#...#.#...#....c
.#.###.###.###.#####.
.#.........#.#...#...
#########c.#.###.#.##
.......#.....#...#...
.#####.#.QR###.#####.
.#...#.#...#...#...A.
.C##.#.###.#.###.#.#.
!#...#.#...#...#.#...
##.###.#.###s#.#.####
...#...#@#...#.#.#...
.#.#.#####.#.#.#.#.#.
.#.........#...#...#.
21 21
...#.....R......t....
.#.a.###.#.#########.
.#...#.#.#...#.....#.
.#####.#.#.#.#.#####.
.....#...#.#.#.#...#.
####.#.#####.#.#.#.#.
.....#B#...#s#...#.#.
.#####.#.#.#.#.q##.#.
.....#...#...#...#Q..
.###.#.#########.##c#
...#.#.#...#...#...#.
##.#.##s.#.###.###.#.
.R.#.....#...#C..#.#.
.#.####C####.#.#.#.Q.
...#..A....#.#.#...#.
.###.#######.#.#####.
..T..#....!#.#...#...
####.#.#####.###.#.##
...#.#.#...#.#.#.#...
.#.#.#.#.#.#.#.Q.###.
@#...#...#...#S......
21 21
.................#...
.###.###Q#######.#.#.
...#.#.....#...#.#.#.
##.#.#.###.###.#.#.#.
.#.#.....#.#...#.#.s.
.#.#######.#.###.##R.
...#.#.....#.T.#.....
.###.#.#####.#.#####.
...#.R.....#.#.....#.
##.#.#####.#######.#.
.#...#...#.#.....#.#.
.###.#B#.#.s.###.#C#.
...#.#.#.#...#.#.#...
.#.#.###.#####.#.####
.#...#...#...#.#...#!
.#####.#.#.#.#.###.#.
.......#.#.#.....#...
##R####s.#.#####.####
.....#...#.S...#.#...
.###.#.#######.#.#.#.
...#...........#...#@
21 21
.......#.......#.....
.###.#.#.#####.#.###.
.#.#.#...#.....#.#.#.
.#.#.#####.#####.#.#.
...#...#.#.#.....#...
##.##S.#.#.#####.#.C#
.#.#...#.......#.#..@
.#.#.#.#######.#.####
...#.#.#.....#...#..b
.A##.B##.##a.##t##.#.
.#.#.#...#.#r....#.#.
.#.#.#.#T#.#####.#.t.
...#.#.#...#...#...#.
.###.#.###.#.#.#.###.
.#...t.#...#.#.#.#...
.#.###.#.###.#.###.##
.#.#.....#...#..!#...
.#.#.####s.########c.
.#.#.#.....#...#...#.
.#.#.#.#####.#.#.#.bq
.#...#.......#...#...
21 21
...........#.........
.#.#######.#.###.####
.#.#.#.....#Sc.#.#...
.#.#.#.#####.#.#.#.#.
.#.#...#.......#...#.
##.#.##b.#########.#.
...#.#C..#...#...#.#.
.###.#####.#.#.#.A##.
.#.........#...#.#...
.###############.#.#.
.....#........@#.#.#.
.###.#.#####.###.#.##
.#...#.#.....#...#...
.#.#####.#####.#####.
.#.....#.#.....#.....
######.#.#.######r.#.
.......#...#.......#.
.#######.###.####R##.
.#.....#.....#.R.....
.###.#.#####b#.######
..!#.#...............
21 21
.........#.....Q.....
.#########.#.###.#.##
.#.......#.#.....#...
.#.#####.#.#R#######.
.......#.......#.....
##############.#.###.
.........#..@#.#.#...
.#######.#.###.#.#.##
!#.....#.#...#.#.#r#.
##.###.#.###.#.#.#.#.
...#.#.#.#...#.#.#...
.###.#.#.#.###.#.####
...#.#.#.#.....#.#...
##.#.#.#.#######.#.#.
...#...#.#...A.#.#.#.
.###.###.#.###.#.#.#.
...#...#...#.#.Q...#.
.#.#########.#.#Q###.
.#.......#...#.#.....
.#B###B#.#.#.#.#.###.
.......T...#.....#...
