abcdefghijklmnopqrstuvwxyz-=[];/
ABCDEFGHIJKLMNOPQRSTUVWXYZ_+{}:?
OOOOOOOOOOOOOOOOCCCCCCCCCCCCCCCC
7
9 9
.....#...
.#.###.#.
.#.#..r#!
.#.#.####
.A.#...#@
.#.###.#.
.#.....#.
.s######.
..B.....T
9 9
t........
.#T#####.
.......#.
####.###.
.#...#...
.#.###.#.
.#..@#.#.
.#.###.#.
C..#!..#B
9 9
!......#.
######.#.
.....#.#.
.#####.#a
.....#...
.###.###.
...#...#.
##.#.###.
@..#.....
9 9
.s...#@..
.###.###.
...#.#...
##.#.#.#.
...#!#.#.
.#####.#.
.....#.#.
####.#.#.
.......#.
9 9
....@#!#.
.#####.#.
.....Q.r.
.###.#.#.
...#.#...
####.###.
.......#.
.#######.
.........
9 9
..Q..#...
.###.###c
...#.#...
##.#.#.#.
.q.a...#.
.#######.
!#...#..A
##.#.#.##
@..#.....
9 9
.......#.
.#####.#.
..!#...#.
####.###S
...#.b...
.#.#####.
.#.#R....
.#.#.####
@#......S
