abcdefghijklmnopqrstuvwxyz-=[];/
ABCDEFGHIJKLMNOPQRSTUVWXYZ_+{}:?
OOOOOOOOOOOOOOOOCCCCCCCCCCCCCCCC
15
17 17
.......#.......#.
.###.###.#.###.#.
.#...#...#...#...
.#.###.#####.###.
.#...#.#...#...#.
.#####.###.###.#.
.#...#.....#.#.#.
.#.#.#q###.#.#.##
...#.....#...#...
.#####.#.###.###.
.#...#.#.#.....t.
.###.#.###.#S###.
.#...#.#...#.....
.#.#.#.#.###.####
.#.#.R...#.#....!
.#.#.t####.######
...#............@
17 17
...#.....#.#....b
.#C#.###.#.#.###.
...#.#!R.#....T#.
##.#.#.#.#######.
...#.A...#.......
.#.#.#####.B####.
.#.#.#...#.#...#.
.#Q#.#.#.#.#.###.
s#.#...#...#.#...
.#.########t.#.##
.#.r.....#.....#.
.#########.#####.
...#.......#.....
.#.#.#########.##
.#...#@......#...
.#########.#.###.
...........#.....
17 17
.............r...
.#.#.###T###.###.
.#.#.#.....#.....
.#.###.###.###.##
.#...#...#.#.#.#!
.###.##c.#.#.#.#.
.#.....#.#.#...#.
.#.###.#.#.###.#.
@#.#...#.#...#.#.
#t.#####.###.###.
...#.....#.#.....
.###.#####.######
...#.#.......#...
.#.#.###.###.#.#t
.#.#...q...#.#.#.
.#.###.###.#.###.
.#.........#.....
17 17
.....C...........
.#########.B##.##
@#...#...#...#...
##.#.#.#.t##.###.
.A.#...#.#.....#.
.#######.#####.#.
.#.....#.....#.#.
.#.#########.#b#.
.#.#.......#...#.
.#.#.###.#A###.#.
.#...#...#...#...
.#####.###.#.###.
.#...#...#r#...#.
.#.#.###.#.###.#.
.#!#.#...#...#...
.###.#.##r##.####
.....#...........
17 17
.......#...#.....
.###.#q#.#.#.#.##
.#...#.#.#.#.#.C.
##.###.#.#.#.###.
!..#.#.#.#.#...#.
####.#.#.#.#####.
.....#...#.#...#.
####.#####.#.#.#.
c......#...#.#q..
.##b##.#.##c.###.
.....#.#.#...#...
.###.###.#.###.##
.#.#.#...#.#.#.#.
.#.#.#.###S#.#.#.
...#.#...#.#.#.#.
##.#.###.#.#.#.#.
@..#.......#.....
17 17
.....#...#!..#...
##.#.#.#.###.##A.
...#.#.#...#...#.
.###.a.###.###.#.
...#...#...#.#.#.
##.#######.#.#.#.
...#.....#...#...
.###.###.#######.
...#...#.....#...
.a.###.#####.#.##
@#.#...#...#...#.
#B.#.###.#.#####.
...#.....#...#t..
.#.#####C###.#.##
.#.........#.#...
.#b###Q#####.###.
.................
17 17
.....#.......T@..
T#.#.#.#.###.###.
.#.#.#.#...#.....
##.#.####T.######
...#.....#.#.....
.#######.#.#.###.
.#!#.#...#..TR.T.
.#.#.#.###.###.#.
...#r#.#......C#.
####.#.#######.#.
...B...r...#...b.
.#.#.###.#.#####.
.#...#...#.......
.#####.##########
.#...#...........
.#.#.###########.
...#.............
17 17
.#.....#.....#...
.#.#.#.###.#.#.#.
...#.#.....#...#.
####.#######C####
.....#...#.......
.#####.#.#.#####.
.#...#.#.#.....#.
.#.#.S.#.###.###.
...#...#s#...#!..
.######Q.#.######
.#@#...#.#.......
.#.#.#.#.###A###.
...#.#.........#.
##.#.###########.
.#.#...........#.
.#.###########.#.
.............#...
17 17
.....#......r#...
.###.#b#.#####.#.
.#.#.#.#...#...#.
.#.#.#####.#.###.
.#.......#...#...
.####r##.#####.#.
.#!..#.#.#.....#.
.###.#.#.#.#A###.
.....#.#.#...#...
####B#.#.###.#.##
.r.#...#...#.#...
Q#.#.#.###.#.###.
.#.#.#...#...#.#.
.###.###.#####.#.
...#...#...#.....
.#.###.###.#.b###
@#.......#.......
17 17
.................
.#.#####.t#######
.#...#s..#!......
.###.###.######c.
.#.#...#@#.....#.
.#.###.###.#.###.
...B.#.#...#.....
####.#.#.########
.....#...#.....#.
.#########.###.#.
.#.#..c....#...#.
.#.#.#####.#.###.
.#.....#...#.q...
.#####T#.###.#.#.
.....#.#.#.#.#.#.
####.###.#.#.###.
.........S.......
17 17
.....r.......#c..
.###.###.###.#.##
...#.....#..S#...
##.#######.###t#.
...#.............
.#.#q#########C#.
.#.#.......#r..#.
.###Q#####.#c#.#.
.......#...#.#c#.
.#####r#.#####.#.
...#.....C.....#.
####.#####.#.###t
.....#..@#.#.#...
.#####.###.#.#.##
!#.....#...#.#.#.
##.#####.###.#.#.
........B..#.....
17 17
.#...#...........
.#.#.#.###.#####.
.#.#...#...#...#.
.#.#####.###.###.
...#...#.#...#...
.###.###.R.#.#.##
.....#...#.#...#!
####.#.###.#####.
.#...#...#.#...#.
.#.#####.#.s.#.#.
...#.#...#...#.#.
.###.#.#######.#.
...#.#...#@....#.
##.#.###.#######.
.t.b...#.#...#...
.#####.#.#.#.#.##
.......#...#.....
17 17
...#.#...........
.#.#.#.#.########
.#...#.#...#.....
.#.###.###.#.###.
.#@#...#.r...#...
.###.###.#####.##
...#.#...#...#...
.#.#.#.#.###.###.
.#.....#.......#.
.########t######.
.#.......#.......
##.#####.#.#####.
...#.#...#...T.#.
.###.#.c##.#.#.#.
.#.....#...#.#.#.
.#####.###q#.#.#.
....!#.......#...
17 17
..@#.............
.###.#####.######
...#.r.....#.....
##.#.c.#####.###.
...#.#.#.....#...
.###.#.#.#####.##
.....#.......#...
.###############.
.#...#.........#.
.###.#.#######.#.
...#.#.#a..#.#...
##.#.#.#.B.#.###.
.#.#.#.#.#.#...#.
.#.#.#.#.#.###.#.
...c.#.#.#...b.#.
.###.#.#.###.#.#.
.....#.....#!#...
17 17
.....#@........#.
.#.#.#####.###.q.
.#.#.#.....#.....
##.#.#.#.#####r##
...#.#.#.#.......
.###.#.###.#####.
.#.#.R.....#...#.
.#.#.#.####t.###.
.#...#.#.......#.
.#.###.#######.#.
.#...#.........#.
.###.#########.#.
..!#...#.......#.
######.#########.
...Q.#r....#...#.
.##c######.#R#.#.
.............#...
