abcdefghijklmnopqrstuvwxyz-=[];/
ABCDEFGHIJKLMNOPQRSTUVWXYZ_+{}:?
OOOOOOOOOOOOOOOOCCCCCCCCCCCCCCCC
9
17 17
@#.......#!#.....
.#.#####.#.#.####
.#.#.#...#.#.#...
.#.#.#.###.#.#.#.
.#.#.#...#.#...#.
.#.#.###.#.#.###.
.#.R...#...#...#.
.#.#.#######.###.
.#.#.....#...#...
.#b###.#.#.###.##
.#...#.#.#...#...
.###.#.#.#.#####.
..b#...#.#s#.....
.#######.###.###.
.........#...#...
.#########.###.##
...........#.....
17 17
.....#.......#.r.
.#####.#.#.###.#.
.....#.#.#.a...#.
.###.#.#.###.###.
.#.#.#.#..B..#...
.#.#.#.#######.#.
...#.#.#....@#.#.
##.#.#.#.#####.##
.#.#c....#...#...
.#.#B##r##.#.###.
...#.b.....#...#.
.###.#.#######.#.
.#...#...#.a.#...
.#.#####.###.##a.
.#.#...#...#...#.
.#.#.#.###.#.###r
...#!#.....#.....
17 17
.....#...q.......
.###.#.#####t###.
...#.#.#...#..!#.
##.#.r.###.#.#t#.
...#.#.#...#.....
.#.###.#.#.######
.#.#...#.#.......
.#.#.###.#######.
.#.#.#...#...#...
.#.#.#.#####.#.##
.#.#...#.....#...
.#.##S##.#.#.###.
.#...#...#.#.c...
.#####.#S#.#.#.##
.......#...#.#...
.#####b#.#######.
......@#.........
17 17
.......#.....#...
.#####.#.###.#.#.
.#.....#...#...#.
.#.#######.#####.
.#...........#...
.#############.#.
.#.....#.......#.
.#.###.#.###c###.
.#.#.#...#.....#.
.#.b.#######.#.#.
.#.#.#.......#.#.
.#.#.#.###.#####.
.#.#.#.#@#...#...
.#.#.#.#.###.#.##
.#.#...s...#...#.
.#.###.#.#.#####.
.#..!#...#.......
17 17
.....#........R..
.###Q###Q#.#####.
...#.#...#.....#.
##.#.#.#.c##.###.
.#.#...#.#...#t..
.#.#####.#.###.#.
.A...#.#.#...#.#.
.###.#.#.#####.#.
.#...#...#...#.#.
.#.###.###.#.#.#.
.#...#...#.#...#.
.###.###.#.#####.
...#!#.#.#...#...
.T.###.#.#.#.###.
.#.....#.#.#...#.
.#.#####.#####.#.
.#..S..........#@
17 17
...#.........#...
.#.#########.#.#.
.#.....#.....#.#.
.#####.#.#.###.#.
...#@#...#.#!#.#.
##.#.#####.#.#.#.
...Q.......#.#.#.
.#########.#.#.#.
.#.......#.#.c.#.
.#.#####.#.#.#.#.
...#...#.#.#...#.
.###.#.#.#.####R.
.#...#.#.#.....Q.
.#.###.#.#####.#.
.#.#.s.#.....#.#.
.A.#.#######.###.
...#.......#.....
17 17
.........#...#A..
##.#####.#.a.#.#.
...#...#.#.#...#.
.###.#.#.#######.
.....#.#...q.....
.#####.###.#.###.
.#.....#...#.#.#S
.#.#####.###.#.#.
.#...#.#...#.#T#.
.###.#.###.#.#.#.
.#.#.#.......#...
.#.#.#######T#.##
...b.#!..#...#...
#R##.##c.###.###.
.......#...#..@#.
.#########.#.###.
..........aC.....
17 17
...........#!....
.#.#############.
.#.............#.
.###########.#.#.
.#..@#...#...#.#.
.#.###.#.#.#####.
.a.....#.#.......
.#.#####.########
.#.#.....#...#...
.#.#.#####.#.#.#.
.#.#.......#...#.
.#.#############.
.#.#.....#.......
.#.#.#####.#####.
.B...#.....#.#...
.#####.#####.#.#T
.......#.........
17 17
.....#.......#..@
.#####.###.#.#.##
.....#...#.#.#...
.c##.#.###.#.###.
...#...#...#....C
########.########
.........#......!
.#c##rT#.#.######
.#.....#.#.#.#...
.#.###.#.#.#.#.#.
.#...#.#q#.#...#.
.#.#.#.#.#.##s##.
.#.#.#.r.#.......
.R.#.###.#######.
.#.#......q#...#.
.#r#########.#.#.
......A......#...
