abcdefghijklmnopqrstuvwxyz-=[];/
ABCDEFGHIJKLMNOPQRSTUVWXYZ_+{}:?
OOOOOOOOOOOOOOOOCCCCCCCCCCCCCCCC
7
33 33
.#.........#.......#...#..!#@....
.#.#####.#.#.#####.#.#.#.####C##.
...#...#.#.#.#...#.#.#.#...#.....
.###.#.###.#.#.#.#.#.#.###.#.###.
.R...#R....#.#.#.#...#.....#.#...
##.B.#####.#.#.#.###########.#.##
...#.#...#.#.#.#.......#...#.#...
.#.###.#.#.#.###.#####.#.#.#.#C##
TQ.#...#.#.#.....#.#...#.#...#...
.###.###.#########.#.#r#.#.###.#.
...#.#.#.......#...#.#...#.#...#.
.#.#.#.#######.#.#.#.#.cA###.###.
.#.#.Q...#.....#.#...#.#.....#...
.#.#.###.#.#####.#####.#.#####.#.
.#...#...#.......#...#...#...#.#.
.####T.#.#######r#.#.#####.#.#.#.
...#...#.#.........#.....#.#...#.
##.#.#####.###.#########.#.#####.
...#.......#.#.#.....c.#.#.....#.
.###.######B.#.#####.#.#.#####.#.
.#.#.#.......C.....#.#.#.#.....#.
.#.#.#######.#####.#.###.#.######
.#.........#.....#.#.#...#.......
.#########.###.###.#.#.###.#####.
.....#...#...#.#...#.#...#.#...#.
####.#.#####.#.#.###.###.#.#.###.
...#.#.........#.#...C.#.#.c.#...
.#.#.#######.###.#####.#.#.#.#.#.
.#.#...#...#.#...#.....#.#...#.#.
.#.###.#.#.##b.###s#####.#####.#.
.#...#.#.#.....#.#.....#.......#.
.#.###.#.#Q#####.#.###.#########.
.#.......#...........#...........
33 33
...............#.........Q.......
.#######.#####.###########.#####.
.....#.#...#.....#.....#...#.#...
####.#.###.#####.#.###.#.###.#.##
.....#.#...#...#.#.#...#.#.#...#.
.#####.#.###.#.#.#.#.###.#.#.###.
.#.....#.#...#.#...#.#...#.#.#...
.###.###.#.##A.#####.#.T.#.#.#.#.
.....#...#.#...#...#.#.#.#.....#.
####.#.#.#.#.###.#.#.###.#######.
.....#.#.#.#.#...#.#.....#!#...#.
.###c#.#.#.#.#####.#.####r.###.#.
...#...#.#.#.....#...#...#...#...
####.###.#.#####.#.###.#.###.##r#
.....#...#.....#.#.#...#...#.....
.#####.#######.#.###.###.#######.
.....C.#.....#.#...#...#.........
.###.#.#.#####.###.###.##########
.s...#...#.....#.#...#.#.........
.#.#####.#.#####.###.#.#####s###.
.#.#...#.#.........#...#.........
.#.#.###.#########.#####.#######.
.#.#.......#.....#.....#.#.....#.
##.####R##.#.###.#####.#.#.#####.
...#.....#.#...#.....#...#.#.....
.##r.###.#.#r#.r##.#######.#.####
.......#.#@#...#.#.......A...#...
.#######.###.###A###.#####.#q#.#.
.#...#...#...#..B..#.......#...#.
.###.#.###.##B.###.##########a##.
.....#.....#a..#.#.#C..........#.
####.#######.#r#.#.###.b######.#.
.....S...tQ..#.C.......#..A......
33 33
..............@#...#.......#.....
.###.###.#######.#.#.#.#####.###.
.#...#...#.......#...#.#.......#.
.#.###.###.#########.#.#.#######.
.#.#.....#.....#...#.#.....#.#...
.#.#######.#####.#.#######.#.#.##
.#S#.....#.#.....#.#...#.#.#.#...
.#.#.###.r.#.#####.#.#.#.#.#.###.
.#...#.#...#.....#...#.#.....#...
.#####.#########r#####.#.#####.#t
.......#.......#.#.#...#.#.....#.
######.#.#####.#.#.#.#####.#####.
.......#...#...#.#.#...#...#.....
.#########.#.###.#.R##.#.#.#####.
.........#.#.#...#.....#.#.#...#.
########.#.#.#.#######.#.###.#.##
...#.....#.#...#.....#.#.#...#...
.#.#####c#.#####.###.#.#.#.#####.
.#......!#.....#...#.#...#.#...#.
.#########.###.###.#.#####.#.#.#.
...#...#...#...#...r....A..#.#.#.
##.#b###.###.###.##Q########.###.
...#.....#...#...#...#.Q.....#...
.#t###.###.#.#.###.#.C######.#.##
.....#...#.#.#.....#.#.......#...
####.###.#.###.#####.#.s####.###.
s..#...#.#.....#...#.#.#.......#.
.#.###.######a##.#.#.#.#####T###.
.#...#.....S...#.#.#...#.......#.
.###.#####.#.#.#.#.#####.#####.#.
.#.#.....A...#...B.....#.#.....#.
.#.#####.###########s#.#.#.#####.
r......s.................#.......
33 33
.....R...#A........#.....Q.......
.#.#####.####q####.A.#######.###.
.#.#.....R.....#...#...#...#.#...
.#.########c##.#.#####.#.#.#.###.
.#...Q.#.#...#.s.#.....#.#.#...#.
.##C##.#.#.#.#.b##.#####.#.###.#.
.#.....#...#...#...#.....#.....#.
.#.##r##.#######.###.###########.
.#.#.#.......#...#.#..q#.......#.
.#.#.#.#######.###.###.###b#.###.
.#.R...#...........#...#...#.#...
.#.#.###.###########.###.###.#.##
.#.#..R#.#...#.......#.#...#.#...
.#.#.##r.#.###.#######.#.#.##A##.
.#.#.#...#.#...#...#.....#.....#.
##.#.#.###.#.#####B#.#######.###.
...#.#.#...#.....#...#.......#...
.###.#.###.#####.#####.#####.#.##
...#.#a#.....#...#...T.#.....#.#.
.#.###Q#.#####.###.#########.#.#.
.#.....#.....#...#.........#.#.#.
.#####SA####.s##.#######.#.###.#.
.#...#.....#...#...#...#.#.....#Q
b#.#.###.#.###.###.#.#.#.#######.
...#.#...#.#.....#...#.#.#.#.....
####.#.###.#.###.#####.#.#.#.#.##
..!#...#.#...b.....#...#.#...#...
.#######.#.####b##.#.#r#.#######.
.#...#.....#...#..b#...#.........
.#.#.#######.#.#####.#.#########.
...#...#.....#.....#.#.#..@#...#.
######.#.#######b#.###.#.##s.#.#.
.........#.............#.....#...
33 33
.....#...........#...#.......#...
##.###.#####.###.###.#.#####.#.##
...#...#.....#.......#...#.#.#...
.###.###.#####.#########.#.#.###.
.....#...#...#.#.........#...#...
.#####.###.###.#.####S####.###.##
...#s..t...#...#.....#...#.#.....
##.#.#####.#.#######.#.###.#####.
...#.#.....#.#.....#.#.....#...#.
####.#.#####.#.###.#.#.#####.#.#.
...#.#.....#...#...#.#.B.....#.#.
.#.#.#####.#####.###.#.#####.#.#.
.#...#...#.....#.#...#.......#...
.#####.#.#.#####.#.#############.
.#.....#...#...#.#.#...#.......Q.
.#.###.#####.#.#.#.#.#.#.#####.#.
.#.#.#.......#...#.#.#.#.#...#.#.
.#.#.#############.#.###.#.#.#.#.
.#.......#@..#...#.#.#...#.#.#.#.
.#######.###.#.#.#.#.#.###.###.c.
.......#.....#.A...#.#.q.....#...
.####a.###.###.#####.#.#.###.#S##
.....#.#...#!#.#...#...B.#...#...
####.#.#####.#.#.###.###.#.#.#.#.
.#...#.....#...#...#.#...#.#...#.
.#.##s####.#######.#.#####.#####.
...#q....#.........#.#.....#.....
.#Q#.###.#.###.t####.#.#####.####
.#...#...#.#...#...#.#...q.#...#.
.#####.#.#.#####.#.#.#.#.#.a#t.#.
..t....B.#.#...#.#...#.#.#...#.b.
########.#.#.#.#.#######.#.#####.
.........#...#...........B.......
33 33
...........#...........#.......#.
.#.#######.#####.#####.#B#.###.#.
.#.......#...#...#...#.....#.#.#.
.#######.###.#.###.####q####.#.#.
.#.....#.#...#.#...........#.#.#b
.#.#.###.#.###.##t##.#.##A.#.#.#.
.#.#.#...#B..#.....#.#.#@#...#.#.
.###.#.####r.#.###.###.#.#.###.t.
.#...#...#.#.#.#...#...#...Q...#.
.#.#.###.#.#.###.###.#####.#.###.
..s#...#.#...#...#...#...#.#.....
##.#####.#.###.###.###.#.#######.
...#.....#.....#.......#.......#.
####.###Q#######.#########.#.###.
.....#...#.....#...#.....#.#.#...
.###.#.#.#.######Q.#.###.#.#.#.##
.#.#.#!#.#.#.....#.#.#.....#.#.#.
.#.#.###.#.#.###.#.#.#########.#.
.#...#...#.....#...#...........#.
.###.#.#######.#################.
...#.#.....#...#.........#.....#.
.#.#######.#.#####.#######.#.#.#.
.#.......#.#.....#...#.....#.#...
########.#.#####.#.#.#.#####.###.
.........#.....#.#.#...#...#...#.
.###q#########.#.###.#####.###.##
.#.t.#......a..#...#...#...#.#...
.###.#.###########.###.#.#.#.###.
...#.#...#.#.....#...#r..#.....#.
##.#####.#.#.###.###.###q#######.
.#.......#...#C#.....#...........
.#########.###.#######.#########.
.................R.....#.........
33 33
...........T.....Q.#.......#.....
.#####R#######.###.#.#.###.#.####
.#.....#.....#.#...#.s.#.#.#.....
.#.#.###.R##.#.#####.#.#.S.#C###.
.B.#@#...#...#.......#.#.#...#...
.#.###.###.######AcA##.#R#T#.#.##
.#...a.#.#.#...#.....#.#.....#...
.###.#.#.#.T.#.#.###.#.###.#####.
.....c.#.#.#.#...#...#...#.......
######.#.#.#.#####.###.#.#######.
...#...#.#b#...#.....#.#.#...#...
.#.#.t##.#.#.#.#####.C##.#.#.####
.#...#...#.#.#...#.#.#...#.#.....
.#####.###.#.###.#.#.#.###.#####.
...#...#...#.#...#.#.#.........r.
##.#.###.#####.###.#.R####.#####.
.#.#...#...#...#.c.#.....#.#.....
.#.###.###.Q.#####.#####.#.#.###.
.#...#..c#.#.....#.....#.#.#.#...
.###.###.#.###.#.#.####b.A##.#.##
...#.#...#...#.#.#.#.....#...#...
.###.#.#####.#.#.#.#.#####.###st.
.#...#.......#.#.#...#...#.....#.
.#.##q.###.###.#.###.#.#.#####.#.
.#...#.#!#.#...#.C.#...#.......#.
.###.#.#.#.##s####.#############.
...#.#.#.#.....q...#...........#.
##.#.###.#####.#.###.#c#s#######.
...#.....#.....#...#.#...........
.#########.#######.#.#.##A#A#####
.#.........#.....#.#.#.......#...
.#.#####s###.###.#.#.#######.#.#.
.............#.....#...........#.
