abcdefghijklmnopqrstuvwxyz-=[];/
ABCDEFGHIJKLMNOPQRSTUVWXYZ_+{}:?
OOOOOOOOOOOOOOOOCCCCCCCCCCCCCCCC
7
17 17
.....#.........#.
.###.###.R##.#.#.
.#.#...#.#...#...
.#.###.#.#.#####.
.#...#.#.#.....#.
.###.#.#.#####.#.
...#...r.#.....#.
##.#.#####.###r#.
.#.#...#...#..@#.
.#.###.#.###.###.
.#!#...#.#.....#.
.###.###.#.###.#.
...#.#...#...#...
.###.#.#####.####
...#.#.#.#R..#...
.#.#.#.#.#.###.#.
.#.....#.......#.
17 17
.............#...
.###########.#.#.
...#!#.......#.#.
##.#.#.#######.#.
...#.#.#@......#.
.###.#.#####.###.
.#...#...#...#...
.#.#####.#.###.##
.#.....#...#.#...
.#####.#q###.###.
.....#.....#.....
.###Q#####.###.##
...#.....#...#...
.#.#.###.###.####
.#...#.#...#.....
.#####.#.####A##.
.......#.........
17 17
...........A.#...
.#########.#.###.
.#.........#.....
.#.#############.
.#.....#...#.....
.#R###.###.#.####
.....#...#.......
####.###.#.####r#
.......#.#.#.....
##.#####.#.#.###.
!#...#...#.#.#...
.###.#.#####.#.#.
.#@..#.......#.#.
.###.#####.###.#.
...#.#...#...#.#.
##.###.#.#####.#.
.......#.......#.
17 17
.................
.###########.####
.#...#.....#.#...
.#.###.###.#.#.#.
.#...#..!#.#.#.#.
.###.#####.#.#.#.
..A......#.#...#.
######.###.#.###.
@#.....#...#.#...
.#.#####.#####.##
.#...#.#..a#...#.
.###.#.###.#.###.
...#.....#.#...#.
.#.##R##.#.###.#.
.#.#...#.#.....#.
.#.#.#.#.#######.
.#...#...........
17 17
@#...........#...
.#.#####.###.#.#.
.#.#...#...#...#.
.#.#.#.#########.
.#.#.#.......#...
.#.#q#######.#.#.
.#.#...#.....#.#.
.#.###.#.#####.##
...#...#.....#.#!
.###.#######.#.#.
...#.....#...#.#.
##.#####.#.a##.#.
.#.#...#.#.....#.
.#.#.###.###.###.
...#...#.#...#...
.#####.#.#####.##
.......#.........
17 17
.#.....#.....#...
.#.#.#.###.#.#.#.
...#.#.....#.#.#.
.###.#######.###.
...#.#.#.........
##.#Q#.#.#######.
...#.#....@#...#.
##.#.#######.#.##
!#.#.........#...
.#.###########.#.
.#...#.#.....#.#.
.#R#.#.#.###.###.
...#...#...#...#.
##.#####.#.###.#.
.#.#...#.#.#.#.#.
.#.#.#.###.#.#.#.
.....#.....#.....
17 17
.......#.....#@..
.#####.#.#.#.###.
.....#.#.#.#.....
.###.###.#.######
...#.....#r......
##.#############.
.#.............#.
.#############.#.
...............#.
.#########.#####.
.#...#...#.#.....
.#.#.#.#.###.###.
.#.#...#.#...#.#.
##.###R#.#.###.#.
...#...#!#.#.#...
.Q##.#.###.#.#.##
.....#.....#.....
