abcdefghijklmnopqrstuvwxyz-=[];/
ABCDEFGHIJKLMNOPQRSTUVWXYZ_+{}:?
OOOOOOOOOOOOOOOOCCCCCCCCCCCCCCCC
7
17 17
.B.#!#.....#.....
.#.#.#.#Q#.#.###.
@#.#.#...#.....#.
##.#.#.#########.
.b.#.#.#...#.....
.#.#Q###.#.#.###.
.#.#.#B..#...#...
.###.#.#######.##
.....A.#...#...#.
.#####.#.#.#.###.
.......#.#...#..s
########.#######.
.....#...#.......
.##q##.###.###.#.
.#...#...#...#.#.
.#.#.###.#####.#.
...#........a..#.
17 17
.....#.........#.
.###.###.#####.#.
.A.#...q.#.......
##.###.#.#.######
...#.#...#...#!..
.###.###.#######.
.#@......#.....#.
.#########.###.#.
.#.......#.#.#...
.#.#####.#.#.####
.#...#...#.#.#...
.###.#.###.#.#.#.
...#.#.....#...#.
.###.#######Q###.
.....#.........#.
.#########.###.#.
...........#.....
17 17
.#.......#.......
.#.#.###.#.####S#
...#...#...#.....
.#####.#.###.###.
.#...#.#.#...#!..
.#.#.#.#.#.######
.#.#.#.#.#.#.....
.###.#.###.#.#.#.
.....#.#...#.#.#.
.#####.#.#####.#.
.#...#.#.....#.#.
##.#.#.#####.#.#.
...#.......#...#.
.#########.#####.
...#@......#a..#.
.#.#########.#.#.
.#...........#...
17 17
q.....A....#@....
.#######.#.#####.
.#...#...#.#.....
.###.#.###.#.###.
.....#...#.#.#.#.
####.###.#.#.#.#.
.......#.#...#...
.#######.########
.#.......#.......
.#.#####.#.#####.
.#.#.....#.#.#!..
##.#.#####.#.####
...#.....#.#.....
.#######.#.#r###.
...#...#.#...#...
.#.#.#.#####.#.#.
.#...#.........#.
17 17
.............#...
##.#####.###.#.#.
!#.#.....#.#...#.
.###.#####.#####.
.#...#....r......
.#.###.##########
...#...#..s......
####.#######.###.
...#...#.....#...
##.###.#.#####.##
.....#...#...#...
.###.#####.#.###.
.#......@#.#...#.
.######Q##.###.#.
...........#.#...
.###########.####
.................
17 17
.....#.....#@....
.#.###.###.#####.
.#.......#...#...
.###########.#.##
.#.#...#.....#...
.#.#.#.#.#######.
.#...#.#.#.....#.
.#####.#.#.#.#.#.
...#..b#!#.#.#.#.
#r.#.#######.#.#.
...#.........#...
.#########.#####.
.....#...#.#...#.
##Q#.#.#.#S#.#.##
.#...#.#.#...#...
.#.###.#.#######.
.......#.........
17 17
.......#..B#.....
.#####.#.###.###.
...#.#.#.....#...
##.#.#.######A.#.
...#...#...#...#.
.###.###.#.#.####
...#.....#.#.....
.#.#######.#####.
.#...#...#.......
####.#.#.#######.
.....#.#.......Q.
.b.#######.#.#.#.
.#@#!.q..#.#.#.#.
.#######.#.#.###.
.#.R...#.#.#..a..
.#.#.###.#.######
...#.....#.......
