abcdefghijklmnopqrstuvwxyz-=[];/
ABCDEFGHIJKLMNOPQRSTUVWXYZ_+{}:?
OOOOOOOOOOOOOOOOCCCCCCCCCCCCCCCC
7
17 17
...B.........#...
.#.#########.#.#.
.#.....#...#...#.
.#####.#.q.#####.
.#...#.#.#R....#.
.###.#.#b#####.##
.....#.#.....#.#!
####.#.###.###.#.
.#...#c#...#...#.
.#.###.#.###.#.#.
.#.#.#...#.r.#.#.
.#.#.#####.#.###.
...#.......#.#...
.###bc.#.#.#.#.##
.....#.#.#.#.R.#.
####.##U.#.#.#.#.
@........#.#.....
17 17
.#.......#.......
.#.#.###.#.#.t##.
.#.#...#.#.#...#.
.#.###.#.#.r##.#.
u#.#...#.#...#.#.
.#.#.###.###.#.#.
...#.#...#...#.#.
####.t####.###.##
.....#.....#.#.#!
.#####.#t###.#.#.
.............#.#.
.#A###########.#.
.a.T...#.......#.
.r.#.###.###S###.
...#.#...#...#...
####.#.###.#.#.##
@....#.Q...#...R.
17 17
...#b............
.#.#r#########.#.
.#.r.#.........#.
.B.###.##########
.#...#.#...#.....
.###.#.#.#.#.###.
...#...#.#.#.#.#.
.#.#####.#.#.#.R.
.#.....#.#...#.#.
.#####.#.#####C#.
...#@#.#.....#.#.
##.#.#.#####.#.#.
..D#.#.........#.
.###.#######.###.
.#...#!#...#.#...
.a##.#.#.#.###.#.
.....#...#.q...#.
17 17
.....#@..........
.###.c########.#.
...#.....#.....#.
##.#####.#.####c#
...#...#.#.#.....
.###s#.#.#.#.###.
.#...#.#...#.#...
.#.###.###.ud#.##
.....b...#.#.#..A
.##s##.#.###.###.
.#...#.#.......#.
.#.#.###.#######.
.#.#...#.#.....#.
#U.###.#.c.###.#.
...#...#.#.#...#.
.#####.###.#.#A#.
....!#.....Q.....
17 17
.#...............
.D.###.#########.
.#.#...#.#.....#.
.#a#.###.#.#.###.
..A#...#..t#.#...
####.#.#####.#.##
!..#.#.#.....#.#.
##.###.#.U####.#.
.#.#...#.....#.U.
.#.#.###.###.#.#.
.#a..#.#.#...#.#.
.#####.#.#.###.#.
...#.....#.T...#.
.###.#####.q.##U.
.....#@..#.#.#...
.####D##.#.#.#.#.
.....U...#.....#.
17 17
!#.........b.....
.#######.##c###c.
.#.....#.c.A.#...
.#.###.###.#.###.
.#.#.#...#.#...#.
.#.#.###.##t##.#.
.#.#..@#...#...#.
.Q.#.#####.#.####
...#.....#.#.....
########.#.###.#.
.........#...#.#.
.#####.#####.#.#.
.#.....#...#.#.#.
.#######.#.#.###.
...#.....#.#.....
.#.#.#####.#####.
.#..S....#.......
17 17
..........@#.....
.###########.#.#.
.#...#.......#.#.
.#.#.#.#######.##
...T...#.....#...
.#####.#.###.###.
.#...#...#.u...#.
.#.#.#####.#Q###.
.#.#.#.....#.....
.#.#.#######.###.
.#.#......r#.#...
.#.####D##.#.####
.#.#.#.....#.....
##.#.#.#########.
!..#.#.#...#...#.
####.#.#.#.#.#.#.
.........#...#...
