abcdefghijklmnopqrstuvwxyz-=[];/
ABCDEFGHIJKLMNOPQRSTUVWXYZ_+{}:?
OOOOOOOOOOOOOOOOCCCCCCCCCCCCCCCC
15
17 17
.....Q.......#...
b#####.##t##.#.#.
.#.....#...#...#.
.#.#####.#.#####.
...#!....#.....#.
.#############.#.
...Q...#.....#.#.
##.###.#.s##.#.#.
...#...#.#.#.#.#.
.###.###.#.#.#.#.
.....#...#.#...A.
####.#.###.#####.
...#.#...#...#...
.#.#.###.#.#.###.
.#...#.#...#...#.
.#####.#######.#.
............@#...
17 17
.............#...
.#####.#####.#.##
.#.....#.......#!
.#.###.#########.
.#...#.#.......#.
####.#.#.b####.#.
.....#.#.#...#...
.#######.#.######
.#q....#.#.......
.#.###.A.#.#.r##.
.#.#.s...#.#...#@
.#.TbA#####S##.##
...#.........#...
.###.#.#####.###.
.#...#.#...#...#.
.#####.#.#.###.#.
.......#.#.......
17 17
.......#.........
.#####.###.#####.
...#...#...#...#.
#B.#.###.#####.q.
...#.#...#.....#.
.###.#.###.#.###.
.#.....#...#...#.
.#######.#####.#.
.#...#...#.#!#.#.
.#.#.###.#.#.#.#.
...#...#...#.C...
####s#.###c#.#.##
.......#...#.#.#.
.#######.#.#.#.#.
.......#.#...#...
.####A.#.#######.
.....#...#@......
17 17
.........#.......
.#######.s.###.#.
.#....@#.R.#.#.#.
.###.###.###.#.##
.....#!Q...#.#...
######.###.#.###.
.....#.#...#...#.
.###.#.#.###.#.#.
...#.b.#.....#.#.
##.#.#.#####.###.
...#...Q.....#...
.#####R#####.#.#.
.....#.....#.#.#.
####.#.###.###.#.
...#.#...#...#.#.
.###.###.###.#.#.
.........#.....#.
17 17
.........#c......
.#.#####.###S#.#.
.#.#.........Q.#.
.#.###.#########.
.#...#...#...#...
####.###.#.#.#s#.
.....#...#.#...#.
.#####.###.###.#.
.#...#...#!#...#.
.#.#.###.###.###.
.#.#.......#...s.
.#.###########.#.
.#..@#A........#.
.#.##q.#########.
.#.#...#.......#.
.###.###.##t.###.
.....#.....#.....
17 17
...#.........#...
.###.###.###.###.
.#.....#...#.....
.#t#######.#.####
.#.#.....#.#.#!..
.#.#.###.#.####t.
...#...#...#...#.
.#####.#####.#.#.
.....#.....#b#.#.
####.#####.#.#.#.
.#...#@..#...#...
.#.C#s##.########
...#.........#...
.###.#######.#.##
.#...#.....#.#..T
.###.#.#####.###.
.....#..a........
17 17
.......#......C..
.#.#####.####A.##
.#....b..#...#...
.#########.#.###.
...#.......#.#...
Q###.#.#####.#.##
.#...#.#...#.#...
##.###.#.#.#.###.
...#...#!#.#...#.
.#########.###.#.
.....#...t...#...
###A.#.#.###.###.
..@#...a.....#.#.
.###r#########.#.
.#...#.......#...
.#.#.#.#.#####.##
...#...#.........
17 17
..c..#...........
.###.#.#######.##
.#.#.#.#.....#...
.#B#.#.###s#.###.
...#.#.........B.
##.#.###.#######.
..r#.....#!..#...
.###########.#.##
.#...#.....#...#.
.#.#.###.#.#####.
.#.#.....#...#@..
.#.#########.###.
...#.......#.#...
####.#####.#.#.#.
...#.#...#...#.#.
.#.#.###.#####.#.
.#.............#.
17 17
.........#.......
.#####.###.#####.
.#@....#...#.....
.#######.###.###.
.......#.#.#...#.
.###T#.#.#.###.#.
....S#.....#...#.
##########.#.###.
.....#...#c#.#.#.
.###.#.#a###.#.#.
...r...#.#...#.#.
##.#####.#.r##.#.
.#...#...#...#.#.
.###.#.##T##.#.#.
.#...#!#.....#...
.#.#####.#####.##
.........#...R...
17 17
.#t..........#...
.#.##c.#####.#.#.
...#.#...#.....#.
.###.###.#######.
.C.....#.......#.
######.#######.#.
...#...#...#...#.
.#T#.###.#.#.###.
.Q.#.#...#.#.#@..
.#.#.###.#.#.###.
.#.#.....#.#...#.
##.#######.###.##
.....#...#.#.#...
.#####.#.#.#.###.
.....#.T....a..#.
.###.#.#########.
...#.....#!......
17 17
...........#.....
.#########.#.#t#.
.......#...#...#.
.#####.#.#A#.###.
.b.....#.#...#...
q#.#####.#.###.#.
...#.#...#.#...#.
.###.#.###.#.###.
.S...#...#.#.#.#.
.###.###.###.#.#.
...#...t.....#...
##.#######S###.B#
@#........!#.#.#.
.###########.#.#.
.#...#.....#...#t
.#.#.#.###.#.###.
...#.....#.......
17 17
.TTQ...#...#...#.
.#####.#.#.#.#.#.
.#.....#.#...#...
r#.tB###.#T##T##.
.#.....#...#.....
.#####.###.A.#B##
.#.........#.....
.#.##############
.#.#.............
.#.#.##s#r######.
.S.#...#@#...#...
.#####.#.#.#.#.##
.#.....#...#.#!#.
.#.#########.###.
...#.......#.....
.###.#####.#####.
.....#...........
17 17
...#.......#.....
.#.#.###.###.#.##
.#.#.A.#.....#...
.#.#.#.#########.
.#.#.......#...#!
.#.#######.###.##
.#...#.....#.....
.#####.##a##.###.
.....#.#.....#.#.
.R##.#.###.###.#.
.#...#.#...#...Q.
.#.###.#.###.###.
.#...#...#.#.....
.###.##B##B#.####
...#.#.....#...#.
##.#.#.###.###.#.
@..#.....#.......
17 17
...#.......#.....
.#.#.#####.#.###.
.#.#.#...#...#.#.
.#.#.#.#.#####.#.
.#...#.#..T....#.
.###.#######.###.
.#...#.s...#.....
.#####.###.Q####.
.#.......#.#...#.
.#.#######.#.#.#.
...#.......#.#.#@
.###.#######.Q.##
.#.#.#...#...#...
.c.#.#.#.#.#####.
...#...#.#.#.#!..
##.#####.#.#.####
.......#.........
17 17
....Q....#.....#.
.#######.#.###.#.
.#.......#.#.#...
.#.#####.#.#.###.
.#.#.....#.#.....
.#.#######.#.####
Cr...#...#.#.....
.###.#.#.#.#####.
...#.#.#.#....!#.
##.#.#.#.#######.
@#.#.#.#...#...#.
.#.#.#.#.###.#.#.
.#.#...#.#...#.#.
.#.#####.#.###.#.
...#...#...#.#...
.###.#.#####.##S#
.....#...........
