abcdefghijklmnopqrstuvwxyz-=[];/
ABCDEFGHIJKLMNOPQRSTUVWXYZ_+{}:?
OOOOOOOOOOOOOOOOCCCCCCCCCCCCCCCC
7
33 33
.............#.......#.#.....#...
.#########.#.#.#####.#.#.###.#.#.
...#...#...#.#.#.#...C.#.#!..#.#.
.###.#.#.###.#.#.#.#####.#####.##
.#...#.#.#.#.#.#C#...#...#.......
.#.###.#.#.#.#.#.q##.#.#####.##a.
.#.#.....#.#...#...#.#.....#.C...
.#.#######.#####a###.#####.#.#.##
.#.....#b......#.....#...#.#.#...
.#####.##a##.###.#######.#.#####.
.#...#.#...#...#.#.....#.#.....#.
.###.#.q.#.###.#.###.s.#.##T##.#.
.....#...#.#...#.....#.#...#.#...
##.#######.#.#.#######.#.#.#.###.
...#.....#.#.#.......#...#.....#.
.##s.###.#.#.###.#########T#.###.
.#.#.#.....#...#@#.......#...#...
.#.#.##t######.###.###.###.###.##
.#.#.#.......#.#...#.#.......#...
.#.#.#.#####.#.#.###.###########Q
...#.#...#...#.......#.....#.....
##.#.###.#.#.S######.###.#.#.####
...#.....#.#.#...#.....#.#.#...s.
.#R#######.###.#.A####.#.#.t##.#.
...#.....#...#.#.....#.#.#...A...
##.###.#.###.#.#Q###.#.#.###.##B.
.#.....#...#...#...#.#...#...A.#.
.#########.#####.#.#.#####T###.a.
.........#.#.....#.#...#.......#.
.B########.####r.#.###.###b#####.
.#.........#...#.#...#..a....#...
.#.###A#####.#.###.#.#######.#.##
.b...........#.....#.......#.....
33 33
.......#.....#.....#.....#...#...
##.###.#.T##.#.#.###.#.#.#.#.###.
s..#q..#...#...#.#...#.#...#.#...
.#.#####.#######.#.###.#####.#.##
.#.#...#S#.......#.#.#.#.....#...
.###.#.#.#.#c###q#.#.#.#.#######.
.#...#.#.#C#.....#...#.R.#.....#.
.#.###.#.#.#######.###.#.###.#.#.
...#...#.#.........#...#.....#.#.
.###.###.###########.#########.#.
...#...#.#.....q.....#.......#.#.
##.T##.#.#.##Q.#.#####.##r####.#.
@#.#.#.#...#...#...#.B.......#...
.#.#.#.#####.#####.###.#####.##q.
.#...#...........#...#.#.....#...
.###.#####C#########.###.###.#.##
.....#.....#.#.....#...#...#.#.#.
####.###.q.#Q#.###.#.#.#a#.#.#.#.
...s.....#...#.#.#.#.#.#.#.#.#.#.
.#.###.#######.#.#.###.#.#.###.#.
.#...#.#.......#...#...#.#...#.#.
.###.###.#######.###.#######.#.#.
.#.#.....#.....#...Q...#...#.#.#.
.#.#######.###.###.#.#.#.#.#.#.#.
.#.....#...#.#.....#.#...#.#...#.
.###.#.#.###.##R####.###C#.#.###.
...#.#.#.........#...#.....#.#...
.#.#.#.#########.###.#.#####.#.#.
.#.#.#.#...#...q...#.#.#.....#.#.
.#.#.###.#.#.#.###.###.#.#####.#.
.#.#.#...#.#.#...#.#...#.#...#.#.
##.#.#.###.#.###.#.#.###.a.#.###.
!..#.....#.....#.....s.....#.....
33 33
.....#.......#.......#.....#.....
.###.#.#####.#.#####.###.#.#####.
.#...#.#...#...#.#...S...#..R....
.#.###.#.#.#####.#.###.#.#######.
.#.....#.#...#...#.#...#.#.....#.
.#######.###.#.#.#.###.#.#.###.#.
.#.........#.#.#.#.#...#.#.#.#.#.
.#.#########.#.#.#.#.#####.#.#.##
.........#...#.#.....#.....#.#...
.####T####.###.#######.#####.###.
.#.....#...#.....#...#.#.....#...
##.###.#.#########.#.#.###.#.#.##
...#.#...#.........#...#...#.#.#.
.#T#.###.#.#####A#######Q#####.C.
.#.......#.......#...#...#...#.#.
.#.##t##########.#.#.###.#.#.#.#.
.#...#.........#...#...#...#.#.#.
.#####.###.##a.###A###.###.#.#.#.
.#.....#...#...#.....#...#.#...#.
.#.T####.#######.#.#.###.#####.#.
.#...#...#.......#.#.#.#.....#.#.
.###.#.s##.#######.s.#.#####.#.#.
.#...#.#.........#.#...#...#.#...
.#.###.#.#######.#.###.#.###.###.
.....#...#.....#.#.#@....#!#...#.
.#########.###.###.#######.#.#.#.
.#.......#.#...#...#.....#.t.#.t.
.#.#####.#.#.###.###.##s.#.###.#.
R#.#.......#.....#...#.#.#.....#.
.#.###.###########.###.#.#######.
.#...#.#.......#...#...#...#...#.
.###.###.#####.#.S####.###.#.#.#.
...#.........#...........#...#...
33 33
.........#.....#.............#...
.###R###.#.###.#.#.#########.###.
.b.#.#.#.#...#.#.#.#...#.....#...
.#.#.#.#.###.#.#.#.###.t.##a##.#.
.#.a.#.....#.#...#...#...#.....#.
.#.#.#######.#######.#.###.#####.
...#.....#s..#...#...a...#.....#.
########R#.##c.#.#.#####.#####.#.
.........#.#...#.#.#.....#...#.#.
.#########.#####.#.###.###.#.#.##
.#...S...#.....#.#...#...R.#.#...
.#.#####.#####.#.###.T######.#.#.
.#...#.....B.#...#...#....@t.#.#.
.##b.#.#########.#.###.#.###.a.#.
...#.#.......T.#.#.#...#.#...#.#.
.###.#####.###Q#.#.###.A##.###.#.
.....#..!#...#...#...#...#...#.#.
.#####.###.#######.#.###.###.###.
.#.....#...#.....#.#...#...#.....
##.#########.###.#####.#.#.#####.
...#.......#.#...#...#.#.#.....#.
.###.#####.#.#.###.#.#.#.#####.#.
.....#.....#.#.#...#.#.#.#...#.#.
#s####.#####.#.#.###.#.#.###.#.#.
.....#.....#.#.#...#.#.#.....#.#.
.###.#####.#.#.###.#.#.#####.#.#.
...#.#.....#.#.....#.#.#...#.#...
.#.#.#.#####.#######.#.###.#.####
.#.#b#.#.C...#.......#...#.#...#.
##.###.#.#.###.#######.#.#.###.#.
...#...#.#.#.#...#...#.#.#...#...
.###.#####.#.###.#.#.###.#.#.###.
...........#.......#.....#.#.....
33 33
...#...........#.......#.........
.###.#.#######.#.#####.###.######
.....#.#...#.#...#.........#.....
.#####.#.#.#.#####.#####.###.###.
...#c..#.R.......#.#...#.#...#.#!
####.###.#######.#.#.#.###.###.##
...#.#.......#...#.#.#...a.#Q....
.#.#.#####.#.###.#.#.###.#.#.####
.#...#...#.#...#.#.#...#...#.....
.#####.#.#.###t###.##Rq#######S#.
.....#.#.#...#...#...#.......#.#.
####.#.#.###.###.###.#######.###.
.....#.#...#...#.#...#.....#...#.
.####c.###.#.###.#.##t#S.#.###.#.
.#.....#...#.#...#.....#@#...#.#.
.#.###c#.###.Q.#.#####.###.###.#.
.#.#...#.#...#.#.....B.....#...#.
.#.#.###.#.###.####B######.#.###.
.#.#...#.#...#.......#.....#.#...
.#.###.#.R##.#######.#.#####.###.
.#.....#...#...#..b#...#.....#...
.###.#####.#.###.#.#####.#####.##
.....#...#.r.#...#.....#...#.....
.#####.#.#.###.##a####.###.###.#.
.#...#.#...#...#.c.......#...#c#.
RR.#.#.#####.###.#.###.#####.###.
.#.#.#...........#.#...#.....#...
.#.#B##A###C######.#####.##T##.#.
.#.#.......#.....#.....#.......#.
.#####.###.#.###.#####.#########.
.#...#...#.#.#.....A...#...#.....
.#.#.####ar#.######t###r.#.#.####
...#....a..#.............#...B...
33 33
.......#...#...#.......#@........
.#####.#.#.T.#.#.###.#.#####.####
...#.#...#.#q#.#.#...#.#.....#...
#T.#.#####.#.#.#.#.###.#.#A###.#.
.#.#.....#...#.#.#r#.#.#.......#.
.#.#####.#####.#.#.#.#.#########.
.#.........#.#...#.#.......#.....
.#########.#.#####.#######.#.####
...#.....#.#.....#.....#...#.....
.###.a.#.#.###.#######.#.#######.
.....#.#.#...#.......#.#.........
.#####.#.###.#.###.###.#########.
.....#.#.#...#...#.#...#.#.....#.
.#####.###.#####.#.#.##A.#.###.#.
.#...b.#...#...#.#.#.#...#.#.#...
.#.#Q#.#.#B###.#.#.#.###.#.#.####
.#.#.r.#.....#...#.#..B#...#.....
.#.#.#######.#####.###.#.###.#.#.
.#.#.#.............#.#.#.q.#.#.#.
.#.#.#.#######a###.#.#.#.#.T.#.##
.#.#.#...#.......#...#.#.#...#...
.#.#####.#.#####.#a###.c.#######.
.#.......#...#.#...#!#.#.......#.
.###########.#.###.#.#.#######.#.
.....#.......#...#...#.#.....#.#.
#####T.#######.#######.#.#.R##.#.
.....#...#.............#.#.R...#.
.###.###.#.#####.#######.###.###.
...#.....#.....#.....#.#.....#...
##.##########A.#####.#.#.#######.
.#.#...#.....#.#.....#...#.......
.#.#.#.###.#.###.S####.#####.###.
.....#.....#.....#...........#...
33 33
.....#.......#...................
##.#.#.#.###.#.###########.######
...#.#.#.#...#.....#.....#.......
.#####.#.#.#######.###.#.#######.
.#.....#.#...#.....#...#@#.......
.#.#####.##B.#.#####.#R###.######
.#.#...#.#.#.#.......#.#...#.....
.#.#.###.#.#.#########.#.###.###.
.....#...#.#.......#...#.#...#...
######.###.#######.#####.#.###.##
.....#.#.....#.....#.....#!#.#.#.
.###.#.#.###.#.#####.#######.#.#.
.#.....#.#...#...#...#.......#...
.#######.t.#####.###.#.###.#Rq##.
.....#...#.#...#...#.....A.#.#...
.###.#.#####.#.###.#######.#.#.##
.#.#.#.......#.#...........#.S...
.#.#.###.#####.#.##########B####.
.#.#...#.#...#.#...#.....#...#...
.#.###.#.#.#.#.###.#.###.#.#.#.#B
.....#.#...#.#.t...#.#.#...#...#.
c###.s.#A#####.#.##c.#.#########.
.#...#.......#.....#.#...........
.#.#########.#.#####.#####.#####.
.#...#.....#.#...#...#...#.....#.
.#b#.####C.#.#####.###.#.#######.
...#...#...#.......#...#.......#.
.#####.#.###########.#.#######.#.
.#.....#...........#.#.......#.#.
.#.###########.###.#.#######.#.#.
.#.#.........#...#.....#...#.#...
.#.###.#####.###########.#.#.###.
.......#.................#...#...
