abcdefghijklmnopqrstuvwxyz-=[];/
ABCDEFGHIJKLMNOPQRSTUVWXYZ_+{}:?
OOOOOOOOOOOOOOOOCCCCCCCCCCCCCCCC
3
17 17
.........C...#...
.#.A########.#.#.
.#.#...#..c#.#.#.
##.#.#.#Q#.#.###.
t..#.#A..#.#.....
.#.#.#####b#####.
.#.#..@#a..#...#.
.###.###.###.#.#.
.....#...#...#...
#R##B#.###.######
..b#!..#.#...#...
.#.#####.###.#.#.
.#.....#...#.#.#.
.#####.#.#.#.#.#.
.#...#.#.#...#.#.
.#.#.###s#####.#.
t..#...........#.
17 17
.....#.......#...
.###.a.###.#.#.#.
...#.#T#C..#R#.#@
.#r###.#.###.#.b#
.#.....#.#...#T..
.#######.#.##R##.
.#...#...#.#.....
.#.#.#.###.#.###.
...#.#B..#S..#...
#######Q.#######.
.......#.......#.
.#####.#.#####.##
.B...#.#....s#...
.#.#.#.#####.###.
.#.#.#....!A...#.
.#.#.###########.
...#.............
17 17
.......#.......#.
.#####.#.#.###.#.
..@#...#.#...#.#.
.###.###.###.#.#.
.#...#...a.#.#...
.#.###.#####.###.
.#.#...#...#.#.B.
.#.#.###.#.#.#T##
.#...#...#.#.....
###A##.###.#.##A.
....!#...#.B...#.
.##R##.c.#.#####.
.#...#.#.#.....#.
.#.#r#.#.#####.#.
.#.#.#.#.....#...
qb.#.#######.###.
...#.........#...
