abcdefghijklmnopqrstuvwxyz-=[];/
ABCDEFGHIJKLMNOPQRSTUVWXYZ_+{}:?
OOOOOOOOOOOOOOOOCCCCCCCCCCCCCCCC
11
17 17
...#...#.........
.#.#.#.#######.##
.#.T.#..a#...#...
.#.#.###.#.#.###.
.#.#!#.#...#.....
.R.###.#r##r####.
.#...#.........#.
.#####.#####.###.
.#.....#...#.#...
.#.#####.#.#.#.##
.#...#...#...#...
.###.#.#####.C##.
...#.#.#.s.....#.
.###.#.#######.#.
.#...q.......#.#.
.#.####A####.###.
..........@#.....
17 17
.#...........#...
.#.#########.###.
.#.#.........#...
.#.#.b########.#.
...#.....#.....#.
.#######.#.###.#.
.#.....#.#.#...#.
.#.#####.#.#.####
.#.#!....#.#.....
.#.#######.#####.
.#...#.....#.....
.#.#.######C.###.
...#.#.....#..R#.
####.#.###.#.#.#.
...#.#.#@#.#R#.#s
.###.#.#.#.###.#.
.......#.......#.
17 17
...#.....#.......
.#t#####.#.#####.
.#a..#...#.#.....
.##R.#.###.#.###.
..r#...#...#.#...
.#.#####.###.####
.#.......#.r.....
.#########.#####.
.#.....#.....#...
.###.#.###.#.#.##
.....#.#...#.#!#.
#####r.#.###.###.
.Q.....#...#...#.
.#######.#.###.#.
.#...#..S#...#...
.#.#.####A##.###.
...#.........#@..
17 17
...........#.....
#T##.###.#.#.#.##
...#...#.#.#.#...
.#.###.#.###.###.
.a...#@#.....#.#.
.###.###.#####.#.
q#.....#.....S.#.
.#####.#b###.#S#.
b..#...#...#...#.
.#.##s.c.S.###.#.
.#...#...#...#.#.
.###.#######.##T.
.#...#.#...#.....
.#.###.#.#.#####.
.#.#.....#.......
##.#.##C#########
!..#....b......q.
17 17
..........q..#!#.
##.###.#######.#.
...#.r.#.......#.
.###.#.#.#######.
.#.....#...#...#.
.#T#######.#.#.#.
.#.......#.#.#.#.
.#######.#.#.#.#.
.#.....#@#...#...
.#.###.########R.
.#.#.#.....#...#.
.#.#.###.#.#.#.#.
...#...#.#.#.t...
.###.###.###.####
.#.R.#...#...R...
.###.#.###.#####.
....C#...........
17 17
.......#.C.......
.###.#.#.#.#####.
.#...#...#.#.#...
##.#####.#.c.#.s.
...#.....#...#.b.
.###########.#.##
.TB..........#...
.#.#############.
...#.........#.#.
.###.#####c#.#.#.
.R...#.........#.
.#.###.#######.#.
...#...#.....#.#.
####.###.###.###.
@#...#.b.T.....#.
.#.###.#.#####.#.
.......#....!#...
17 17
.......#.......#.
####.#.#.#####.#.
.....#.#...#.#.#.
.#########.#.b.#.
.........#!#.#.#.
.#####.#####.#.#.
.#.#...#.....#...
.#.#.###.###.###.
...#...#.#.#...#.
##.###.#.#.###.#.
...#...#.....#.#.
.###.#.#####.#.#.
.c...#.#...#.R...
.#.#r###.#.#.####
.#.#.....#...#..s
.#.#.########r##.
@#...............
17 17
...#.....#.....#.
.###.#.q##.#C#.#.
.....#...#.#...#.
.#######.#.#.###.
..s..#...#.#.#...
####.#.###.#.###.
...c.s.....#.#...
.###.#####.#.#.#.
.....#...#.#.#.#.
.#####.#.###.#.##
.....#!#.....#...
####.###########.
...#.....#.....#.
.#.#####.#.###.#.
.#@#...#..c#.#..C
.###.#.#c###.###.
.....#...........
17 17
.......#...#.....
.####q.#.#.#.###.
...#...#.#.#.#.#.
##.#####.#.#.#.#.
...#.....#.#.#.#A
.#C#.#####.#.#.#.
.#!..#...#.#.#.#.
.#####.#.#.#.C.#.
.......#.#...#...
.###.##S######.##
...#.#.......#.#.
##.#.#.#a#.#.#.T.
...#.#.#...#b#.t.
.###.#.#.#####.#.
...#...#...#...#.
##.#######.#.###.
@........#.......
17 17
...#...#.........
.#.###.#.#######.
.#...#.#.......#.
.###.#.####r##.#.
.#.....#.......#.
.S.##c##.#######.
.#.#.#...#.....#.
.#.#.#.###.#.###.
.#...#.....#@C...
.#######.#####.#.
.......#.#.....#.
.#####.C.#.######
...#.#...#.......
##.#.#########.#.
.#...#..!#...#.#.
.###.#.###.#.###.
...r.#.....#.....
17 17
.....#...........
.c#A##.#####.####
.#...#.#...#.....
.#.#.#.#.#.#A###.
.#.#.#.#@#.....#.
.#.#.#.####A.#.#.
...#.......#.#.#.
.#########.St#.#.
.#.....#...#.#.#.
##.###.#.###.#.#.
...#!#.#.....#.#.
.###.#.##B##.###.
.....#.#.....#...
######.#####.#.#.
.......#...#.#.#.
.####at#.#.###.#.
.........#.....#.
