abcdefghijklmnopqrstuvwxyz-=[];/
ABCDEFGHIJKLMNOPQRSTUVWXYZ_+{}:?
OOOOOOOOOOOOOOOOCCCCCCCCCCCCCCCC
3
17 17
..@#.t...#.......
.###.###.#######.
.......#s..#...#.
.#########.A.#.#.
...#.#...Q.#.#.A.
##.#.#.#q#.#.###.
.#...#!#.#.#...#.
.###.###.#b#.#.#.
...#.#.#.#.#.#.#.
.#.#.#.#.#.#.#.##
.#...#.#Q..#.#..R
.#####.#####.###.
.#.........#...#.
.#.#######.#####.
...#...#...#...#.
####.#.#.###.#.#S
.....#.......#...
17 17
.....#.......#...
.#####.#####.#.##
.#.....#@..#.#...
.#.#######.#.###.
.#!A.......#.....
.###.###########.
...#.....c.#...A.
.#.#.#####.#.####
.#...#.#...#...#.
.#####.#.#####.Q.
.....#.#..R#...q.
####.#.###.#.###.
...#C..#.#.#....r
.#####.#.#.#####.
.....#.#.#...q...
.#.###.#.###.#.##
.#.......S.#.....
17 17
.....#@.........T
.###.###.#######.
...#...#.#.....#.
C#.###.###.###.Q.
.#.#...#...#...#.
C#.#.###.b##.###.
...#.#...#.#.#...
.###.#.###.#.#.#.
...#...#.#...#.#.
##.#####.#.###.#.
...#...#...#...#.
.#####.#.#####.##
.a...#.#.#...#...
t###.#.#.#.#.###.
.#...#.#...#.....
.#.###.A########.
.#!#.........B...
