abcdefghijklmnopqrstuvwxyz-=[];/
ABCDEFGHIJKLMNOPQRSTUVWXYZ_+{}:?
OOOOOOOOOOOOOOOOCCCCCCCCCCCCCCCC
13
17 17
.........#.....#.
.##Q##.#.#.###.#.
.....#.#.#...#.#.
.#####.#####.#.#.
.#...#c#!....#.#.
.#.a.#.#######.#.
.#.#......B#.#...
.#.#######.#.###.
.#.......#....b#.
########.###A###.
.b.......#.......
.#########.######
.........#.#.....
.#######.#.#.#.##
.#.....#.#.#@#...
.###.#.#.#.#####.
.....#.#.........
17 17
....@#.......#...
.#####.#####.###.
.#..!#.#.....#...
.#.b##.#.#####.##
.#...#.#.....#...
.###.#.#####.#.#.
.#...#...#.#.#.#.
.#.#####.#.#.#.#.
.#...#...#...#.#.
.###.#.###.#####.
...#...#...#...R.
.#.#####.###.###.
.B.....#...#.#.#.
##.#.##a##.#.#.#.
...#.#...#...#...
.#b###.#.#####.##
.......#.........
17 17
.......#.........
######.#.####q##.
.....#...#.....A.
.###.#.#######.#.
!#.#.#.........#.
##.#.#########.#.
...#...#.....#.#.
.#####.#.###.#.#.
.....#...#.#.#.#.
.###.#####.#.###.
...#.......#...#.
##.#.###.#####.#.
...#...#.#....s#.
.#####.###.#####.
.#...#.#...#...#.
.#.#.#.#.###.#.#.
...a@#.......#...
17 17
.....#.....#.....
.#####.#.###.S##.
.s.....#...#.#...
.#.#b#####.#.#.#.
...#.....#...#.#.
.###.###.#####.#.
.#...#.t.......#.
.#.#############.
.#.#.......#.#...
##.#q#####.#.#.##
...#...#.#!#...#.
.#####.#.###.###.
.r.....#...#.#...
########.#.#.#.##
.......#.#.#.#...
.####t.#.#.#.###.
....@#...#.......
17 17
.#.....#@#...#...
.#.###.#.#.#.#.#.
...#...#...#...#.
.###.###.#######.
.#.#..!#.#.......
.#.#######.#####.
.....#...#.#.....
####.#.#.#.#.####
.#...#.#...#.#...
.q.###.#######.#.
...#...........#.
.#############.#.
...#.........#.#.
##.#.#######.#.#.
...r.#...#...#.#.
.###.#.###.#####.
.....#...........
17 17
.....#...#!....#.
.#####.#.##r##.#.
...A...#...#...#.
.#.b.###.#r#.###.
.#.#.#.#.#.#.#...
.#.#.#.#.#.#.###.
.r.....#.#.#...#.
.#######.#.###.#.
...#.....#.#...#.
##.#.#.###r#.s##.
...#.#.B.....#...
.###.###.####c.#.
...#...#.....#.#.
##.###.#####.#.##
@#.#...#...#.#...
.#.r.###.#.#.###.
...#.....#.......
17 17
...#....Q#.......
.#.#.###.#.#.###.
.#.#...q...#...#.
.#.###.#######.##
.#...#...#...#...
.###.###.###.###.
.#.....#.......#.
.#########b#.###.
.......#...#.#...
.#####.#.#.C.#.##
...#.#.#.#.#.#...
##.#.#.#.#.#.###.
@#.#.#...#.....#.
.#.#.###########.
.#...#.#!#.......
.###.#.#.#.#####.
.......#...#.....
17 17
.................
.###.###########.
.#.#...........#.
.#.###########.r.
.......#...#...#.
######.#.#.#.####
.....#.#.#.#.....
.#####.#.#.###q#.
.......#.#.......
.#######.###.####
.#.......#...#...
.#.#####.#####.#.
.#...#...#.....#.
.###.#.###.#####.
.#@#.#.#...#...#!
.#.#.###.#####.##
...#.............
17 17
.....#...........
##.#.#.###.#####.
...s.#.#...#...#@
.###.b##.#.#.#.##
S..R.....#.#.#..!
.#.#########.####
.#...#.......#...
.###.#.#######.##
.#...#...#...#...
.#.#.###.#.###.#.
.#.#...#.#.....#.
##a###.#.#.#####.
...#...#.#.....#.
.#######.#####.#.
...#.....#...#.#.
.#.#.#####.#.###.
.#.........#.....
17 17
..A#...........#.
.###.#####.###.#.
.....#.....t...#.
.#####.####C.###.
.#...#.#.a.#.#...
.#.###.#.#.#.###b
.#.#...#.#.......
.#.#.###########.
...#.#.........#.
##.#.#.#######.C.
C#.#.#.....#...#.
.#.#.#.S##S#.###.
...#...#...#...#.
.#######.#.###.##
.......#.s...#...
##.#####.###.###.
@..#!....#.......
17 17
.....#...t...#...
.#.###.#.###.#.T.
.#.#...#.#...#.#.
.###.###.####A.#.
.....#...#.....#.
######.#.#.#####.
...b...#.#.....#.
.#.#.#########.#.
.#.#.....#!....#.
.#.#####.#######.
.#......A..#.....
.###########.####
...........#.#...
.#########.#.#.#.
.T...#...#...#.#.
####.###.B######.
@................
17 17
.......C.#.......
.#######.#.#.####
...#.....#.#.....
.###.###.#.#####.
.#...#.#.#.#.....
##.###.#T#.#.###.
T..#.....#.#.#...
.###a#####.#.#B#.
.......#...#...#.
.#####.#.#####.#.
.#...#.......#.#.
.#.#.#########.##
..B#...#.#...#...
######.#T#.#.###.
@#.......#.#...#.
.#.#######.###.S.
.......#!..#.....
17 17
..@#.........#...
.###.#q#.###.###.
.....#...#.......
.#r###.#########.
.....#...#...#...
.#######.#.#.###.
.#.....#.#.#...#.
##.###.#.#.###.#.
...#...#...#...#.
.###.###.###.###.
...#.#...#...#.#.
#S.#.#####.###.#.
...#.....#.c...#.
.#######.#.#.#.#.
.....#.#...#.#...
.###.#.#####.####
.#!..#...........
