abcdefghijklmnopqrstuvwxyz-=[];/
ABCDEFGHIJKLMNOPQRSTUVWXYZ_+{}:?
OOOOOOOOOOOOOOOOCCCCCCCCCCCCCCCC
7
21 21
.......#.........#...
.#.###.#.#####.#.#.#.
.#.#.#.#.#...#.#...#.
.#.#.#.#.#.#.#.#####.
.a.s.#.#.#.#...#...#.
##.#.#.###.###q#.###.
...#.....#...#.....#.
.#######.#.#.#.###.#.
.....#.#.#.#.#.#A#...
.###.#.#.###.#.#.####
.#...S.#.....#.#.....
##.###.#######.b.###.
...#!#.#.....#.#...#.
.###.#.#.###.#.#####.
.....#.#.#.#...#...#.
##a###.#.#.##s##.#.#.
.......#.R...#...#.#.
.#####.#.#.#.###.#.#.
.#@#...#R..#.....#...
.#.#.###############.
...#.................
21 21
...#...#..Q......#...
.#.###.#.#######.###.
.#.....#.#.......#...
.#####.#.#.#######.#.
.....#.#.#...#...#.#.
.###.###.###.#.#.#.##
.#.#.......#...#.#...
.#.#######S#####.#.#.
.s...#...#.......#.#.
.#.###.#.#.#########.
.#.#...#.#.....#.....
.#.#.###.#####.#.###.
.#.#...#.#..!#.#...#@
.#.###.#.#.#B#.#.#.##
.#.....#.#.#...#.#...
.#.#####.#.#.r######.
.#.#.....#...#.......
.#.#.###.###s#.#####.
.S.#.#...#.....#.#...
.###.#.#####.###.#.##
.....#.......#.......
21 21
...........#.....#...
.#.###r#.###.#.#.###.
.#.....#.#...#.#.....
######.#.#.###.#####.
.....#.#.#.#.#.#.....
.R##.#.#.#.#b#.######
.#.....#.#.q.#......!
.#######.###.########
...#.T.#...#.......#.
##.#.#.#.########r.#.
...#.#.#.#.......#.#.
.###.###.#.#.#####.#.
...#.....#.#.....#...
##.#.#####.#####.###.
...#...#@#.#...#.....
.#####.#.#.#.######c#
.#...#...#.R.........
.#.#.#####.#.###.###.
.#.#...#...#...#.#.#A
.#.###.#.#######.#.#.
.....#...........#...
21 21
.#.......#...#...#.c.
.#.#.###.###.#.#.###.
...#...#.....#.#!#...
.#####.###.###.###.#.
.#...#.#...#...#...#.
.#.#.#.#.###.#S#.###.
.#.#...#.#...#...#...
##.#####.#.###.###.##
...T.....#.#...#.#...
.#####.###.###.#.###.
.....#...#.....#...#.
.###.###.#######.#.#.
.#...#...#.......T...
.#.#.#####.#T########
@#s#.#..c..B.......#.
##.###.#######.###.#.
...#...#a......#...#.
.###.###.#.#####.###.
.#...#..Q#.#...#.....
.#.####Q##.#t#.#####.
..B........#.#.......
21 21
...#.....#.........#.
.#.#####.#.#.#####.#.
.#.....#...#...#...#.
.#####.#.#####.#.###.
.#..@#.#.#...#.#.#...
.#.###.b.#.###.#.###.
.t.#...#.#.#...#.....
.###.###.#.#.#######B
.#...#.#.#.#.#.Q.#...
.#.###.#.#.#.#.#.#.##
.#.#.#...#.#...#.#...
.#.#.#.###.#####.####
B#!#...........#.....
.###########Q#.#####.
.#.......#...#.....#.
.###.###.#.#.#######.
...#.#...#.#.#.......
##.#.#.###.#.#.#####.
.#.#.#.#...#...#.....
.#s#.#.r##.####b.####
.....#.....#....c....
21 21
...r.............#...
.###.#.#########.#.#.
...#c#.....#...#.b.#.
.#.#.#####r#.#.#.#.#.
.#.#.#.#...#@#.....#.
.#.#.#.#.######R####.
.#.#.#.#C..........#.
##.#.#.###########.##
...#.....#.....#.#...
.#######.###.#.#.Q##.
.......#...#.#.#...#.
.#.#######.#.#.#.###.
.#.#......aT.#...#...
.#.A.####R##.###.#.#.
.#..C#...#.#...#Q#.#.
.#####.#.#.#.#.###.#.
.#.....#.#...#...#.#.
Q#####.#.#######.#.##
.....#.#...S.....#...
####.#.###.#.#.#####.
.......#.....#.#!...a
21 21
...#...#.....#.....#.
.#.#.#b###.#.###.#.#.
.#...#.....#.....#.#.
.#####r##########T.#.
...........#.........
.#########.#.########
...#..sb...#T....#...
##.#.###.#.#######.#.
.#...#b..#.#.......#.
.###.a.#####.#######.
.....#.#.A...#...#!..
.####t.#.#####.#.#C##
.#.#...#...#...#.....
.#.#.#####.#.#######.
...#.......#.#...#...
##.#########.#.#.###.
.#.#C......#..S#...#.
.#.#####.#.#.#####.#.
...#...#@#...#.....#.
.##T.#.#######.#####B
.....#.........#.....
