abcdefghijklmnopqrstuvwxyz-=[];/
ABCDEFGHIJKLMNOPQRSTUVWXYZ_+{}:?
OOOOOOOOOOOOOOOOCCCCCCCCCCCCCCCC
7
25 25
.......#.....#...#.......
##R#.#.#.###.#.#.#.#.####
.....#...#...#.#.#.#.....
.#########.###.#.#.#####.
.#.......#.....#.#.....#.
.#.#.#######.#########.#.
.#.#.......#.#.....#...#.
.###.#####.#.#.#.#.#.###.
...#.#...#...#.#.#.#.#...
##.#.#.#.#.#Q#.#.#.#.#.#.
...#.#.#.#.#...#.#.#.#.#.
.#####.#.###.##B.###.#.#.
.....#.#......@b.....R.#.
.C##.#.#############.#c##
...#...#...........#.c...
##.#####.####Sc###.#.###.
.#.#.....#.......#.#...#.
.#.#.###B#.###.B##.###.#.
.#.#.#.......#.s...#.#.q.
.#.#a#########.#.###.#.#.
...#.#.......b.#.#.....#.
.###.#.#####.#.#.#R####b.
.#.#.#.#.#!..#...#.......
.#.#.#.#.#####.s##.#####.
...#...c...........#.....
25 25
...#...#.....t.....#.....
.#.#.#.#.##R.#.C##.###.#.
.#...#...#...#...#...#.#.
.t########.#####.###.#.#.
.#.....#.....#...ab#...#.
.#.###.##a##.#.###.#####.
.#..!#...#R..#.#.......#.
.#####S#.###C#.q.#B#.###.
.....#...#...#.#.#..T#...
##.#.#.###.#.#.###.#.#.##
...#.#.....c.#.#...A.#...
.###.#######.#.#.###.###.
.#...#.....#...#.#.....A.
.###.#.###.#####.#######.
...#.#.#.#.#@....#.......
##.#.#.#.#.#C###.#.######
...#...#.#.#...#.#.#.....
.#######.#.#.#.#.#.###.#.
...#.....#...#...#.#...T.
##.#.###########.#.#.###.
...#...#.........#.#.#...
.#a#q#.#.#########.#.###.
.....#...#.......#.#...#.
.##T.#####.#####.#.###.#.
...#...q.......#.......#.
25 25
.......#.......#...#@....
q#.###.###a#.#.#.#.###.##
...#.#.......#...#...#...
.###.#####.#########.###.
.#.......#.#.......#...#.
.###.#.###.A.#####.###.#.
...#.#.....#...#.#...#...
##.###########.#.###.###.
...#.........#...#.#.r.#.
.###.#######.###.#.#.#.#.
.......#..r..a.#...#.#...
######.#.###.#.r##.#.####
...#...#...#...#...#.#...
.#.R##.###.#####.###.#.#.
.#...#...T.......#.#.#.#.
.#T#.#####c#####.#.#.#.#.
.b...#.........#.Q.#...#.
.#.###.#######.###.#####.
!#...#.....#.#...A.#.....
#c##.#.###.#.###.###.###.
.#...#.#...#...#.....#.#.
b#.#####.#Q#.#########.#.
.#.#.....#.#...B.......#.
.#.#.#####.#.#.#s#####.#.
.....#.......#.......#...
25 25
.....#.........#.......#.
.###.#.###.#####.#.###.#S
...#.#...#.....#.#.#.#.#.
##.#.#####.###.#.#.#.#.#.
...#.....#...#...#.#...#.
.#######.#########.#.###.
.....#.#...........#...#.
####.#.###b###########.#.
.....#...................
.###T#.#########q###.###A
.#.....t...........#.#...
.###.###.#c#.#####.###.#.
...#.#@#.#!#.....#...#.#.
C#.#.#.#.#.#######.#.#.#.
.#.#.#.#.#.......#.#...#.
##.#.#.#.######q.#.#####.
...#...#.....#.#.#.....#.
.###########.#.#.#T#####.
.#.........#...#.#.#.....
.#.#####.#.###.t.#.#.####
...#...#.#...#.#.#.#.#...
.###.#.#.#####.#.###.#.#.
...S.#.#.#.....#...#...#.
##.###.#.#.#######.#####.
.......#.........#.......
25 25
...................#...#A
.#####.#####.#####s#.#.#.
.#.....#.....#.....#.#...
T#.#####.#####.###.#.###.
...#...#.....T...#.#..!#.
.###.#.#####.###.#.#####.
...#.#.....#...#.#...#...
.#.#.#####.###.#.#.###.##
.#...#...#...#.#Ba...#...
.#######.###.#.#.###.A##.
.#...#.....#.#.#.#R#.....
.#.#.#.###.#.###.#.######
...#.#.#...#.....#.#.....
A###s#.###.#######.#.#.##
.....#...#..q#...#...#...
.##S####.#####.#.#a#Q###.
......t#.#.....#...#...#.
######.#.#.#######.#.#.S.
.....#.#.#...#...#...#.#.
.#.###.#.###.#.#.#.#####.
.#...#.#.....#.#.#.#.....
.###.#.#######.#.##b.###.
.#@#.#.....#...#...#...#.
.#.#.r####.#.#s###.###.#.
...#.........#.........#.
25 25
.......#.............#...
.#####.#####.#.#####.###.
.#.........#.#.#...#.#...
.#.#######.###.C##.#.#.#.
.#.#.....#...#.#...#.#.#.
.#.#.###.###.#.#.###.#.##
.#.#.#...#.....#.....#..R
.#.#.#.#q#######.#######.
.#.#.#.....#...b.....#...
.#.#.####c.#.#######.#.#.
.A.#.#...#!#......C..#.#.
.###.#.#####.##c######.#.
...#.#.....#.#.....r...#.
##.#.#.#.###.#.###.###.##
..A#.#.#.....#.#@#...#...
.###.#.#######.#.###.###.
.#...#.#.......#.#...#...
.#.###.#######.#.#.###.#.
.#.#...........#.#.....#.
.#.##Q#Q########.#######.
.#...#.............#...#.
.###.###.#########.#.#.#.
.....#...#.......#.#.#...
b#####.###.#####.###.####
...............#.........
25 25
.....#.........#.........
.#.T##.#.#####.#.#####.#.
.#.....#...#...#.#...#.#.
.######t##.#####.#.#.#.#.
.#..c....#...#...#.#.#.#.
.###.#######.#.##C.#.#.##
.....#.....#.Q.#...#.#...
####.#.###.#.#.##A.#.###.
...#.#..!#.#.#...#.#...#.
#b.#.#####.#.###.#.###.#.
...#...#@#.#.......#...#.
.#####.#.#.######sC#####.
...#...a.#.............#.
#t.r.###.#######c#####.#.
...#...#.#.......#...#.#.
.#####.#.#.###.#.#.###.#.
.....#.#.....#.#.#B..#...
####.#.##B#s.#.#.###.####
.....r.#...t.#.#....Q....
.###.#.#.#.#.#.#########.
...#.#...#.#.#...#..t....
.#.####A##.#.###.#####.##
.#.....#...#...#.....#.#.
.###.###.###########.#C#.
...#.................#...
