abcdefghijklmnopqrstuvwxyz-=[];/
ABCDEFGHIJKLMNOPQRSTUVWXYZ_+{}:?
OOOOOOOOOOOOOOOOCCCCCCCCCCCCCCCC
3
17 17
.....#...t.....#.
.###.#R#####.#.#.
.#...#.#...#.#...
##.#.#.###.#.####
...#T#.#...#.....
.###.#S#.#.#####.
.#...#...#.#@#...
.#.##s#r##.#.#.##
.#.......#...#...
.###Q###.s##.###.
.....#.....#.#...
####.#.#####.#.##
.....#.#.....#.b.
Q#######.C######.
.......#.#...#.a.
.#####.#.###.#.#.
.....#.......#!#.
17 17
.......#.........
q##R####.c######.
...#.....#.......
r#.#.###c#.###R##
.#...#...#!#...#.
.#######.###.#.#.
.#.......#...#...
.#.#####.#.#.###.
.#.#...#.c.#.#.#.
.#.#.#.#.###.#.#.
.#.#.#.#.....#...
.#.###.#######c##
.#.#...#.......#@
.#.r.#.#.#Q#####.
...#.#.#...#.....
####.#####.###.#.
t............T.#.
17 17
........A#...#...
.#######.#.#.###.
.......#...#...#.
######.#######.#.
.....#...#s..#.#.
.#.#.###.#.#.#.#.
b#.#.#@#!#.#...C.
##.#.b.###.#####.
...#.#.#...#.....
.###C#.#B###.###.
.#.#.#.#...#.#...
.#.#.#.###.#.#.##
.#.#.#.#Q..#.#...
.#.#.S.#.#######.
.#.....#...#.....
.#########.#.###.
.............#...
