abcdefghijklmnopqrstuvwxyz-=[];/
ABCDEFGHIJKLMNOPQRSTUVWXYZ_+{}:?
OOOOOOOOOOOOOOOOCCCCCCCCCCCCCCCC
11
17 17
.#...#.........#.
.#.#a###.####a.#.
.#.#...#.....#...
.#.###.#####.###.
.#..!#.......#.#.
.#########B###.#.
.............#...
.###T#####.#.#.##
...#@..#...#.#.#.
##.###.#.#####.#.
.#.#...#.....#.#.
.#.#.#######.#.#.
...#.......#.#.#.
.###.###.#.#.#.#.
...#.#...#.#.#...
##.###.###.#.###.
.......#...#.....
17 17
.R............q..
.#.#####.#######.
.#.#.#...#.....#.
.#.#.#.###.###.#.
.....#.......#.#.
.###########.#.#.
.#.........#.#.#.
##.#######.#.#.##
...#.....c!#.#...
.###.###.###.###.
...#...#...#.#...
##.#.#.###.#.#.#.
...#.#.#.#c#.#R#.
.#####.#.#.#.#.#.
.#.....#.#.#@#.#.
.#.#####.#.###.#.
...#...t.......#.
17 17
...a.....#.......
.#.#.#q#.#####.B.
.#.#.#.#.S...#.#q
b#.#.#.#.#.#.###.
.#...#...#.#.....
.#####.###.#####.
...#.#.#...#@....
##.#.#.#.#.#####.
.#.#...#.#.....#.
.#.#.#########.#.
.A.#.........#.#.
.#.#########.#.##
.#.....#.#...#...
.#####.#.#.#####.
.....#!#...#...#.
A#######.###.#.#.
.............#...
17 17
............t....
.#####.##########
.#...#...#......!
.#.#.###.#.######
.#.#.....#.....#.
.#.#####.#####.#.
.#.#@......#.#...
##.#######.#.###.
...#...#.....c...
.#.#.#.#######.##
.#.#.#.........#.
.###.#R####b#r##.
.#...#.........#.
.#.#####.###.#.#.
.#.#...#.#...#.#.
.#.#.#.###.###.#.
.....#.....#.....
17 17
.....#......T....
.###.#######.###.
...#B........#.#.
.#.###B###a###.#.
.#.......#...#...
#####b##.#.#.#.##
.......#.a@#.....
.####T.#.########
...#.#...#.......
.#.#.###.#.###B#.
.#.#.....#.#.....
.#.###.###.#####.
.#...#.#...#..!#.
.###.#.#.###.###.
.#...#.#.....#...
.#.###########.##
.#...............
17 17
.......#.........
######.#.#######.
....!#.#.#...#...
.#####.#.#.#.#.#.
...#.....#.#.#.#.
##.#.#####.#.#.#.
...#...#...t.#.#a
.#####.#.#####.#.
...#.#.#.#.....#.
##.#.#.#.#.B####.
...#.....#.....#.
.#######.S####.#.
.#.....s.#..@#.#.
.#.###.b.C.###.#.
.#...#.#...#...#.
.###.#.#####.###.
.....#.......#...
17 17
...#.............
.#.#######.#####.
.#.......#...#.#.
.#######.#.#.#.#.
...#.#...#.#.#...
.c.#.#.###a#.####
.#.#...#.c.t.#...
.#.#.##Q##T#.#.#.
.#.#.#.....#...#.
##.#.###.#.#.###.
...#.....#.#...#.
.#########.###.#.
..!#...#...#...T.
####.#.#.#######.
.....#.#.#.....#.
.#####.#.##Q.#.#.
....@#.......#...
17 17
.........#.....#.
.#.R####.#.###.#.
.#.#...#...#...#.
.#.#.#.#####.###.
.#...#.....#.#.rS
##r#####.#.#.###.
.......b.#.#.#...
.#####.###.#.#.#.
.....#.#...#...#.
.##t.#.#.####Q##.
...#.#.#s....#...
##.#.#.#####.#.##
@..#.#.....#.a...
####.#####.#.###.
...#.#...#...#...
.#.#.#.#######.##
!#...#...........
17 17
.....#.......#...
.#.#.#.#s###.#r#.
.#.#.#.#.#.#.....
.#.#.s##.#.#####.
.#.#.....#.#.....
.#.#######.#.####
.#...#.......#...
.t##.#.q########.
..@c.#.........#.
####.###.#####.#r
.....#.#.#..!#...
.#####.#.#.#####.
...#.....#.#.....
##.#######.###.##
...#.....#...#...
.###.###.###.Q##.
.......#.....#...
17 17
.....#...#@......
##.#.#.#.####Q.#.
...#...#.....#.#C
.###########.###.
...#...#...#.....
.#.#.#.#.#.#####.
.#.#.#...#.....#.
.#.#.T########.#.
.#.....#...#...#.
########.#.#.q###
...#.....#.#..Q..
.#.#.#####.#####.
.#.a.#...#...#...
.#.#.#.#####.#.##
!#...#...#...#...
######.#.#.#####.
.......#..r......
17 17
.#.......#.......
.#.#####.#####.#.
.#...#...#...#.#.
.###.#.###.#.#.#.
...#.#...#.#...#.
##.#.###.#.#####.
...#!#.#.#.#.....
.#####.#q#.###.##
.........#...#..@
.#########.#.####
.........#.#.....
########.##t##t#.
.......#.....#...
.#.###.#####.#.#.
.#...#.r.....#.#a
.###.###.##t##.#.
q..#...........#.
