abcdefghijklmnopqrstuvwxyz-=[];/
ABCDEFGHIJKLMNOPQRSTUVWXYZ_+{}:?
OOOOOOOOOOOOOOOOCCCCCCCCCCCCCCCC
7
17 17
.....#.......#..d
.###.#####.#.#.##
.#...#.....#.#...
.###.#.##R##.###.
...#...#.....#...
##.####S.#####.#.
...#...#.......#.
.###.u.####C####.
.....#.......#...
####.####S.a.###.
...#.#...#.#...#.
.#.###.#.#.###.#.
.#.....#.#...#.#.
.#####R#.#.###.u.
.#.......#.#...#.
.#.##r##T###.##R.
!#.r.........#@..
17 17
.......#!..#.....
.#####.###.#.#.##
.#...#...#.#.#...
.#.#.###.#.#.###.
...#.#...#.#.#.#.
.###.#####.#.#.#.
...#.A.....#...#.
##.#########.###.
@#.....#.....#...
.#####.#.#####.#.
.....#.#.....#.#.
####.#.######b.#.
.....#.........#.
.###.##########r.
.#.....#....c..#.
.#######C###.###.
...........#.....
17 17
.....#...#...#...
##.#.#.#.#.#.#.#.
...#.#.#...#...#.
.###.#.#########.
...#.#.#.#..U....
##.#.#.#.U.######
...B.#S#.#.#.....
.###.#.#.#.###c#.
...#...b.#.#...#.
.#.#####.#.#.####
.D.#@....#...#..!
.#.###.#.#.###.##
.#...#.#...#a..#.
.###.#######.###.
.#.#.#.......#...
.d.#.#.#######.#.
...#...........#.
17 17
.....#...........
##.#.#######.###.
...#...#...#.#.#.
.#####.#.#.#.#.#.
.....#...#...#Q..
####.#########.##
...#...#.A...#...
.#.###.#.###.###B
.#...#!#...#...#.
##.#.#####.#####.
...#.#@..c.#...A.
.###.###.#.#.#.#.
.#...D...#.#.#.#.
.#########.#.#.#.
.........#.#.#.#.
.#######.###.#.#.
.......#.....#...
17 17
.......#.....#...
.###.#.###.#.#Q#.
.#...#.....#...#.
.#.###########.#.
.#.....#.......#.
.#####.#####.###.
...A...#..!#...#.
####.#.#.#####.#.
...#.#.#.....#...
.#.#.#######.R##.
.#...#.....#.#...
.###b#.###.#.#.##
......q#.#...#...
#B######C#######.
...R.......#...#.
.U##.#####.#.#.#.
........@#...#u..
17 17
.......#.....#...
##.###.#.###.R.#.
...#.#.#...#...#.
.###.#.#.#####.#.
...#.#.#@#...#.#.
.#.#.#.###.#.###.
.#.#.Sb..#.#.....
.#.#.###.#.###d#.
.#.#...#.#..T#...
##.#.#c#.#.#.###.
!..#.#.#.#.#...#.
####.#.#.#.###.##
.....#.#.#...#...
.#t###.#.#####.#.
.#.#...#.....#.#.
.#.#.#######.###.
...#........t....
17 17
.........#.....s.
#q####.###.#####.
.....#.....#.#...
.###.###.###.#.#.
.#.#...#.....U.#.
.#.###.#######.#.
.#...#.........#.
.#.#.###########.
.b.#.#.#.....#...
.#.#.#.#.#.#.#R#B
.#.#...#.#.#u#.#.
.#.#####.#.###.#.
!#.......#.#...#.
##.A######.#.###.
.#.....#@#.#.#...
.#####.#.#.#.##q.
.........#.......
