abcdefghijklmnopqrstuvwxyz-=[];/
ABCDEFGHIJKLMNOPQRSTUVWXYZ_+{}:?
OOOOOOOOOOOOOOOOCCCCCCCCCCCCCCCC
15
17 17
...#.....#..!#...
r#.#.###.#.###.#.
...#...#...#...#.
.#####.r#t####.#.
...#...#.......#.
.#.#.###.#######.
.#.#.....#.......
##.#######.###C##
...#.....#...#...
.###.###.###.#.#.
.#...#.#...#.#.#.
.#.###.#.S##.###.
.#.#...#...#...#.
.#.###.###.###.#.
...C...#@#.....#.
.###.#.#.#######.
.....#...........
17 17
.........#...#...
.###.###.#.#.#.#.
...#.#.....#...#.
##.#.###########.
...#.....#.....#.
###b##A#.#.###.#.
.....#.#.#..@#...
.###.###.########
...#.....#!..#...
.#.#.#######.#.#.
.#.#.#.....#...#.
.#.###.###.#####.
.R...#...#.#.....
####.###.#.#.####
.......#.#.#.....
.#######.#.#####.
.........#.......
17 17
.............#...
.#########.#.#.#.
.#...#.....#...#.
.###.#.#########.
.....#...C.....#.
####.###.#.#####.
..@#.#...#.......
.###.#.###T###.##
...#.a.......#...
.#.#.#######.####
.#.........#.....
.###############.
.....#.........#.
####.#.#.#####.#.
...#.C.#.#!#.#.#.
.###.#.###.#.#.#.
.....#.....#.....
17 17
...#...........#.
.###.###c#.###.#.
.....#@..#.#...#.
.#######.#.#.##b.
.......#.#.#.....
.###t#.#.#.#####.
.#..!#...#.#...#.
##.###C###.###.#.
...#.....#.#...#.
.###.###.#.#.#.#.
.#.....#...#.#.#.
.#####.##q##.#.#.
.......#.....#.#.
########.###.#.#.
.#.......#.#.#.#.
.#.#######.#.###.
...........#.....
17 17
.#.......#@s.....
.#.###.#.#.#.###.
.#.#...#...#.#...
.#.#.#######.#.#.
...#B..#..A#.#.#.
.#####.#.#.#.#.#.
...#.#...#...#.#.
##.#.#########.#.
.........#...#.#.
.#######.#.#s#.#.
.#.....#.#.#...#.
.#.###.###.######
.#.#.#.....#...q.
.#.#.#.#####.###.
.#.#...#.....#!#.
.#.#####.#####.#.
.#...........#...
17 17
.#...#.......#...
.#.#.#.#####.#.#b
...#C#.#.....#.#.
####.#.###.##s.#.
.....#...#.#...#.
.###.###.#.q.###.
...#.#.#.#...#...
.#.#.#.#.#####.##
.#.#...#.....#.#.
.#.###.#####.#.#.
.#.#...#...#.#...
.#.#.###.#.#.###.
.#.#.....#.#!#...
.#.#######.r##.##
.#.....#@....#...
.#####.#########.
.....#...........
17 17
.........#.......
.#####.#.#.###.#.
.#...#.#.#@#...#.
##.#.#.#.###.####
...#.#.#...#....S
.###.#.A##.##q##.
.#.....#.T.......
.#######.#######.
.......#.....#...
.#####.#####.#.S#
.#.....#.....#...
.#.#####.#######.
.#.....#.#.......
a#####.T.#.######
..!#...#...#.....
.###.###.#####.#.
.....#.........#.
17 17
...#.....R.......
.#.#.#####.#Q####
.#...c.....#.....
.#####.###.#.###.
.#.b...#...#.#...
.#.#.#####B#.#.##
...#.........#...
##.###########T#.
.#.....#...#.....
.#####.#.#.#.###.
.....#...#.#.#...
.####q####.#.#.##
...s.......#.#...
.###########r###.
.#.......#.#.#@#.
.###.###.#.#.#.#.
.....#.....#!#...
17 17
.........#.......
.#######.###.###.
...#.........#...
.#.#.#########.##
.#.#@#...#.......
.#.###.#.#######.
.#...#.#.....#...
####.#.#####.###.
.....#.#...#...#.
.#s###.#.#####.#.
.#.......#...#.#.
.#.R######.B.#.#.
c#.....#...#...#.
.#####.#.###.####
.......#.#...#...
.t######.#####.#.
.......#.......#!
17 17
.#.....#Q........
.#.###.#.#.######
.#...#...#...#...
.###.#######.#.#.
...#.#!....#...#.
#r.#.#####.#####.
...#...#.#.......
.#####.#.####a###
.....#.#.........
.###.#.#####.###.
.#...#.#...#.#...
.#.###.#.#.#.#.##
.#...#...#...#.#.
.###.#########.#.
...#..R#.....r.#.
Q#.###.#.#.##s.#.
....@#...#.......
17 17
.....A.#.....#...
.#B###a#.t##.#.#.
.#.t.......#...#.
.R##.###########.
.....#...#......a
.#####.#.#.#####.
.#.a...#.#.....#.
.#######.#####.##
.#...........#...
.#.###T###.#####.
...#...#...#!..#.
####.#.#.#####.#.
...#.#.#.....#...
.#.#.#.#####.####
.#@#.#.#.....#...
.###.#.#.#######.
.....#...........
17 17
..s#.........#...
##.#.#######.###.
S..#.#.....#...#.
.#.#.#####.###.#.
.#.#.....#.#...#.
.#######.#.#.###.
.......#!#.#.#...
.###.#.a##.#.#.#.
.#...#.#.#...#.#.
.#.###.#.Q.###.#.
.#.#.#...#.#...#@
.#.#.###.#.###.##
.#.#.#...#...#...
##.#.#.#####.###.
...#...#...#...#.
.###r###.#.###.#.
.........#b......
17 17
.....#.....#.....
##.#.#.#####.#.##
...#...#...#.#...
.#######.#.#.###.
...#.....#...#...
.#.#.########t.##
.#...#.#.....#...
.#Q###.a.###.###.
.....#...#...#...
####.#.###.#.#.##
.#...C...#.#.#...
.#.#####.#.#.###.
.#.....#.#.#...#!
.#####.###.###.##
.....#.#...#.#.#@
.###.#.#.###.#.#.
...#.....#.......
17 17
...#.........#...
.#.#####.##T.#.#.
.#.....#.#.#.#.#.
.#####.#.#.#.#.#.
...#.#.#.#.#...#.
.#.#.#.#.#.#####.
.#.#.....#...#...
.#.#######.#.#.##
.#.....#@#.#...#.
######.#.#.Br###.
.....#.#.#...#...
.###.#.#.###.###.
...#.#.#...#.#...
##.#.#.###.#.#.#.
!..#...#...#...#.
########T#######.
.................
17 17
.............#...
.###########.#.#.
.#.#.....C...#.#.
.#.#.###.#.###.##
.#.#...#.#.#.....
.#.###.#.#.#####.
.#.....#.#...#...
.###.###.###.C.#.
...#.#.#...#...#.
.#.q.#.###.#####t
.#.#.#...#.......
##.#.###.########
...#.........#...
.###########.#.##
.....#..!#.#.#...
.###.#.###.#.###.
...#...#@........
