abcdefghijklmnopqrstuvwxyz-=[];/
ABCDEFGHIJKLMNOPQRSTUVWXYZ_+{}:?
OOOOOOOOOOOOOOOOCCCCCCCCCCCCCCCC
7
17 17
.............#...
########.###.#.#.
.......#.#@#...#.
.#####.#.#.T####.
...#.#.#...#...#.
##.#.#.##u##b#.#.
.#...#.......#.#.
.###.#########.#.
.....#!..#.....#.
.cS#####.#.#####.
.#....QT.#.....#.
.#####.#.#####.#.
.#...#.#.......#.
.#.#.#.#########.
...#...#...#.....
t#####.#.#.###.#.
.........#.....#.
17 17
.......#.........
.#####.#.#######.
.#.......#...#...
.#######.#.U.####
.....#@..#.#.....
.###.#####.#####.
.#...#.....#...Q.
.#.#.#.###.#.#.#.
.#.#.#.C...#.#.#.
##.R.#.###.#.#.#.
...#.#...#.#.#.#.
.##d####.###.#.#.
.......#.....#.#.
.###.#########.#.
.#.#...#.....#!#.
.#D###.#.#.#####.
.....#.A.#.......
17 17
...........#.....
.#.#######.#.#s#.
.#.....#...#.T.#.
####u#.#.###.#.R.
!..#r..#...#.#.#.
##.#.a####.###.#.
...#.#...#.#...#.
.###.#.#.#.#.###.
.#...#.#...#...#.
.#.###.#######.#.
.b.#...#.......#@
.#.#.###.###.####
...#.#.....#.....
####.###########.
...#d....#.....#.
.#.#####.#.###.#.
.#.........#.....
17 17
...#...#...q.....
.###.#.#########.
.#!..#...#...#...
.#######.r.#.#.#.
..B#...R...#.#.#.
.#.#.#.#####.#c#.
.#...#...#...#.#.
.#####.###.###.##
...#.t...#.#..C..
##.#.###.#.###.#.
.#.....#.#...#.#.
.###.###.d##.###.
.#...#.....#.....
.#.###.#.#A#####.
...#@#.#.#.....#.
.##T.#.T##.###.#.
.....#.......#...
17 17
........s..#.....
.#.#######.#.s##.
.#...#...#.#.#.#.
###D.U.###.#.#.#.
..q#.#S#...#.#...
.#.#.#.#.###.#.##
.#...#.c...#.#...
.#####.###.#.###.
.#.......t.u.#.#.
.###.#.#######.#.
.#!#.#.#.....#...
.#.#.#.#.#.#.#.##
...#.#...#.#.#.#.
####.a#D##.###.#.
.....#@..#.....#.
.####t##.d######.
.................
17 17
.................
.###.#.#########.
.#.#.#.#...#@..#.
.#.#.###.#.###.#.
...#.#...#...#.#.
####.#.####c.#.#.
..R..#a..#...#...
.####B##.TA#.####
.......#..!#.....
.#####.#########.
...#.t.#...#...#.
##.#.#.#.#.#.#.#.
.#...#...#.#.#...
.###.#####.#.####
.#...#...#.#.....
.#.###.#.#.#####.
.......#.#c......
17 17
!..#.........#...
#D.###.#####.#.#.
.#.#...#...#...#.
.#.u.####t.#####.
.#.#.#.D...#@#...
.#.#.#.###.d.#.##
.#...#...#.#.#.#.
.d######.#.#.#.#.
...#.....#...#.t.
.#.S##.#####.###.
.#C....#..U....#.
.#########.#####.
.........#.#.....
.#######.###.####
...#...#.#...#...
##.###.#.#.###.#.
.......#.......#.
