abcdefghijklmnopqrstuvwxyz-=[];/
ABCDEFGHIJKLMNOPQRSTUVWXYZ_+{}:?
OOOOOOOOOOOOOOOOCCCCCCCCCCCCCCCC
7
17 17
.#.....#.....#...
.#s###.#.#.###.#.
.#.#.#...#...#.#!
.#.#.#######.#.e#
d..#.......#.#.#.
.###.#####.#.#.#.
...#.....#.#.#Q..
C#.#.###.#.#.###a
...#.#...#.#...#.
.#####.#d#.#.###.
.......#...#.#...
########.###.#.##
.....#...#.#...#@
.#.###.###.#####.
.#.#...#..UB...#.
.#.#.###.#.#.#.#.
.#.......#...#...
17 17
...V.f...#.......
.###.#.###.###.#.
.#...A.......#.#.
.#.###v#######.#.
.#.#.......e...#.
.#.#.###.###.###c
...#.#..V#...C...
.###.#####.###.##
.t.#...#...q...#.
.#.#.w.#.###.###.
.#...#.#...#.#...
.#####.###.#.#.#.
.#.......#.#.E.#.
.b.###.###.#.#.#.
.#.b...#...#.#.#.
.#.#.###.###.###.
...#..@#!#.......
17 17
......w....#....e
.td####t.#.#.###.
.#...#...#.#...#.
.#.#.#.##q####.c.
...#@#........t#.
##.#####.#####s#.
E#.#..!#..Q#...#.
.#.#.##V####.#.s.
.#.#...#...#.#...
.#.###.#.#.#.####
.#.#.#.D.#...Dd..
.#.#r#.#.#######e
S..#.#.#.#.......
.##q.#.#.#.#####.
...#.#...#..c..d.
##.#.#########.#.
...............#.
17 17
...E.......#....@
.#####U#w#.#W####
.#...#.....#.....
.#.###.#########.
.#.............#.
.#######.#####.#.
.....#.#.#..q#...
.###.#.#e#.#.####
.V...#.#.#!#.....
.#.###.#.####v##.
D#.#...........#.
##.#.##S##b#e#S#.
...#...#.r.....#.
.#####.#.#####.#.
.....#.#...#...#.
.###.#####.#.###.
...#.......#.....
17 17
.................
.#.#############.
.u.#.#.......d...
##.#.#.###.#.#.##
...#...#...#.#...
.#####.#.###.###.
.....#.#...#...#.
####.#####.###.#.
...C.#...#...#@#.
.###.#.#.###.###.
...#.#.#...#.v...
.#.###.###.#.####
.#.......#.#...#!
.##c######.#####.
...#.#.....#.....
##.#.a.#####.####
.....#........u..
17 17
...........#.....
.###r###R#.#.###.
.#...#...#...#...
.#.#B#.#.#.######
.#.w.#.#..Q#....!
.uR#.#####.#.####
...#.....#.#.....
.#e#####.#######.
.....#.#.......#.
####.#.#####.###.
@#...V...#...#...
.#.###.v##.###.##
.#...#...#.A...#.
.bt#.##a.#######.
...#...#...F.#...
.####S.###.#.#.#.
........S..#...S.
17 17
.................
#t####.#######.##
..b..#.#.....#...
.###.###.###.##u.
...#...#.r...#...
##.###.#.#.###.#.
...#.#...#.#...#.
.###.#####.#.U.##
...#...#...#.#...
##.#.###.#######.
!..#...#.......#.
####.#.##f##A#.#.
..@#T#.......#...
.###.###.#######.
...#.#.#....u..#.
.#.#.#.###E###.#.
.#...........#...
