abcdefghijklmnopqrstuvwxyz-=[];/
ABCDEFGHIJKLMNOPQRSTUVWXYZ_+{}:?
OOOOOOOOOOOOOOOOCCCCCCCCCCCCCCCC
15
17 17
.......#.......#.
.#.##R.#.###B#.#.
.#...#...#...#q..
.###.#.###.#.###.
.#.#.#.#...#...#.
.#.#.##A.#####.#.
.#.#.......#...#.
.#.#########.###.
...#.....#...#...
##.###.#.#.######
@#.....#.#.......
.#######.#######.
.#.....#.#.....#.
.#.###.#.#.#####.
.#.#...#.#.#...#.
.#.#.###.#.#.#.#.
...#.......#!#...
17 17
...........#.....
.Q########.#####.
.#.....#.......#.
.#.###.#######.#.
...#.#.....#.....
.###.#####.#####.
q#.......#.#...#.
.#.#####.r.#.#.##
.#...#...#...#...
.#####.#####.###.
.......#...#..@#.
########.#.#####.
..!#...#.#.....A.
.##S.#.#.#####.#.
...#.#.#.#.#...#.
##.#.#.#.#.#.###.
.....#...a.......
17 17
.................
.###.##Q#########
.#.#.#!..........
.#.#.####C######.
.#.#.......#...a.
.#.###.###.###.r.
...#.#...#.....#.
##.#.##q.###B###.
@#.#...#.........
.#.###.##########
.#.........#.....
.#######S#.###.#.
...#...#...#...#.
##.#.#.#.###.###.
...#.#...#...#.#.
.###.#####.###.#B
...........#q....
17 17
.......Q.........
#R########.######
...........#.....
.###.#####.#.###.
.#...#...#.#.#.#.
.#####.#.r#a.#.#.
..C..#.#.....#.#.
.###.A.#######.#.
.#...#...#.....#!
.#.#.###.###.#.##
.#.#..B#.R.A.#.#@
##.#######.#.#.#.
...#.......#.#...
.###.##c#t##.###.
.#...c..AS...#.#.
.#.##s####.###.#.
..c........#.....
17 17
...#.........#..A
.#.#.###R###.#.##
.#.#.....#...#...
##.#####.#.#####.
...#...#!#.....#.
.#.###.#######.#.
.#........@#...#.
.###########.###.
.....#...#...#s..
.###.#.#.#.#####.
.#.#.#.#.#.......
.r.#.#.#.####S##.
.#.#.#.#.....#...
.#.#.#.#####.#.##
.#.#...#.#...#.#.
.#.#####.#.###.#.
.........#......R
17 17
.rrr.#...........
.#####.#########.
.....#...#...#...
.###.###.###.#.##
.#.#...#...#...#.
.#.###.###.#.###.
...#...#...#.....
##.#.#.#.#######.
...#.#.#!#.....#.
.###.#######.#.#.
.#.#.#.......#.#.
.#.#.#.#.#####.#.
...#...#...#...#.
##.#######.#####.
...#@..#...#.....
.#####.#.#B#.####
.......#.........
17 17
...........#...#.
.#########.#.#.#.
.#.....#.....#...
.#.###.###s#####.
...#b#.#.....#...
.###.t.#.B##.#.##
.....#.....#.#.#@
##.#########.#.#.
...#!..#.....#.#.
.#####.#.#####.#.
t#.....C...#.#...
##.#####.#.#.###.
...#.....#.#t#..T
.##T###s##.#.#.##
.A.......#.#.#.#.
.###.###.A.r.#.#.
.....#.....#.....
17 17
@..#...#.........
##.#.#.C.#.#####.
.C.#.#.#.#...#.#.
.###.#.#.#A#.#.#.
.....#...#.#.#...
.#########.#.#.##
...#.....#.#.#...
##.#.###.#.#.###.
Q#.#...#...#.#...
.#.#.#.#####.#q##
.a.#.#B....#.#...
.#.####T##.#.#.#.
.#...#.....#...#.
.###.#.###.#####.
...#...#.#.#.b..q
.#C#####.#.#.#.#.
.#.....A.....#!#.
17 17
...#@............
.#.#########.###.
.#...........#...
.#####t#######.##
.......#...#...#.
.#####.#.#.#.###.
...#...#.#.....#.
##.#.A########.#.
...#.s.#.....#.#.
######.#.###.#.#.
.......#.#...#...
.#####.#.#.#####.
...#...#.#.....#.
.#.#.###.#####.#.
.#.a...#.#.#!..#.
.#.#####.#.#####.
.#.......#.......
17 17
.........B.#.....
.b##########.#.##
.#...#.......#...
.Q.#.q.#########.
...#.#...#@#.....
####.###.#.#.##A.
...#.#...#.#.#...
.#.#.#.###.#.#.##
.#...#.#...#.#a..
.#####.#.###.###.
.#...#.#...#.#...
.#.#.#.#C#.#.####
...#.#.#...#.....
.###.#.#.####q##.
.#...#.A.#!......
.#.###.#.#######a
.#...............
17 17
...#.........#...
.#.###.#####.###.
.#...#...#@#...#b
.###.###.#.###.#.
.#!#...#.#...#...
.#.###.#.###.###.
.#.#.#.#...#...#.
.#.#S#.#.#.#.#.#.
.#.#.#.A.#.#.#.#.
.#.#.#.###.#.#.q.
...#.#.#...#.#.#.
####.#.#.###.###.
.....#...#.#.....
.###.#####.#.####
...#.....#...#...
##.###S###.###.#.
.....#.........#.
17 17
.........#...#...
####.Q##.#.#.#T#.
.....#...#.#.....
.#.#####.#.#####.
.#.#..Q#...#.#...
.###.#.#####.#.#C
.....#...#...#.#@
########.#.#.#.A.
..!#.....#.#...#.
.###.#####.#####.
.....#...#.#.....
######.###.#.###.
...#...#...#...#.
.#.#.#.#.#####.#.
.#...#.#...#...#.
.#####.c##.#####.
.T...#...........
17 17
....c#....a......
.#####.R####.#q##
.#.....#...#.#...
.#.#####.#.#.###.
.#.#...#.#.#...#.
.#.#.#.#.#.#####.
.#C..a.#.#.......
.#.#####.#######.
.#.C...#...#.....
.#.#.#.###.#.####
...#.#.....r....@
.#A#.#####.######
...#...#...#.....
##.###.#.###.###.
...#.#.#.#...#...
.###.#.###.###.##
..a..#.......#..!
17 17
.....#.....#.....
##.#.#.##b.#.###.
...#r#.#...#.#...
.#B#.#.#.###.###.
.#.#.#.#...#...#.
.#.#.#.###.#.#.##
.#.....#...#.#...
.#######.#######.
...#...#.......#.
##.#.#.#######.#.
...#.#.......#...
.###########.###.
....!#.......#...
######.#######.##
.#...#.........#@
.#.a.#.########A.
...s.............
17 17
.........#.......
.###.###.#.#.###.
.#.#.#...#.#...s.
.#.#.###.###.#.s#
...#...#...#.#...
##.###.###.#####.
...#.#.#@#.....#.
.###.#.#.#####.#.
...#.#.#.....#.#.
##.#.#.#.###.#.#.
.#...t.#...#.#...
.###.#.###.#.###.
...#.#...#.#.#...
.#.#.###.###.#.##
.#.#...#.#!#.#.#.
.#####.#.#.#.#.#.
.......#...#.....
