abcdefghijklmnopqrstuvwxyz-=[];/
ABCDEFGHIJKLMNOPQRSTUVWXYZ_+{}:?
OOOOOOOOOOOOOOOOCCCCCCCCCCCCCCCC
7
17 17
.#.....#....u#...
.#.#.#.###.#.#.#.
.#.#.#.....#.#.#.
.#.#.#.#####.#.F.
...#.#.U...#...#.
.###.###.#.e####.
...#.....#.#...#.
####.#####S#.###.
...#...#...#.....
.#.#####.###.####
.#.#.....#.#U..#!
.#.#.#####.###.#.
.e...U...#...#.#.
.#####.#.#.#.#.#.
.#...#.#.#@#...#.
.#.#.#.#.#######a
...#...#.........
17 17
...#.......#.....
.#.#.####Q.#.#q#.
.#...#.....#..W#.
.#####.#f###F#.#.
.#...........#.#.
.#######F###.#.#.
.c.....#.#...#.#.
.#.###.#.#.###.#.
.#...#.#.....#@#.
.###.#.v####.###.
...#.#...#.....#.
.#.#.###.#####.#.
.#.#...#.....#...
.#####.#####.###.
.....#.....#...#.
.#.#######.###.#.
.#.........#!..#.
17 17
.......#.t.......
.#####.#.###.####
.#.....#.#...#...
.#.#####.#.###.#.
.#.#.....#.#...#.
.#.#.#####.#.s##.
.#...#...#...#..s
.#####.#####.#.##
...#...#...#.#...
##.#.u##.#.#####.
.#...#...#.....#.
q#.###.S######.#.
...#...#.....#.#.
.###.#.#.###.#.#d
.#@#.#.#!#.#.#...
.#.#.#####.#.#B#.
...#.A.......#...
17 17
.........#....!#.
.#####A#.#.#####.
...#.....#...Q...
.#.#########.###.
.#.........#.#.w.
.#########.#.a.##
....@#.....#.s...
######e#.###.###.
.......#.#...#...
.####f##.#b###.#.
.#.......#.#...#.
.#.#######.#.###.
.#.#...E.c.#...#.
.#.#.#.#.##q##.#.
.#.#.#...#.....#.
.###.#######.###.
.............#...
17 17
.#.......#.......
.#.#####.#.#.###.
.#.Q.....#.#...#.
.#r#.#####.##V.#.
.#.#Q....#.#.#.#.
R#.#####.#.#.#.#.
...#.....#...#.#.
.###.####t##.#.#.
...#...#.....#.#.
##.###.#.#####.#T
.#...#.#.#.....a.
.#.###.#b#.#####.
...#...#...#.#...
.###.##v.###.#.##
...#!#...#.....#@
##.###.###.###T#.
......C#.........
17 17
.........#w......
.###.###.#.#####.
.#...#...#.#.....
.#.###.#####.###.
.#.#.........#...
.#.#####.########
.#.....#.#.......
######.#.#.#####.
.......#.#...#...
.##F######.###.#.
.........#.#...#.
.#######.#.#.####
.......#...#.....
B#####.##a##.###.
...#...#!..#...b.
.#.#.#####.##c##q
@#.......#.......
17 17
...#.D.....#.....
.#.R.#.###.##T##.
.#.#.#.#.......#.
.#.###.####r##.#V
.#.f.#.#.....#...
.T##.#.#.###.####
.#.#.#.b.#.#.#...
.#.#.#F#.A.#.#.#.
.#.#.#.#.#.....#.
D#.#.#.D.##v####.
.#...#.#...#!#@#.
.#.###.###.#.#.#.
.#v.....E#...#...
.#####.##f####.##
.....#.#B....#...
.###.###.#.#####.
...#.....#.......
