abcdefghijklmnopqrstuvwxyz-=[];/
ABCDEFGHIJKLMNOPQRSTUVWXYZ_+{}:?
OOOOOOOOOOOOOOOOCCCCCCCCCCCCCCCC
11
17 17
.....#!#.........
.#####.#.###.###.
.#.....#...S...#.
.#.###########.#.
.#.#...#.....#.#.
.#.#.#.#.###.#.#.
.#q..#...#.#.#.#.
.########T.#.#.#.
.A...........#.#.
.#############.##
.......#@........
######.#########.
.......#.....#...
.#######.###.#.##
.....S...#.#.#...
####.#.###.#.###.
q......#.........
17 17
.......#.........
.#t###.#.#####.#.
.....#.#.#.....#.
####.#.#.#.#.####
...#.#.#.#.#.#Q..
.b.#.#.#.#.###.#.
.#...#...#...#.#.
.#a#########.#.#.
.....#@..#!#...#.
####.###.#.####a.
...#...#.#...#...
.#####.A.###.#.##
...#...#...#...#.
##.#.#####.###SS.
...#.....#.C.....
.#######.###.###.
.............#...
17 17
.#...#...#.......
.#.#.#.#.#.#.####
.#!#.#.#...#@#...
.###.#.###.###.#.
.#...#...#.#...#.
.#.#####.###.###.
.#.#...#.....#.#.
.#.#.#.###.###.#.
.#...#...#.....#.
.#######.#####a#.
.#.....#.#...#...
.#.R.###.#.#.#.##
...#...#...#.#...
.##B##.#####.###.
.#...#...#...#...
.#.#.###.#.###.#.
...#...#.......#.
17 17
.....#.........#@
.#.###.#####.#.#.
.#.......#...#.#.
.#######.#.###.#.
...#...#.#...#...
####.#.#####.##S.
.....#.....#...#.
.#########.###.#.
.#.#...........#.
.#.#.####q######.
.#...#!......#...
.###########.####
.#.........#.#...
.#.#######.#.#.q.
...#.....#.#...#.
.#######.#.#####.
.........#.......
17 17
.#...........#...
.#.#####.###.#.##
.....#.#...#.#...
####.#.###.#.###.
...#...#...#.#...
.#.#####.###.#.##
.#.....#.#...#...
.#####.#.#.###.#.
.#.#.....#.#.#.#.
.r.#.#b###.#.#.#.
.#...#!#...#...#.
.#####.#.#####.#.
...#...#.....#.#.
##.#.#######.###.
@#...#.....#...b.
.#####.###.###.#.
.........#.......
17 17
....s......#.....
.###.q.#####.#.#.
...#.#.#.....#.#.
##.#.#C#.Q####.##
@#.#.#.......#...
.#.#.#.#S#######.
.#.#...#...#...#.
.#.#####.#.#.#.#.
.#...#.#.#...#.b.
.###.#.#.#######S
...#...#.........
.#.###.s###bc###.
.#.....#.....#...
.#######.###.#.#.
.#.......#...#.#.
.#########.#.#.#.
....a......#.#!#.
17 17
.........#.T.....
.#####.#.#######.
.#@#...#t.......S
.T.#.###########.
...#...#.a.....#b
.#####.###.###.#.
.#...#...#...#.#.
.#.#.###.r.#.###.
.#.#.....#.#.....
##.#.#A#####.####
...#.#.....#.....
.#####.###.#####.
.#.....#.#.#!c...
.#.#####.#.#.#.##
.#.......#.#.#.#.
.#######.#.#.#.#.
.........#...#...
17 17
...#...#...#.....
.###.#.#.#.###.#.
.#...#...#...#.#.
.#.#########.#.#.
.#.........#...#r
.#########.#####.
.........#...#...
.#######.###.###.
.#....@#.#.#.#!#.
.#.#####.#.#.#.#.
.#.....#.#.#...#.
.###.#.#.#.#####.
...#.#.......#.#.
##.#.#######.#.#.
...#...#...#.t.#.
.######b.#.#####.
.........#.......
17 17
...#.............
.#.#.###a#######.
.#.A...#.#.......
##.###.#.T####.##
.....#.#.#...#...
.###.#c#.#.#.###.
..RBB#.#...#.#...
.#.###.#####.#.##
.#.....#.#...#...
.#######.#.#####.
.....#...#...#...
####.###.###.####
...#.....#.#.....
.#.#####.#.#####.
.#....@#.......#!
.#############.##
.................
17 17
...#.....#.......
.###.#.###.###.##
.....#.......#...
.###############.
...#.#...#.......
##.#.#.#.#.#####.
...#.#.#...#...#.
.###.#.#####.#.#.
.....#.#.....#.#.
####.#.#.#.#####.
..!#.#.#.#...#...
.###.#.#####.#.##
.#@#.#.#...#.....
.#.#.#.C.#.######
.#...#...#.......
.###############.
.................
17 17
.#.....a...#.....
.#.##S.#####.###.
.....#.......#!#.
c##R##########.#.
.#...#.........#.
##.#.#.#########.
...#...#.....#...
.#######.##T.###.
...#.....#@#...#.
##.#.#####.###.#.
.#.#.#...........
.#.#.###########.
.#.#.........#...
.#.#########.#.##
.#.........#.#.#.
.S########.#.#.#.
.............#...
