abcdefghijklmnopqrstuvwxyz-=[];/
ABCDEFGHIJKLMNOPQRSTUVWXYZ_+{}:?
OOOOOOOOOOOOOOOOCCCCCCCCCCCCCCCC
7
17 17
...#S.....b......
.##W.#######.#.#.
.#...#.....#.#.#.
.#.###.D##.#.#f#.
.f...#r#...#.#.#.
.#.###.#.#####.#.
...q...#.......#.
#d##.###########.
.....#!..#.#.....
.C##.###.#.#.G#S#
.#.....#.#.#.#...
.#.#####.#.F.#.#.
.#.#b....#...#.#.
.#.X.###w#.##W.#.
.#.#.#...#.#...#.
.W##.#.#.#.#.###.
.....#@#.....#...
17 17
........V....q...
.###.###########.
...#.#e........#.
####.#.R######q#.
.....#.#.....#...
.#####.###.x.R###
...#...#...#.#...
.#.#.###.#####.C.
.#.#R....#!.a..#.
.#.###r#########c
.#.........#.....
.#######.#.#.####
.v...#@#.r.#.#..e
####.U.#.#.#.#.##
...w.#.#.#.#.#...
.#####.#.###.###.
.......#.........
17 17
...#...E.#!#D....
.#.#####.#.#####.
.#.w...W.#.....#.
.#d#.###.####d.#.
.#...#...#B..#.#.
.####c.#U#.#.#.#.
.#...#.....#.D.#.
.#.U.#######.#.#.
.#.#...Q.....T.#.
.#.###.#.#####.#.
...#...#...#A..e.
.###.#######.###.
.#.#...#...#.#...
.#.###.#t#.#.#.#.
.....#.#.#.#...#.
####.#.#.#.#####.
@....#...#......E
17 17
...............#.
.#####.#####Qb.#.
.....#.#!....#...
.###.#######.###.
...#.....#...u.#.
####.###.#.###.C.
..C#.#...#.#@#...
.#.###.#.#.#.#.##
.#...#.#.#.R.#...
.###.S.##v.b.###.
...#...#...#T...u
##.#S##d.de#.A###
.#.......#...#...
.#########F#Xe##.
.T...#G....#...#.
.#.#.#.#####.x.#.
...#.........#...
17 17
.W.......#.......
.###S#.###.###.##
...#...#...#.#...
##.#.#.C.##B.r##.
...#.r.#...#...#.
.###.#.#G#.#.###.
.#...#.#S....#...
.#.#.###.#####.#.
.#.#.#...c.#..dv.
.#.###.B#vq#.#E#.
@#.........#.#...
#######db#.#.#.#W
.......#...#.#...
.###Q#.#####.###.
.#...#.....#.#.#.
.###.#####.#.#.#.
..!#.........#...
17 17
.........#.......
######.#.#.#####.
.......#.#.....#s
.##x####.#####.##
.#.....#.....#.R.
.#.#######T#.#V#.
.#.........#...#.
.###.###.####C.#.
...#...#.....#...
##.###.#####.###.
.#.#!#U#...#...#.
.#.#.#.#.R##.#.#.
.#...g...#...#@#.
.#######.r.###r#.
...X.#V..#...g...
.#####.##########
.................
17 17
...#.........#...
.###.#.#######.U.
....x#.........#.
###V##c#T#######.
.....#.#.......#.
.Q##.#.#.#####.#.
!#.q.#.E.....#...
##.###.#####.###.
...#.....#...#.#.
.#######.#.r##.#.
.......#S#...#...
######.###gx.t.##
@#.B...#...#.#...
.#.#####.#.#.###.
...#...#.d...#.#.
.###.#.#.#R###.#.
..Q..#...D.......
