abcdefghijklmnopqrstuvwxyz-=[];/
ABCDEFGHIJKLMNOPQRSTUVWXYZ_+{}:?
OOOOOOOOOOOOOOOOCCCCCCCCCCCCCCCC
7
17 17
...............A.
.#####.#######.#.
.#...#......@#.#.
##.#.##C##.###.#.
Q..#.#.....#...#.
.###.#######.###.
.#...........#...
.###b#########.##
.#...#...#.....#.
.#.#.#.#.#.#####.
.#.#!#.#...#.#.T.
.#.#####.###.#.#.
.#.#...#.#...#.#.
.#.#.#.#.###.#.#.
.#...#.#...#...#.
.#####.###.#####.
.......#.....S...
17 17
.#.....#.........
.#.#t#.#.#.#####.
...#.#.#b#.....R.
##.#.#.#.#####.#.
!#...#.#...#@#.#.
.###.#.###.#.#.#.
.#...#...#.C.#.#.
.###.#.###.Q.#.##
...#.#..c..#.#...
##.#.#######.###.
.q.#.........#.r.
.#######b###.#.#.
.#.....#...#...#.
.#.#t#.#.#.#####.
.#.#.#...#...#...
.#.#.##R#r##.#.#.
...#...........#.
17 17
.....#.#!........
.###.#.#####R###.
.#.....T.......#.
.#####.###.###.#.
...#.......#.#.#.
.#.#.#######.#.#.
.#.#.#...#@....#.
.#.###.#.#######.
.#.#...#.........
.#.#.############
.#.#.......#.....
##.######a.###c#.
.....#...#a..#.#.
.#.###.Q.###.#.##
.#.#...#.....#...
.###.###########.
...........q.....
17 17
.#...#.......#...
.#.#.#.###.###.#.
...#.#...#.....#.
####.###.###Q###.
!..#B..#.#.....#.
##.#.#.#.#.###.#.
.#.#.#...#.#...#.
.#.#.#####.#.###.
...#.....#.#.#...
.###.#####.#.#.#.
.#...#.....#.#@#.
.###.#.#####.###.
...#.#.#...#...#.
##.#.#.#.#.###.#.
.#.#.#.#.#...#.#.
.#.###.#.###.#.#.
.......#..R#.....
17 17
...........#.....
.###.#####.###.#.
...#...#.....#.#.
##.###.#####.#r##
...#.#...#.#.#...
.###.###.#.#.###.
.#.....#.#...R.#.
.#.A##.#.s####.#.
...#...#.#...#.b.
####.###.#.#.#.#.
..!#...#...#t#...
.###.####R##.##r.
.#@..#.....#...#.
.#####.###.###.#.
...#...#.#...#.#.
##.#.###.###.#.#.
R...r#.........#.
17 17
...#....!#...#...
.###.Q####.#.###.
.S...#.....#.....
.#.###.#.#######.
.#...#.#.#.....#.
.###.###.###.#.#.
...#...#...#.#...
.#####.#.#.#.####
.....#.#.#.#.#...
.#.###.#.#S###.#.
.#...#.#.#.....#.
.###.#.#.b##q###S
..C#.B.#.#.T.....
.###.#.###A#####.
.#...#.#...#.....
.#.###.#.###.####
@#.......#S......
17 17
.........#.......
.####A##.b##.###.
.#.....#.....#...
.#####q#######.##
...#q..#...#...#.
.#.#.###.#.#.###.
.#.#.....#.#...#.
.#.#s#.###.###.#.
.#...#.#.#.......
.###.#.#.########
.#...#...#...#..!
##.#####.#.#.#.##
...#.c...#.#.#.#.
.#######.#.#.#.T.
.#.....#...#@#.#.
.#.###.#######.#.
..s..#...........
