abcdefghijklmnopqrstuvwxyz-=[];/
ABCDEFGHIJKLMNOPQRSTUVWXYZ_+{}:?
OOOOOOOOOOOOOOOOCCCCCCCCCCCCCCCC
5
17 17
...........#.....
.###.#######.###.
..@#.#.......#...
####.#.#######.#.
...#...#..R....#.
.#.#####.#######.
.B.#...#.#.....#.
.#.r.#.#.#.#####.
.#!#.#.#.#.#.....
.###.#.#r#.#.####
.#...A...#...#...
.#.#######.#####.
.#.......#.#.....
.####B##.#.#.###.
.#.....#.C...#...
.#.###.#.#####.##
...#..b..#.......
17 17
.....#....c......
##.#.#.########b.
...#.#.........#.
.###.###########.
.#.#...q.a.......
.#.#Q#.#.#######.
.#.#.C...#.......
.#.#.###########.
.#...#.......#!#.
.##a##.#####.#.#.
.....R.#.c...R.#.
.###.#.#.#.#.#.##
.#@#.....#.#.#...
.#.#######.#.#t#.
.#.....b...#.#...
S#####.#.#####.##
.......#.........
17 17
.......#...#.....
##.###.#.S.t.####
...#.#...#...#...
.###.#.#######.#.
.#.#...#.......#.
.#.#.###.r######.
.#.....#.......#.
.#.##a####.#####.
.#...#.....#!..#.
.#.###.#######.#.
.#.#...#.....#...
.#.#.###.###.####
.#.#.#...#.#.#...
.#.#.#.###.#.###.
.#@#...#...#.#...
.#######.###.#.#.
...............#.
17 17
...#..q....#.....
.#.#.R##C#.#####.
.B.#.....#....Q..
t#.#####.#######.
.#.....#!#...#..a
.###.#####.#.#.#b
.#.#.#.....#.#...
.#.#.#.C.#######.
...#.A.#c....#...
##.#.#.#####.#.##
...#.#.....#...#.
.###.T####.####R.
.#.#.s..@#.#...#.
.#.###.###.#.#.#.
.....#...#...#...
####T###.#s#####.
.......#.........
17 17
...#.....#.#!#...
.#R#.#.#.#.#.#.#.
.#...#.#...#.#.#.
.#####.#####.#c#.
.#...#.r.....#.#.
.#.#.#.#.#b####B.
.#.#...#.#.....#.
##T#####.#.#.#.#.
...#.....#.#.#...
.###.s####.#.C##.
...#.#.....#.#...
.#.#.S######.#.##
.#.#...#.....#.#.
.#.###.#.#####.#.
.#...#.TB#...#.#.
.#.###.#.t.#.#.#.
.#....A..#@#.....
