abcdefghijklmnopqrstuvwxyz-=[];/
ABCDEFGHIJKLMNOPQRSTUVWXYZ_+{}:?
OOOOOOOOOOOOOOOOCCCCCCCCCCCCCCCC
7
25 25
..@#...........#!#.......
.###.#####.###B#.###.#.#.
.#T..#...#.#...#...#.#.#.
.#.B##.#.#.#.#####.###.##
...#.#.#...#.#...#...#...
.###.#.#####.#.###c#.###.
.....#...#.....A.....#...
####.###.#######.#####.#.
...#..r#.......#.#.....#.
.#.###.#######.#.#.#####b
.#.#.......#...#...#.#...
##.#.#######.#######.#.##
...#.#...#...#.........#.
.###.#.#.#.#.#.#########.
C....#.#...#.#.#...C.....
.#####.#######.#.#.###.#S
.#...#.........#.#.....#.
.#.#.#######q###.#######.
...#.#...#.......#.....#.
####.#.#.#.#.#####.#.#b#.
...#...#.#.#...#...s...#.
.#T#####.#.#Q#.#.#####.#.
.#...#...#.#...#.#.#...#.
.###.#.##R##.###.#.#.###.
...#.........#.....#.....
25 25
...#...........#.....#...
.###.#.#########.#.#.###.
...#.#...........Q.#...#.
.#.#.##s##########.###.#.
.#...#A#.........#.#.Q.#.
.#####.#.###r###.#.#.#.#.
.#.....#...#.....#.r.#...
.###.#####.#.#####.#.###a
...#.#.....#.#...s.#...#.
##.#.#.#####.#.#######.#.
.#...#...#.....#.......#.
.###.###.#######.#.#.###.
......@#.....#...#.#.#...
########.###.##R##C###.##
.......#.#...#.....#...#.
.####S.#.#.###C#####.###.
.#...#.#.#...#.#.....#...
.#.#.#.#####.#.#.#######.
...R.#.#.....#.#.......#.
####.#.#.##A##.#B#####.#.
...q.#...#.........#...#.
.#b#######.#.##q####.###.
...#...#...#Q#.....Q.#...
##.#.#.#.#.#Q#.#########.
!..#.#...#...............
25 25
.#...........#.....#.....
.#.#.#######.#.#####.#.##
.#.#.....#.#.#.#....a#...
.#.#####.#.#.#.#.#######.
...#...#.#.....#.#.....#.
.###.#.#.#######.#.#####.
...#.#.#...........#...#.
##.#.###############.#.#.
...#.......#.....#...#...
.#######.#.#.S.#.#.######
......c..#.#.#.#.#.#.....
##c#######.###.Q.#.#.####
.........#.....#.#.#.....
####.###.###.S###r.#####.
.....#.#.#...#!B...#.....
.#####.#.#.###.#.###.###.
...#.....#.R.#...#...#...
##.#.#######.#######.#.##
...#.....#@#.A.......#.#.
.#.#####.#.#.#.#######.#.
.#.#...#...#...#.#...#.#.
.#b#.#.#########.#.#.#.#.
.#.#.#.........#...#...#.
.#R#.#######.###.#######.
...........#.............
25 25
.....#..B....#...........
####.#.#####.#.#########.
..Q#.#.#...#.#.#...#...#.
.#.#.#.#.###.#.#.#.#.#.#.
.#.RC..#...#.#.#.#.#.#.#r
.#.###.q##.T.#.#.#.#.#.#.
.#...#.....#.....#...#@#.
.###.####B.#T#######.###.
...#.....#.#.......#.#...
##.#####.###.#####.###.#.
.#...#.......#S..r.....#.
.###.#########.##a######.
...#.........#.#...#.....
.######Q####.#.#.#.#.#S##
.........#!#.#...#.#.#...
.###.#q#.#.#.#.###.#.#.#.
.#...#...#...#.#.#...#.#b
.#.r##.#######.#.#####.##
r#...#...#...t.#..s......
.###.###.#.#.#.#q#.#####.
.#...#.....#.#...#...A.#.
s#.#############.#######.
.#.#.....#.....#.....#...
.#.#.##Q.#.#.#######T#.#.
.#.....#...#...s.......#.
25 25
............t......#.....
.#.#####Q#.#######.###.#.
.#.......#.#.....#.#...t.
.#######.###.###.#.#.###.
.#...c.#.....#...#...#.#.
.#.#.#r#######.#S#####.#.
.#.#.#.....a.#.#...#.....
.#.#.#.#a#r###.#.#.#.####
...S...#.....#.#.#...#...
########.###.#.#.#######.
.......#...#.#.#.........
.a####.###.#.#.##Q##A###.
.#...#.#...#.#.....#.....
.###.#.#.###.#.###.#####.
...#...#.#.#.#.#...#...#.
##.#.###.#.#.###.#.#.#.##
.#.S.....#...#...#.#.#...
.#.#######.###.###.#.###.
.#...#..T#...#.#@..#...#.
.###.#.#.###.#.#####.###.
...#!#.#.#...#.......#...
.#####.#R#.#######.###.#.
.....#...#.#.....#A#...#.
.###.#.#.#.#.###.###.###.
.t.#...#.....#.......#...
25 25
q..........#....t#!#.....
.###.#####.#.###.#.#.###.
...#.#.....#.#...#.q.#.#.
##.#.####A##.#.A##.#.#.#.
.#.#.....#...#...#...#.#.
.#.#####.#.#####.#####.#.
.#.#...#...#.......#.....
.#.#.#.#####.#####.#.####
.A...#.#S....#...#.t.....
########.#####.#.#.#####.
.........#.....#.#.....#.
.#####.###.#####.###.###.
.#...S.#...#...#.#...#...
.#.#.#.#.###.#.#.#.###.##
.#.#...#.#...#.#.#...#...
.#####.#.#.###.#.###.###.
.....#.#...#.#.#...#..@#.
.###.Q.#####.#.###.#####.
.#...A.#.....#.#.#.......
.#.#####.###.#.#.########
.#...#...#.#.#.#.........
.###.#.###.#.B.###.#####.
.#.#.#.....#.#...#...#.#.
.#.#.#####.#.###.###.#.#.
...#.......#.........#...
25 25
....A..........#.........
.#############.#.#.#####.
.#.........#.#.#.#.#.....
.#.#######.#.#.###.#.####
.#.#@#...#.#.......#.#...
.#.#.#.#.#.######CT#.#.##
...#.#.#...#...#...#.#...
####.#.#####.#.#.###.#.#.
.....#.#.....#.#.....#.#.
.#####.q.#####.#.#######.
.#.....#.S!....#.#.......
.#.###a#.#######.#.#####.
.#.......#aC.....#.#...#.
.#########.#.#####.#.#.#.
.....#...b.#.#.....#.#...
.###.#.###.#.###.###.####
.#.....#...#.#...#.#...#.
.####R.#####.#.###.###.#.
.#...#.#...#...#.....#...
.#.#.#.#.#.#a#######.###.
.#.#.#.#.#.............#.
.#.#.###.####b##.###.###.
.#.#.#...#..b..#...#.#...
.#.#.#.#######.###.###.##
...#.............#.......
