abcdefghijklmnopqrstuvwxyz-=[];/
ABCDEFGHIJKLMNOPQRSTUVWXYZ_+{}:?
OOOOOOOOOOOOOOOOCCCCCCCCCCCCCCCC
7
33 33
.......#.........#...........#...
.#.###.#.#######.#.#####.q##.##Q.
.#.#...#.#...#...#.aA..T...#.#...
.#.r####.#.#.#.###.###.###.#.Q.#.
.#.......#.#.#...#.....#...#...#.
.#########.#.#.#.#####.#.#######.
...B.......#.#.#.#.....#.......#.
##.#.######q.###.#.##A########.##
.#.#.#.....#...#.#.#.....#...#...
.#.#.###.#.###.#.#.#.#.###.#.#.#.
.#.#..!#.#.#...#.#.#.#.#...#.#@B.
.#.#####.#.#.###.#.#.#.#.###.###.
.#.#.....#.#.#...#...#.#.#.......
.#.#.###.###.#.#.###.###.#######.
.#...#...#...#.#.#...#...s...#...
.####c.###.#####.#.###.###.#.#.##
.....#.#...#.....#...#.....#.#...
.###.#.#.#####.#####.#######.###.
.#...#.#.....#.......#Q....#...#.
.#.###.#####.###.#####.###.#.#.##
.#.....#...#...#.#.....#...#.#...
.#######.##C##.a.#.#####.#######.
.....#.#.....#.#.#.#...#.....#...
####.Q.#.###.c.###.#.#######.#.##
.....#.#.#.#.#.....#.......#...#.
.#Q###.#.#.a.#######.#.###.#####.
.#.....#.#.#.....#...#.#.#...#...
.###.###.#.#####.#.###.#.#c#.###.
...#.....R.#...#...#...#...#..C#.
##.#####.#.#.#.#####.###.#.###.#.
.#.....#...#.#.#...#.#...t...#.#.
.#####.#####.#.#.#.#.#.#.#####.#.
.............#...#...#.#.........
33 33
.#.....#.....#.............#.....
.#.#.#.###.#.###.#########.###.#.
...#.#.....#.....#...#...#...#.#.
#t##.###############.#.#.###.S##.
.....#@..............#.#...#.#...
.#######.#.###########.###.T.#.#.
.#...#...#.#.....#.....#.#...#.#.
.#.#.#.#####.###.#.#####.c####.##
...#.#.#.....#.#...#.........#...
.###.#.#.#####.#####.#########.#.
...#.#.#.#.....C.#...........R.#.
##.#.#.#.#.###.#.#.#############.
.#.#.#...#.#...#B#.#.....#.....#.
.#.#.#.###.#.###.#.###.###.###rr.
.c.#.#.....#.#.......#.....#...#.
.###.#######.#######.#######.###.
.C.#.#..B..#b....#...........#...
####.#.###.#####.###########.#.#.
.....#...#.......#...#...#...B.#.
.#######.#########.#.#q#.#.###S##
...s...#...#.......#.#...#...#...
##.#.#####.#####.###.t.#####.#BQ.
...#.A.....#.....#.#.#.....#.#...
.###.###.###.#####.#.###.#.#.#.##
.#...#!#.....#.....#...#.#...#...
.#.###.#######.#.#####.#####.##s.
.A.#...#.#.....#.#.....#...#...#.
.###.#T#.#.###.###.#####.#.#####.
.#...#...#.#B#...#...#...#.#...#.
.#.t##.#.#.#.###.###.A.###.#Q#.#.
.#.#...#...#...#...A...#.#.#.#...
.#q#.#########.#.##t####.#.#.###.
...A..........T#.....T.......#...
33 33
.#...........#...........#.......
.#.#######.#.#####.###.###.q.####
...#.....#.#.#.....#.#.#...#.....
.Q######.#.#.#.#b###.#.#.#######.
.........#.#...#.......#.#...#...
####b#.###.###.b########.###.#.#.
...#...#...#...#.......#.....#.#.
.#.#.###.#######.#####.#####.#.#.
.#...#.#.......#.....#.....#.#.#.
.#####.#######.###.#####.###.#.##
.T...#...#.....#...#...#.....#...
####.#.#.#.#####.##b.#.#Q#####.#.
.......#.#.#.....#...#...#.A.#.#.
.########T.#.#####.#####.#.#.###.
.#...#.....#.#...#.#.......#.#...
.###.#.q#Q.#.#.#.#.#########.#.#.
...#.#...#.#.#.#.#.....#.....#.#.
##.#.###S###.#.#######.#####.#.#.
.#...#.#.......#.....#a....#.#.#.
.###.#.#######r#.###.#####.#.#.#.
...R.#.....#.....#...#.....#...#.
.#.#.#####.#.#####.###.#########.
.#.#.#.....#.#...#.#...#.....#...
.#.#.#.#####.#.#.#.b.###.###.#.##
.#.#.#...#...#.#...#.#...#.Q.#...
.#.t.###.#.###.####s.#.#.#.#.###.
.#.#...#.#...#!#.....#.#.#.#...#.
.#.###.#.###.###.#.###b#.#.###.#.
.#..@#.#...#.#...#.....#.#...Q.#.
.#####.#.#.#.#.#######.#.###.#.#.
.#...#...#.#.#.#.......#...#...#.
.#.Q.#####.#.###.#######.#.#####.
...#.......#.....#.....t.#.......
33 33
.........#...#.............#.....
.##c######.#.#.###########.#.###.
...#.......#...#.........a.#.#...
.s.#.###########.##A####.#.#.#.##
.#...#.........#.#.....S...#.#...
.###########.#.#.#.###.#####.###.
.#.....#...#.#.#.#...#...#...#...
.#.#.#.#.#.#.#.#.#.#.#####.###.#.
.#.#.#...#...#.#.#.#.#...Q...#.#.
.###.#######.###.#.#.#.#.###.#.#.
...#...#...#.#...#.#.#.#...#.#.#.
##.###.#.#.#.#.#####.#.#c#.#.#.##
.#...#.#q#..C#...#...#.#...#.#...
.#R#.#.####b####.#.###.#.###.###.
.....#.........#.#.....#.......T.
.#####S#####.###.#############.#.
...#.......#...#.........#..!#.#.
##.#.#####.#.s.#########.#.###.A.
...#...#...#.#.#.....#...#.#...#.
.###.#.###.###.#.###.#.#B#.#.###.
...#.#...#.....#.#...#...#.#...#.
##.###.#.#######.#.#.###.S.#.###.
.#...#t#R#.....#.#s#.#...#.#.#...
.###.T.#.#.###.#.#.##r.###.###.#.
...#.#.#.....#...#...#.....#...#.
.###.######B.#####.#.#######.###.
...#.......#.#...#.#...#.....#...
.#.#######.###.#.###.#.#.####T.##
.#.#.....#.#...#.....#.#...#.#...
.#.#.###.#.#.#########.###.#.###.
.#.#.#.#...#.#..@#...#.#...#...#.
.#.#.#.#####.#.###.#.#.#.###.###.
a#...........#.....#.....#.......
33 33
...........#.#.S.....#...........
########.#.#.#.###.##R.#####.###.
.......#.#...#...#.........#.#.#.
.#s###.#.#######.###########.#.#.
...#.....S.........a.#...Q...#...
.#.#.#####.###########.#.#.###.##
.#.#.#.........#...#...#...#.....
##.###.#######.#.#.#.######t####.
.T.#...#.....#.#.#...#...B...#...
.##R.###.###.###.#####.#.r.#.#.##
..B#.#..t#.#.....#.....#.#.#.#.#.
.#.#.#.###.#####.#.#####.#.#.#.#.
.#...#...#...#...#.#...#...#.#.#.
.#######.###.#.###.#.#.#####.#.Q.
...#...#...#.#.#.#.#.#.......#...
.###.#.###.#.#.#.#.###.#########.
.#...#.....#.....#...#.....#...#.
.#.########c.#####.#.#####.#.##a.
.q.S.#.....#.#...#.#...#.#.#...#.
.#.#.#.###.#.#.#.#.###.#.#.###.#.
.#.#.#...#...#.#.#.#...#.#...#...
.#.#.###.#####.#.#.a.###.###.#.##
.#.q.......#...#.#.#.#...#...#...
.#.#########.###.###.#.###.#####.
.#.#...#!....#.#.....#...#...#...
##.#.#.#######.q########.###.###.
...#.#...........#.........#...#.
.###.###.#######.#.###########.#.
...#...#...s...#...#...s.....#.#.
.#.R##.###.#.#.#####.#.#.###rr.#.
.#...#...#...#.......#.#.#.#.#.#.
.###.###.########t####.#.#.r.#.#.
...#............A....#.....c...#@
33 33
.....#.....#...#...#.#...........
.#####.#.###.#.#.#.#.#.#####.####
.#...#.#.....#...#.#...#...#.....
.#.#.#.###########.###.##A.#####.
.#.#...#.........#...#...#...#...
.#.#########.###.###.###.###.#.#.
...#.......#...t...#.#.......#.b.
.###.#####.#####.#.#.###.#####.q#
.#...#.....#.....#.#...#.#...#...
.###.#.#####.#########.#.#.#.###.
.....#.#...#.........#!#.#.#...#.
######.#.###.####S.#.#####.##S.#.
...#...#...#..s..#.#...#...#.....
.#.#.###.#.#.#####.###.#.########
.#...#...#...#.....#...#.........
.####B########.#####.###.#######.
...#.........#...#.#...#...#...#.
##.#.#######.###.#.###.###.#.#.#b
.#...#.....#.#...#.#...#...#.#.#.
.#####.#.###.#.###.r.###.###.###.
.......#.#...#.#...#.#.#.#...#...
.#######.#.###.###.#.#.#.#.#.#.##
...#.....#.#...#...#.#...T.#.#...
##.#.#####.#.###.q##.###.#.#####.
.#.#.....#...#.....#...#...#.....
.#.###c#.#####.###.###.#####.####
...#.#...C...#.#r.r..#.#...#.....
.###t#.###T#.###.###.#.#.#.###.#.
.....#.#...#.....#...#.#.#...#.#.
####.#.#.#.###t#.#####.#.###.#.#.
@#...#.#.#.#.....#...#.#...#.#.#.
.#.###.#.#.#######.#.#.###.A.###.
.....#...#.........#.......#.....
33 33
.....#.....#.........#.........#.
.###.#####.#.#######.#.###.###.#.
.#.........#.#.....#.#.#...#.#.t.
.###########.#.###.#.###.###.#.#.
.....#.....#.T.Q...#...#.#....R.c
.###.#.###.#.#####.###.#.########
.#.#...#.#.#.#...#...#.#q........
.#.#####.#.#.#.#.#####.#########.
.........#...#.#.....#...#.....#A
####.#########.#####.###.#.###.#.
.....#.........#.t...#...#.#.#.#.
.#####.#####.#####.###.###.#.s.#.
...#.#...#.#.#...#.....#...#.#...
##.#.###.#.#.#.#.##c####.###.###.
.#.#...#.#...#.#.#......c#.#.....
.#.#.#.#.#####.#.#.#######.#.####
...#.#.#.....#.#.#.#.......#.#...
.###.###R###.#.#.#.###.#.###.#.#.
.#.........#...#!#...#.#.....#.#.
.#.###a#.#.###B#####.#.#######.##
.#.....#.#.#.......R.C.#.........
.#######.#.#.#####.#.#.#########.
.........#.#.#.....#.#.....#...#.
##########.#.###.###.###r#.#.#.#.
.......#.#.#...#.....#.....#.#.#.
.#.###.#R#.#.#.#######.#####.#.Q.
.a...#...#.#.#.#.....#.....#.#...
.###.#####.###.#.##T.#####.#.###.
.#q#.....#.....#.#...#...#.#...#.
.#.#####.#######.#.###.#.#.#.#.#.
.#.....#...#.....#.#...#.#.#.#B#.
.#b#.#q###B#.#####.R.###.q.###.#.
.....#...#.......#.....#.......#@
