abcdefghijklmnopqrstuvwxyz-=[];/
ABCDEFGHIJKLMNOPQRSTUVWXYZ_+{}:?
OOOOOOOOOOOOOOOOCCCCCCCCCCCCCCCC
7
17 17
.#.............#U
.#.###.#######.#.
.#.#.#...#.....#.
.#.#.###t#.#####.
...#...#.#..v....
e###.#.#.#######.
.#...#.#.#.....#.
.#.###.#.v.#q#.B.
...#.#.#...#.#.#.
####.#.#####.#r#.
...#...#.....#.#@
U#.#.###.###.#.##
.#.#.#...#...#...
.#.#.#.#########.
.#..b#..T......#!
.#E#########.#.##
........d...u#...
17 17
.........#.......
.###.###.#######.
.s...#.........#.
.#.###.#######.#.
.#.#.#.#...#...#.
.#.#.#.#.#.###.#.
.#.#...#.#...#...
.#.#.###.###.#e##
.#.#...#...#A....
.v.###.Q##.#####.
.#.#@#V#!#q..#..c
##.#.#.#.#V#.#.##
...#...c.....#...
.#####.#########.
.#...#.#.....#...
.#.#.###.#.###.##
...#.....#.......
17 17
.D.......#.......
.#######.#.###.#.
...#...#...#...#.
##.#.#.#####.###.
.#...#...#...#...
.#######.#.###.##
.#.....#.#...#...
.#.###.#.###.###.
...#@#.#...#..s#.
##.#.#.###.#A#.#.
!#...#.......#.#.
.#####.#####S#.##
.#...#.#...#.#..B
.#.#.###.#.#.###.
...#...#.#.#.#...
####e#.#.#.###.#.
.........#.....#T
17 17
...#.....#.....#@
.###.#.###.#.#.#.
.....r.#...#.#...
.C####.#.###.####
.#.....#.#.#.....
##.###.#.C.#####.
!#...#.#...#...#.
.#.#.####u.###.#.
.#.#.....#...#D#.
.###.#.#####.#.#.
...#.#.........#.
s#.#####.#######.
.#.#...r.#.#...#.
.#.#.#.#.#.#.#.#.
.#.#.#.#...#.t...
.#.#.#.##A#v.###.
.....#.......#...
17 17
...#...#.....#...
.###.#.#.###.D.#.
.....#.....#...#.
.###E###########.
.....#...#....!#.
####.#.###.#####.
.......#...#.....
#######c.###.Q.#.
.........#.#.#.#.
.#########.#.D.##
.#...........#...
.#.#############.
.#......@#...#...
.###A#####.B.#.#.
..b........#...#.
################.
.................
17 17
.#..d....#.......
.#.#.###.#.#v###.
...#...#.#.....#@
.#####.#.##u##.#E
...#...#....Q#...
##.#.#####t#.###.
.#.#.......#.....
.#.#######.###D#.
.#...#...#.#.#...
.###.#.C##.#.#.##
...#...#...#.#.#.
.#.#S#V#.#v#.s.#.
.#..d#.#.#.......
.#c#.#.#.#####r#.
.#.#.#.#...#!#...
d#.#.#.###.#.#.##
...#.....#.a.#...
17 17
...#.c...#....T..
.#.##A.#.#######.
.#...#E#.#...#...
.###.#.#R#.#.#.#.
...#...#...#...#.
C#.############B.
.#.Q..u#@#.......
.#.#.#.#.#.######
.#...#.#...#.....
.#####.#####.Q##.
.e.#...#.......#.
##.#.###.#######.
!#.#...#...Q.#...
.#####.#.#####.#.
.....R...#.....#.
####.#####.##E##.
...........#.....
