abcdefghijklmnopqrstuvwxyz-=[];/
ABCDEFGHIJKLMNOPQRSTUVWXYZ_+{}:?
OOOOOOOOOOOOOOOOCCCCCCCCCCCCCCCC
7
17 17
...#.........#...
.###.#.#####.#.##
.c...#.#...#...#!
.#.###.#.#.###A#.
...#.#...#.#.....
.###.#####.#.####
.....R.#.#.a.Q...
######.#.#S#####.
.....#...#...T...
.###.###.#.#BTx#.
.#@#.#T..T...#.#.
.#.#.#.#####.f.##
.#.#.#.....#.#...
.#.V.#####.#.###.
...#...#...#.#...
##.#.###.#####.#.
...#...........#.
17 17
.....#!..........
.###.###########.
.#...#...D.#.....
.#.#######.#.####
.#.....#...#..c..
.#####.#.#####f#.
.#...#.#.......#.
.b.#.#.Q##a###D#.
.#.#V#...#...E.e.
.#.#.#E#.#####.#.
...#.#.......#.#.
.###.r######.#.#C
.#.#...#...#.f.#.
.#.###.#.#.#####.
.#F..A...#...#...
.#.#.#######.#.##
.f.#......@#.D...
17 17
.............#...
##.#########.#.#.
...#...#.S.#...#.
.#####.#.#.###B#.
.....#.c.#...#.#.
####.#####.#.#.#.
.....#...#.#.#.#.
.#####.#.F.#.#.#.
...#...#...#...#.
#V.R.#########.#S
...#.#...#U..#.#.
.###.#.#.#.#.###.
.#...#.#...#...#.
.#.###.#####.F.#.
.E.....#..!#.#.#.
r#######.###.#.#.
.........#@..#...
17 17
.....b.#.....#...
##.X##.###.#.#.#.
...x.....#.#...#.
.#######.#.#T###.
...#!..#...#.....
##.###.#####.####
.#.....#...#.....
.###V###.####f##.
.#.......#...#...
.#.#####.#.#.x.x#
.#.G...#...#...#@
.q.###C######e##.
.#.......#.......
.#######.###.#.#c
...#...#...#.#.#.
.#.#e#.###.###.#.
.#...w.........#.
17 17
...............q@
.#.###########.#.
.#.....#.#.....#.
.###G#.#.#.###a#.
.....#.#...#.....
A#####.#.###G###.
.#.....#.#...#.#.
##.#a###.###.#W#.
...#.......g.#.#U
.#.##########w.#w
.#.#s...B..#.....
.g##.G####.#.####
.....#.....#.#..!
.##G##A#####.#.##
...R...#.....#q#.
##.#.#########.#.
...#.............
17 17
.....#.........#t
.v####.##W####.#.
.#!#...#.......#.
.#.#.###.##D#B##.
T#...#.#...#.....
.#####.###.#.###.
.C...X..@#...#.#.
.#.###.#######.#.
.#.#...#.........
##.#.###.########
...w...#...#.....
.#####.###.#.#.##
.....#.#...#qc...
.###.#.#.v####.#.
.#.#.#.#.#.v.#B#.
.#.#.###.#.#.#v#.
...#.......#.....
17 17
.F....E..#.#.....
.#.#W###.#.#.###.
.#.#.#.....#.#!#.
.#.#.#.####eQ#.#.
...#.#.#@#...#.#.
#u##.E.#.#.###.#.
....w#.#.#...#...
.##DG#.#.###.####
...#.#.....#.....
.#.#.#####.###A#.
.#.#.......#.....
.u.##R####.#.####
.#.......#.#.#...
.#######.#.#.#.#.
.#.....#.#.#...#.
u#.###.#.#######.
...#...#..d......
