abcdefghijklmnopqrstuvwxyz-=[];/
ABCDEFGHIJKLMNOPQRSTUVWXYZ_+{}:?
OOOOOOOOOOOOOOOOCCCCCCCCCCCCCCCC
7
17 17
.....#.....#.....
.###.#.#.###.#.#.
.#.#...#.....#.#.
.#.###########.#.
.#.......#.....#.
.#.#####.#.####B.
...#.#R..#...#...
####.#.#####.#.##
...#...#...#.#...
.#.#.#####.#.###.
.#@#...#...#...#.
.#B###.#.#.###.##
.....#...#...#..!
.#.###s#####.####
.#.#.......#.#S..
.#.#.#S###.#.###.
.#.......#...t...
17 17
...#..A........#.
.#.#.###.###S#.#.
.#T#...#.....#...
.#.###.#####.C###
.#.#...#...#.....
.###.###.#######.
.....#.....#.....
.#########.#.###.
...#S....#.#...#.
T#.#.###.S.###.#.
.#.#.#.#...#.#.#.
.#.#.#.###.#.#.#.
.#.#.#...#.#.#.Q.
.#.#.#.#.#.#.#.#c
.#.#.#.#@B...#.#.
.#.#.#.###.###.#.
.....#.....#!..#.
17 17
...........#.....
####.#####.####Q.
...#...#t..#...#.
.#.###.#.###.#.#.
.#.....#.....#.#.
.#############.#.
r............#.#.
.###########.#.#.
.#..@#.......#.#.
.#.###.#######.#.
.#...#...#.....#.
.###.###.#.#####.
...#.C...#.#.....
C#.#.#.###.###.##
.....#...#...#...
########.###.###.
!........#.......
17 17
.#...#...........
.#.#.#.#####.####
...#...#...#.....
.#######.q.#####.
.#....c..#.#...#.
.#.#######.#.#.#.
.#.#.....#.#.#.#.
.#.#.###.###.#.#.
...#.#.......#...
##.Ra##b########.
.#.#.......#.#..s
.#.#######.#.#.##
.......#...#...#.
q#####.#.###.###.
....!#@#.#.#.#...
.#######.#.#.###.
.........#.......
17 17
...#.....#.......
.###.#.###.#####.
.#...#...#.#.#...
.#.#####.#.#.#.##
.#.#...#.b.B.#...
.#.###.#####.###.
...............#.
.#####C###B####q.
.#.......#.#.....
##.#####.#.#.###T
...#.....#.#.#...
.###.#######.#.#.
.#!#.......#...#.
.#.##b####.#####.
...#....@#.....#.
####.#########.#.
....C............
17 17
.................
.#########.####t.
.#.....#...#...#.
.A.#####.A#T.#.##
...#Q..#.....#...
####.#.#.#######.
.....#.#.......#.
.#####.#######.#.
.#.....#.....#.#.
.#.#####.###.#.#.
.#!#.....#.#.#@#.
.###.#####.#.###.
...#.....#.#.....
##.####B.#.#####.
.#...#...#.....#.
.###.#.###.#rt.#.
.q.....#.....#...
17 17
.........#...#..T
.#####.###.#.#.##
...#...Aq..#!#...
.#.#####.#b###.#.
.#.#.....#.....#.
.#.#.#######.###.
.s...#.....#.#...
.#######.#.###.#.
.#...#...#...#.#.
.#.#.#.#####.#.#.
.#.#...#...#...#.
.#.#######.#####.
.#...#.....#...#.
.###.#.#####.#.#.
.#...#.....#.#.#.
.#.###.###.#.#.#.
...#@....#...#...
