abcdefghijklmnopqrstuvwxyz-=[];/
ABCDEFGHIJKLMNOPQRSTUVWXYZ_+{}:?
OOOOOOOOOOOOOOOOCCCCCCCCCCCCCCCC
7
35 35
.....#.....#.........#.............
.###.#####.#.#######.#T#.#####.###.
.#.Q.......#...#t..#...#...r...#...
.#.#######.###.#.#.###.#####.###.##
.#....@#...#.#.#.#...#.....#.#...#.
.#.#####.##c.#.###.#######.#.#.###.
.#...........#...#.........#.#...#.
.###########.###.#######.###.###.#.
.........#....B#......!#.#.s.#...#.
.#######.#.#a###########.###.###.#.
...#.....#.#...........#...#...#.#.
##.#.#####.#.#####.#######.#.#.#.#.
.B.#.#...#.#.#...#.........S.#.#...
####.#s###.#.r.#############.#.####
.....#...#.#.#.......#.....#.#.....
.#R###.#B#.#.#####.#.#.C##.#.#####.
.#.....#...#.....#.#.#.#.#.#.....#.
.#####.#####b###.###.#.#.#.#.A#c##.
.....#....s..#.#...#...#.#...#.....
.###.#.#####.#.###.#.###.r####.###.
.#.#.#.#.a.#.....#.#.....#...#.#...
.#.#.###.#.#####s#.#####.#.#.#.#.##
...#...#.#.....#.#.#.....#.#.#.#.#.
##.s##.#.#####.#A#.#.t####.###.#.#.
.#...#...#...#.#...#.....#.#...#.#.
.###.#####.#.#.#.##a###S.#.#.###.#.
...#...#...#.#...#.....#.#.#...#...
.#.##rs#.S##A#####.###.#.#.###.####
.#.....#.........#.#...#.#.B.#.....
.###########.###.#.#####.#.#.#####.
...#.....#...#...#...#...#.#.....#.
##.###.#.#.###.#####.#.###.#######.
...#...#...#...#...#.......#.....#.
.###.#######.###.#.T########.###.#.
.....#...........#...........#.....
35 35
.....#.........#.....#.....#.......
.###.#.#####.###.#.#.#.###.#.#.###.
.#...#..C..#...ab#.#.#.#.C.#.#.#...
.###S#.#####.#####.###.#.#.#.#.####
.#....q#...#.....#T..#...#...#.....
.#.#####.#.########c.#.#####.#####.
...#.A.#.#.#...#...#...#...#.#...#.
####.#.#.#.#.#.#.#.#####.#.b.###.#.
.....#...#...#...#...#B..#.#.....#.
.q##################.#.###.#.#####.
.....#.........#...#...#.#.#.#.....
.###.#.c######.#.#.#C###.#.#.#.####
.#...#.....R...#.#.......#.#.#.....
##.####r##.#.#.#.#####.R.#.#.#####.
...#.....#.#.#.#...#.#.#.#.#.....b.
.###q###.#.#.#####.#.#.###.###.###T
.#...#...#.#...#...#.#.q...#...#...
.#.###.###.###.#.###.#.#R###.###.#.
.#...#.#..c#.#.#.....#...#.....#.#.
.###.#.#.t##.C.#####.###########.#R
.#...#.#.#...#..q..#.#.......#...#.
.#C###.#.###.#####.#.#.#####.#.####
.....#.q...t.....#.#...#.....#.....
.###.#####.####A.#.#####.######C##.
...#...#.AB....#.#...#...Q.........
##.###.s######.#.###.#.#####.#####.
.....#...#.........#.#.....#.#S..#.
########.B##########.#####.#.#.#.##
.......#...#.......T.......#...#...
.####a.###.#.#####.###.########T##.
.....#...#...#...#...#.......#...#.
####.###.#.###.#.###.#######.#.#.#.
...#.#!..#.#...#...#.#.....#.#.#.#.
.#.#.#######.#####.#.#.#.###.#.#.#.
.#...........#.......#@#.......#...
35 35
...........#.........#...#.......#.
####.S####.#.#######.###.#.#.R##.#.
!..#.#...#.#.#.......#...#.#.#.....
##.#.#.###.#.###.#####.#.#.#.#####.
.#...#.#...#...#.......#.#.#...#...
.#####.#.#####.#.#######.#.###.#.##
.....#...#.....#.#.....#.#.#.#.S.#.
.###.#.###.#.#####.###.###.#.#.#.#.
.#...#.#...#.#.....#.#.......#.#...
##.#.#.#####.#.#####.#########.###.
...S.#.....#.#.#......T#...#...#.#.
.###.#####.#.#.###.#.###.#.#.###.#.
.#.#.....#.#.#.#...#.#...#.#.#.#...
.#.###.##a.#.#.#.###.#.###.#.S.#.##
.#.....#...#.#...#.#.#...#...#...#.
.Rs#####.###.#####.#.###.#####.###.
.#...#...#.......#.....#.#...#.c.#.
.#.#.#.###.#####.#.####s.#.#.###.#.
...#.#.#.#...#.#...#.#...#.#...#.#.
.###.#.#.###.#a#####.#.###.#####.B.
...#...#...#.#.....#.#.#.......#...
##.#####.#.#.#.###.#.#.#######.###.
...#...#.#.....#.#...#...#...#...#.
.###.###.#######.#.#####.#.#.#.#.#.
.#.....#.#...#.....A...#...#.#.#.#.
.#.###.#.#.#.#######.A.#####.#.#.#.
.#S..#.#.#.#.......#.#.......#.#.#.
.##T##.#.#.#######.#.a#####s##.#.#.
.#...a...#.....#.#.Q.#...#.....#...
.#.#.#########.#.#.#.s##.#.########
.#.#.......#...#.#.#.#...#.#@#.....
.#.#######.#.###.#.#.#.###.#.#.###.
...#....R#...#...T...#.....#...#...
####.#########.#######.##a######.#.
.................................#.
35 35
.#.............#.#.............#...
.#.b##.#######.#.#.###.#######.###.
...#...#.#...#...#...#.....#.#...#.
####.###.#.#.###.#r#.#####.#.###.#.
.....#.....#.......#...#...#...#...
.#####.##B#c####a#####.#.###.#.###.
.....T.#.......T.......#...#.#.....
####.b.#######.#.#########.#####A#.
.....#.........#.....#.....#.....#.
.############s.#####.#.###.#.###.#.
.......#.#.....#...#.#...#.#.#...#.
.#####.#.#.#####.#.#.C##.###.#.A#S.
.#.....#.#.....#.#.B.#T#.....#.#...
##.#####.#####.#.#.#.#.#######.####
...#...#.......#.#.#.......#.#.....
.###.#.#.#########.######Q.#.#####.
...#.#....T............#...#...#...
.#.#####s####S########.#.###.###.##
.#.......#.........#...#.#.....#...
.#######.#.#######.#.###.#####.###.
.#...#...#@#.....#...#...#a..#...#.
.###.#.#####.###.####a.###.#.###.#.
.....#.#...#.#.#.#...#.#...#.....#.
######.#.#.#.T.#.#.#.#.###.#.#####.
.....#...#.#...#...#.......#t#...#.
.###.#####.###.###########t###.#.#.
.#...#...#...#.#......Q#.....#.#...
.#.###.#.#.#.#.#.#####.#.###.#.###.
.#.....#...#.#.#...#.#.#.#.#.#.#...
.#############.###.#.#.#.#.#.#.####
.....#.....#...#.S...#.#.#.q.#.....
####.#.###.#.#a####R##.#.#.#.#.###.
...b.#.#.#.#.....#.....b.#...#.#...
.#####.#.#.#####.q.#####.#.#####.#.
.......S.#.........#!....#.......#.
35 35
.........#.....#.....#.........#...
.#####.#.###.#.#q#####.###.###.###.
.#.....#.....#.#.#.......#.#.#.....
.#.#####c#####.#.#.#######.#.#####.
.#...#...........#...#...#.#.....#.
.###.#############.###.#.#.#.#####.
...#.#.......#.....#...#...#.....#.
##.S.#.###bc.#.#####.#########Q#.#.
.#.#...#.....#.....#.#...........#.
.#.#####.#####.#####.###.#.#.#####.
.#.#.#...#...#.#...#...#.#.#.#.....
.#.#.#.###.#.#.#.#.###.###.#.#.#B##
.....#.....#.#.#.#.....#t..#T#.....
.########t##.#.#.#######.#.#######.
.#.#.......#.#.#...#..q..#.#.....#.
.#.#.#####.#.#.###.#.#####.#.###.#.
.#.#.....#...#.#.#.#C#.....#q.A#.#.
.#.#####.###.#.#.#.#.R########.#.#.
.......#...#.#.#.#.#.#..S......#...
#######S.#.#.#.#.#.#.#.#########.##
.......#.#.#.#.#.#.#.......#...#..R
.#####.###.###.#.#.######R##.#.###.
!#...#...#...#...#.#.........#.#...
####.###.#.#.###.#.#.#########.#.##
.......#.#.#.....#...#.......#.#R#T
##.#####.#.###########.###.###.#Q#.
...#.....#.........#...#@#.#...#...
.b.#.####Q########.###.#.#.r.##c##.
.#.#.#.................#...#.#...#.
.###.#r#######.############C.SA#.#.
.....#...#...#...#.........#.#...#.
.#########.#.#####.#######.#.#.###.
......r..#.#.....#.#.#.....#.q...#.
########.#.#####.#.#.#.##t##.#.B.#.
...........#.......#.........#.#...
35 35
...#.....................#.......#.
.#.###########.#########.#.#####.#.
.#.........#...T@......#.#...#.#...
.#########.#.#########.#.###.#.###.
.#...#...#.#.......#...#...#.#.....
.#.#.###.#.#.#####Q#.#####.#.#.####
...#...#.#.#...#...#.....#...#...#.
.#####.#.#.#####.#######.######T.#.
.#...#.#.#.#.....#.....t.....#...#.
##.S.#.#.#.#.#######.#.#.###.#.###.
...#...#...#.#.......#...#.#.#.#...
.#######.###.#.##r########.#.#.###.
.#.....#.#...#...#.#.....#...#...#.
.#.###.#.#.#####.#.C.#S#.#.#####.#.
.#...#.#...#.....#.#...#...#...#.#.
.###.#.#####.#####.###.#####.#.#.#.
...#.#.....#.#...#...#.#.....#.#...
##.#.#####.#.B.#.#.###.#.#####.#B#.
...#.#...#.#.#.#.#.....#.#.......#.
.###.#.#.#.#.#.#.#.#######.###.###.
.....#.#...#.#.#.#...#...r.b.#.#...
######.#####.#.#.###.#.#.#.#.#.#.##
.......#.#.....#...#...#...#...#.#.
.#.#####.#.#######.#############.#.
.#.#...#.........#.#...#.......#...
.###.#.###########.#.s.#.#####.###.
...#.#.......#...#...#...#.#.....#.
.#.#.#######.#.#.#.#######.#.#####.
.#...#...#...#.#.#.........#.....#.
.#####.###.#.#.#.Ta#######.#####.#.
.#...#.#...#.#.#.....Q...#.#.....#.
c#.#.#.#.#####.#####.#.#.#.#.###.#.
...#...#.#..q#.#...#.#.#...#...#.#.
######.#.#.#.#.#.#.#.###.#####.###.
.......#...#.....#.#..!#.....#.....
35 35
...........#.......................
C#####.#####.#.#####.#############.
.#...T.#.....#.#.....#...#...#.....
.#.#.###.#####.#.#####.#.#.#.#.##s#
...#.....#...#.#.#...#.#...#.#...#.
.#########.#.#.#.#.###.#####.###.#.
.....#!..#.#...#...#...a.#...#.#...
.#######.#.#########.###.#.###r###.
.#.....#.#.#...#...#.#...#...#...R.
.#.#.#.#.#.#.#.#.#.#.s.#.###.#.#.#.
.#.#.#.#.#...#...#...#r#T..#.#.#.#.
##.#.#.#.#.######q######.#.#.#.###.
...#.#.#.#.#......a......#.#.#.....
.###.###.#.#.######c######.#.###.##
.q...#...#.#A#...#.....#...#...#...
.#.###.###.#.#.#.#####.#.#####.###.
.#.....R.#.#.#.#.c...#.......#.#..C
.#####A#.#.#.#.#.#.#.#########.#.##
.#.c....T#...#.#.#.#.......c...#...
.#####.###.###.#.#.#######.#.###C#.
.....#q#...#...#...#...#...#...#...
####.#.#.###.###S#####.#.###T#.#.##
...Q.#..A#.#.........#.#.#.....#.#@
.###.#.###.#########.#.#.#.#####.#.
.#...#...#.Q.#.......#...#.#...#.#.
.#.#####.#.#.#.#######.###.#.###.#.
.#.....#.#.#.#...#.......#.#.#...#.
.#####.#.#R#.###.#.#####.#.#.#.###.
.....#.#...#...#.#.#t..#...#...#...
.###.#.###.#.#.#.###.#.#####.###.#.
.t...#...#...#.#.....#.....#...#.s.
.#.#####.##a###R.####C####.###.#.##
.#.#...#...#...#.#.......#.#.#.#...
.#.#.#.###.#.#.###.#####.#.#.#.###.
.#...#.......#.....#.......#.......
