abcdefghijklmnopqrstuvwxyz-=[];/
ABCDEFGHIJKLMNOPQRSTUVWXYZ_+{}:?
OOOOOOOOOOOOOOOOCCCCCCCCCCCCCCCC
11
17 17
...#.......#....@
.#.#.#####.#.####
.#.#.C...#.#.#...
.###.#####.#.#.#.
.....S.....#...#.
.#####.#####.###.
.#...#...B...#.#.
.#.#.###.###.#.#.
.#.#...#...#...#.
.#.###.###.#####.
.#.#...#...#..!#.
.###.#.#.###.###.
.#...#.#.....#...
.#.###.#q#####.##
.#.#.#.#.....#...
.#.#.#.#.###.###.
...#.....#.......
17 17
.......#.........
##.###.#.###.###.
...#...c...#.#...
.###.#######.#.##
!#.#.........#.#.
##.###########.#.
...........#...#.
.#######.###.###.
.....r.#.....#...
####.#.#######.##
...#.R...#.......
.#.#.#.#.###.###.
.#.#...s...#...#.
.#.#######.###.R.
.#.......#...#.#.
.###.#######.###.
..@#.............
17 17
....@#...#.a.....
.#####.#.#####.##
.#.....#.....#...
.#.#########.###.
.#.#...#...#..!#.
.#.#.#.###.#####.
.#...#.#...#.....
.#####.#.#.#.###.
.#...#.#.#...#...
.#.#.#.#.#####.##
.#.#...#.#...#...
.#.###r#.#.#.A##.
...#.......#b..#.
.############t.#.
.#.........#...#.
.#.#######.#.C##.
...#.........#...
17 17
.....#@....#.....
##.#.#####.#.###.
...#.....#...#...
.#.#####.#####.#.
.#.#...#..B....#.
.###.#.#########.
.....#.......#...
##########.#.##Q.
.........#.#...#.
.#######.#.###.##
...#.....#...#.t.
##.#####.#######.
...#.Q.#.........
.###.#.#####a####
.#...#.....#.#...
.#.#######.###.#.
.........#.q...#!
17 17
...........#.....
.#######.#.#.#.#.
.....#...#.#.#.#.
######.#####.#.##
.......a...#.#...
.#######.#.#.###.
.........#.....#.
.###############.
.#...#...#.......
.#.#.#.#.#.######
.#!#...#...#.....
.###########.#.#.
.#.....#.....#.#.
.###.#.#.#####.##
...#c#.#....@#...
##.#.#.#####C###.
.....#...........
17 17
.....#...#.......
.#.#.#.#.#.#####.
.#.#.#.t.#.....s!
##.#.###.#####.##
...#.....#.....#@
.###.##s##.#####.
.#...#.....#...#.
.#.###.#####.#.#.
.#...#.......#...
.###############.
...#...........#.
##.#.#########.#.
...#.#.....#...#.
.###.###B#.#.###.
.#...#...#.#.#...
.S.###.###.#.#.c#
.......#...#.....
17 17
.#...#.........#.
.#.#.#.###.q##.#.
.#.#.....#.#.#.#.
.#.#######.#.#.#.
.#...#.....#...#.
.###.#.#####.###.
...#.#s#...#.....
.#.#.#.#C#.#####.
.#.#.#.#.#..@#...
.###.#.#.#####.##
C....C.#.........
.##r##.#.########
.#.#...#...#.....
.#.#.#######.###.
.#.#.....#...#...
.#.#####.#.###.#.
....T..#...#!..#.
17 17
.................
.#Q#############.
...#.....R.......
.###.###########.
@#...#B......#...
##.#######.###.##
...#.....#.#...#.
.###.#.#.#.#.###.
!#...#.#.#.#...R.
##.###.#.R.###.#.
...#.#.#...#...#.
.###.#.###.#.###t
.....#.#...#.#...
####.R.#.###.#.#.
.#...#.#.#...#.#.
.#.s##.###.#####.
.....#...........
17 17
.......#...#..S..
.###.###.#.#####.
..@#.#!..#.....#.
####.#########.#.
...#...#.......#.
.#.###.#.#A#####.
.#.....#...#.....
.#####.###.#####.
.#.....#...#.....
.#.#####r###.####
.r.#...#...#.....
.#.#.#.###.#.###.
.#.#.#.#...#...#.
.#.#.#.#.#######.
.#...#.#.#.....#.
.#######a#c#.#.#.
A............#...
17 17
.....#!#...#.....
.#.###.#.#.#.###.
s#.#...#T#...#...
.#.#.###.#####.a#
.#.#.#......@#...
##.#.#########c#.
...#.#...#.......
.###.#.#.#.#####.
...#...#...#.#...
##.#########.#.##
.........#...#.#.
.#######.#.#.#.#.
.......#...#.b...
.r####.#.#######.
...#...#.#.....#.
##.#.#####.###.#.
...#.........#...
17 17
.....R....@#...q.
.#.#.#.#####.#.r.
.#.#...#...#.#.#.
##.###.#.#.#.#.#.
...#...#.#...#.#.
.###.###.#####.#.
.#.#B..#...#.#...
.#.#.#####.#.###.
.#...#...#.#.....
.#####.#.#.#.####
.#.....#.#.#...#.
.#.s####.#.###.#.
.#.#.#...#.#.#.#.
.#.#.#.###.#.#.#.
.#...#.#!..#.#...
.###.#.#c###.###.
.....#...........
