abcdefghijklmnopqrstuvwxyz-=[];/
ABCDEFGHIJKLMNOPQRSTUVWXYZ_+{}:?
OOOOOOOOOOOOOOOOCCCCCCCCCCCCCCCC
7
21 21
.#...........#.......
.#.#######.#.#.#####.
t..#.......#.#...#...
####.#######.#.###.#.
.....Q...#@#.#.#...r.
.#.###.#.#.#.###.###.
.#.#...#.#.#.....#...
.###.#C#.#.#######.##
.#...#.#.#.......#.Q.
.#.###.#.###t###.#C#.
...#..s#.......#.....
.###.#.#####.#.#####.
.....#.#...#.#...#C..
######.#.#.#####.#.#Q
...#...#.#.......#...
.#.#.#t#.#R##########
.#!#.#...#...........
.###.#A###.#########.
...#.#.....#...q.#...
##.#S##a####.###.#.#.
.............#.....#.
21 21
...#.....#.......#...
.###.###.#.A##.#.#.##
...#...#.#...#R#.#...
.#.###.#.###.#.#.#C#.
.#.#...#!#...#.#...#.
.#.#.#######.#.##q.#.
.#...#.....c.#...#...
.######S.#.#.###.###.
.........#.#..@#...#.
######R###.####R##.#.
.....#.....#.......#.
.#.#.#.#####.######C.
.#.#.#.#.....t.....#.
.#.###.#.#.#####.#.#.
.#.....#.#.#.....#.#.
.#######.#.#.#######.
.#.....#.#.#.#.......
.t.###.###.#.#.######
.#...#...#.#.#.....#.
.###.###.#.#.#####.C.
.....#.....#.........
21 21
...#.........t.......
.#.#.###.###.#####.#.
@#...#...t!#.....#.#.
######.###.#####.#.#.
c......#...#.....#.#.
.#######.a##.#####.#.
...#..a..#...#R....#.
##.#.#####.###.###.#.
...#.....#..C#...#.#.
.####q##.###.#####.##
.....#...#.#.....#...
.###.#.###.#####.###.
.#...#.#...s.........
.#.###.#############.
.#...#...#.......#.#.
###s.###.#.#####.#.#.
.......#...#.#...#...
.###########.#.###.##
.#.......#...#.C.#...
.#.#####.#.#.#.#.###.
.......#...#...#.....
21 21
...........#.........
.###.#####.#.#.#####.
.#.#...#...#.#.....#.
.#.###.#.#######.#.#.
...#...#.......#.#.#.
.###.#########.###.#.
.#...#.......#.#...#.
##.###.#####.#.#.###.
...#.....#.#...#...Q.
.#####C#.#.#####.q.##
.#...#@#....S..#.#...
.#.#.#.#######.#####.
.#.#.#.......C.......
.#.#.S####.#.#######.
...#.#...#.#.........
.###.#.#.############
.#.#.#.#...#.......#!
.#.#.#.###.#.#####.#.
...#...#...#.#...#.#.
##.#####.###.#.#.#.#.
.....C.#.......#S#...
21 21
...#.....#...#.......
.#.###.#.#.#.#####.#.
.#.#...#...#.....#.#.
.#.#.a#########R.#.r.
.#...#.#.......#.#.#.
.#####.#.#####.#.###.
...#...s.#...#.#.#...
##.#####.#.#.#.#.#.B#
...A...#.#.#.#...#...
.###.#.#.#.#.#####.#.
Q....#.#...#...#@..#.
######.#######.#####.
.......#...T.#...#...
.#######.###.###.#.#.
.t.......#.....#...#.
.#.#######.#########.
.#...#...R...#.......
.#####.#.#.#.#.######
.......#!#.#...#....T
#########c.#########.
.......q.............
21 21
.........#...#.......
.#.#####.#.###.###.#.
.#...#...#.#...#...#.
.###.###.#.#.###r####
.#.#...#...#.s.#.....
.#.###.#b###.#.#####.
.#...#.............#.
.t.#.#############.#.
...#.........#...#.#.
.#b#########.#.#.###.
.#...#.....#.#.#.#.B.
##.#.###.###.#.#.#.#.
...#..!#.....#.#.#.#.
.#######.#####.#.#.q#
...#.......#@#.#.#...
##.#######.#.#.#.###.
.#.......#...#.#...t.
.#######.#####.###.#.
.....C...#.....#...#.
.###.#.###.A####.###.
...#.......#.........
21 21
.#...#...............
.#.#.B.###########.#.
.#.#.#.#.........#.#.
.#.#.#.#.#######.#.S.
...#...#...#...#.#.#.
.#########.#.#.#.#.#.
...#.....#...#.#...#.
##.#.#.#.#####.#####.
...#@#.#.....#.....#.
.#s###.#####.#####.#.
.......#..b#...#...#.
.#######.#.#####.###.
.#.......#.#.....#...
##.#######.#.########
...#...#.....#.......
.###.#.#######.#####.
.....#...#.......#...
.#######.#.##R####.#.
.#.....#.#.#.#...#.#.
.#.###.#.#.#.#.#.#.#.
...#...#.....#!#...#.
