abcdefghijklmnopqrstuvwxyz-=[];/
ABCDEFGHIJKLMNOPQRSTUVWXYZ_+{}:?
OOOOOOOOOOOOOOOOCCCCCCCCCCCCCCCC
7
35 35
.......#a........#.#.......#.#.....
#C.###.#####.###.#.#.#.###.#.#.###.
...#.#.....#.#.#.#...#.#.#.#.....#.
.###.#####.#.#.#.#####.#.#.#.Q##R#.
.#.......#...#.#.#.....#...#...#...
.#####.#.#####.#.#.#####.#S###.#.#.
.....#.#.....#...#...#.#.#...#.#.#.
a###.#######.#.#####.#.#.#.###.#.#.
...#.......#.#.......#...#.#...#.#.
.#########.#.#########.###.#.###.#T
...#.......#.#.......#.#.....#.#.#.
##.#.R######.#.###q#.#.#.#####.#.#.
...#.....#...#.#@..#...#.......#.#.
.#######.###.#.###.###########.#.##
.......#..!#.#.#...#...........#...
.#####.#a###.#.#.###.#########s###.
...#...#.....#.#.#...#.......#.....
##.#.###.###.#.#.#.#######.#.#.###.
...#.....#.#.#.#.....#.....#.#...#.
.#########.#.#.##c##.c.#########.#.
.#.....#...#.#.....#...#...#...#.#.
.#.###.#.###.#s###.###.#.#.#.#.b.#.
...#.#.#...#...#...#...#.a...#...#.
####.#.#.#.###.#.#####.#.###.#####.
.....#.#.#...#.#.....#.#...#.#S..#.
.#####.###.###.#####.#####.###.#.##
...#.......#...#.....#...#.....#...
#r.#.###s###.###.s####.#.##q##.###.
...#.#...#...#...#.....#.....#...#.
.###.#.#.#.t.#.###.#########.#####.
.....#.#...#.#...#.#...#...#.#.....
.#####.#########.#.#.###.#.#.#.A##.
.....#.#.......#...#.....#...#.#...
####.#.#.#####.#####.#########.#.##
.....#.....Q.#.................#...
35 35
.....t.....#...............#.......
.###.###.###.#####.#.#####.#.#####Q
...#.....#...#S..B.s.#...#..Ra...#.
.#.#####.#.#r#.#C###.#.#.#####.#.#.
.#...#...#.#.#.#.....#.#...#...#.#.
.###.#####.#.#.#######.#t#.#.###.#.
.#...#...#.#.#...#.#.....#...#...#.
.#.###.#.#.a.###.#.#.###.#.#######.
.#.....#.....#...#.#.#.#.#.#.....#c
.#############.###.#.#.#.###.###.#.
.#...#.........#.#.t.#T#...#...#...
.#.#.#.#########.#.###a###.###.####
.#.#...#.......#...#.....#.....#...
##.#######.#.###.###.###########.#.
...R.....#.b.#.......#...#.......#.
.###.#a#.###.#.#######.#.#.#######.
.......#...#...#...#...C...#...#...
##########.A.###.#.#.#######.#.#.#.
...#.......C...#.#.....#...#.T...#.
.#.#.###########.#######.#.#.#####.
.#...#.......q...#.#.....#...#.....
.#####.#####.#.###.#.#.#######.####
B.......R..#.#.....#.#.#...#.......
.#######.###.#####.#.###.#.#######.
...#...#.#.......#.#.#...#.......#.
##.#.#.###.###.###.#.#.#########.##
...#.#.....#...#...#...#.......#...
.###.#.#####.###.##s######T#####.#.
...#.C.S...#...#...........#...#.#.
##A#.###.r.B##.#####.#######.#.###.
...#...#.#...#.#@#...#.....#.#..!#.
.#####.#.###.#.#.#.###.##q.#.#####.
...#.#.#.#...#...#.#.#.#.#...#.....
##.#.C.#.#.#######.#.#.#.#######.#.
.....#...#...........#...........Q.
35 35
..........@#.......#.#.......#..Q..
.###########.###.#.#.#.#####.#.#.##
.............#.#.#...#.#.....#.#...
.#############.#.###.#.#.###.#.###.
.#.......#.....#.#...#.#...#.#...#.
.#####.#.#####c#.#####.###.#####.#.
...#...#...#...#.....#.#.#.......S.
##.#.#####.#.#.#####.#.#.#######.#.
.#.#...#.#.#.#S..#.#.....#.....#.#.
.#.###.#.#.#.###.#.#######.###.###.
.#...#.#.....T...#...#.....#.#...#.
.###.r.#######.###.###.#####.###.#.
...#.#.#.....#.....#!..#.#.....#...
.###.#.#.###r#####.###S#.#.###.####
.....#A#...#.#...#.#.....#.#.#.....
.#####.#.###.#.#.#.###.###.#.##b.#.
.#.......#...#.#...#...#...#.#...#.
.#####.###.#######.a.###.###.#.T###
.....#...#.......#.#...#.....#.#...
####.###.#######.#.#.#.q.#####.#.#.
.#...#.A.....#...#.#.#...#...#...#.
.#.###########.###.###.###.#.####r.
.#.......#.....#.....#...#.#.......
.#######.#.#########.s##Q#.########
...#.#...#.#.......#.#...#...#.....
.#.#.#.###.#.####R.#.###.###.c.###.
.#..Q#...#.#.#...#.#...#...#.....#.
.###.###.#.#.#.#.#.###.###########.
.c.r.#...#.#.#.#.#...#.....#.......
.#.###.##C.R.###.r##.#####.#.#####.
.#.Q...#...........#.....#...#...#.
.#########.Q############.#####.#.#.
.#.......#.#.........#...#.....#.#.
.###.###.###.######a.#.###.###.t##.
.....#.......#.........#.....#.....
35 35
...................#!Q.#.....#.....
.#####.#####.#####.#.#.#.#.#.#####.
.#...#...#.#.#...#C#.#...#.#.......
.#.#.###.#.#.#.#.##a.#####.#######.
.#.#...#.#...#.r.....#.....#.......
.#.###.#.#####.#######.#t#A#####.##
.#...#.a.#.....#...#...#.#.....#.s@
.T.#.###.#.#####.#.#.#.###.###.#.#.
.#.#.#...#...#...#...#.#.....#.#.R.
.###.#.#.###.#####.###.#.#####.#.#.
...#.#.#...#.....#.#.#...#.#...#...
##.#.#.#########.#.#.#####.#.######
...#.#...........#.#.......#.......
.###A#############.###.q##.#######.
.#.......#.....#...#q..#.........#.
.B##.###.#.###t#.###.###.#########.
.....#.#.#...#.#.#...#.Q.#.....#...
######.#.#.#.###B#.###.###.###.#.#.
...s.....#.#.......#.#.#...#.#...#.
.###.###############.#.#.###.#####.
.....#.........#.......#.#.....#...
.#####.######T.#########.#.###S#.q#
...#...#.....#...........#.#.....#.
##.#.#.#.######s##########.#.#####.
.#.#.#.#.#.....#.....#.....#.#.....
.#.q##.#.#.#.###.#.###.#.#.#.#.###.
...#...#...#.....#...#.#.#.#.#...#.
.###.###.###########.#t#.###.###.#.
.#...#.#.#...#.....#.#.#.....#...#.
.#.###.#A###.#.###.#.#.#######.##a.
...#...#...#.#...#...#.....#...#.#.
####.#####.#.###.#########.###.#T#.
.#B......#.#.#...#..Q..#...#C..#...
.#.###.###.s.#.###.###.#.###.###.##
B....#r......#.......#.......#.....
35 35
.........#.......#....b........B...
.###.#####.###.#.#.#######.#.#####.
...#...#...#.#s#.#.....#.#.#.#...#.
##.###.#.###.#.####Q##.#q#.###.#.##
...#...#...#.#....r..#.#.#.....#...
.###.#####.#.###.#.###.#.#########.
.#...#...#.#...#.#.#...c.....#.....
.B.###.#.#.#b#.#.###.#q###.#.#.####
.#...#.#...#...#...#.#.....#.#.#.b.
.###.#.#####.#####.Q.#.#######.###.
...#.#.#@....#.....#.#...#.....#...
##.#.#.#####.#.###.#q###.#.###a#.#.
C..t...#.....#...#.#.#...b.#!#...#.
.#######.#######.##q.#.#.#.#.#.####
.........#...#...#...#.#.#...#.....
#Q#a.#####.#.#.#.#.###.#.######q.#.
.#T..#.....#...#.#.#...#.#.....#.#.
.#.#b#.#####a#.###.#.#.###.#.#.###.
.#...#.#.....#.#...#.#.....#.#.....
.###.#.###.#.#.#.#####.#####.#####.
C#...#...#.#...#.....#.#...#.#.....
.#.#####.###.#######.#.#.#S#q#.##t#
.#.....#...#...#.....#.#.#...#R#...
.#.#######.#####.#######.#####.#.#.
...#.......#.....#....S..#...#.#.#.
####.###.###.#####.#.#####.#.#.B##.
.....#...#...#.....#.#...#.#...#...
.###.#####.#########.#.#.#.#####.##
...#.#...#.#...t...#.#.#.#.#...#...
##.###.#.#.#.#####.#.#.#.#.#.#.###.
.B.s...#...#...#...#.#.#...#.#...T.
.#.#.#######.#.###.#.###.###.###.#.
.#.#...#.r.#.#...#.#...#.#...#...#.
.#####.#.#.#####.#.###.#.###.#q###.
.........#.......#.....#.....#.....
35 35
...s.......#.........#.........#...
.###.#####.#####.#.###.###.###.#.#.
.#...#...#.....#.#.......#.#..t..#.
.#.###.#.#####.#.#########.########
.#.#@..#.....#.C.#...#!..#.........
.#.#####.#####.#.R##.###.#####.###.
.#.#t..#.#.....#.......#.#...#.#...
.#.#.#.#.#.###########.#.#.#.###.##
.#...#...#...#.......#.#...#...#...
.#######.###.#.#####.######C##.###.
...#.#...#.#.#.#...#...........#.T.
.#.#.#.##b.#.A.#.#.#############.#.
.#.#B#...#.#.#.r.#......t..#.....#.
.#.#.###r#.#.#.###.####S##.#.#####.
.#.....#...#...#.A.#.....#...#.....
.q########.#####.###.###.#####.####
a#.......#.....#.#.....#.#.....b...
.#.###.#.#####.#.#######.#.#####s##
.#.#.#.#.#...#...#.......#.#.......
.#.#.#.#.#.#.#####.#######.###r#.#.
.#...#.#.#.s.......#.....#.....#q#.
.###.#.###.#####.#.#.###.#####.###.
.#...#.#...#...#.#.#c#.......t.#...
.#.S##S#.###.#.#.#.#.#.#####.#.#.#.
.#.#.#...#...#.#.#.#.#...#.#.#...#.
.#.#.#####.#.#.#.###.###.#.Q.#####.
...#......c#.#.#...#.#...#.....#.#.
.###.#######.#.###.#.#.####B##.#.#.
.#...#.#...T.#...#A#.#.....#.#..b#.
.#.###.#.#######.#.#.#####.#.###S#.
.#.....#..t#...#.#.R.#..a#.#.....#.
.#######AB.#.###.#.#.#.###.#######.
.#.....S...#...#.#.#.#.#...#.......
.#.###.#.###.#.#.#.#.#.#s###.######
...#.....#..c#...#.....#...........
35 35
.....#...#.........#.........#b....
.###.#.#.#####.###.###.#####.#####.
...#...#.....#.#..C#...#.....S.....
.#.####r####.#.###.#.###.#####.#B##
.#.#.....#.#.#...#...B.#...#b......
.#.#.###.#t#.###.#####.###.#######.
.#.#...#.#.#.....#...#........Q..#.
##.###.#R#.#####.#.#.###########.#.
...#...#.#.#.....#.#.....#....A#...
.###.###.#.#.#####.####B.#.#.c####.
.#...#...#.#.#...#.#.....#.#.....#.
.#.###.###.#.#.#.#.#.#########.###.
...#...#...#...#.#.#...#.....#.....
.###.###.###.###a#.###.#.###.######
...#.#S#.....#.....#.#.#.#.#.#.....
####.#.#.T####.#####.#.#.#.#.#.###.
.....#.#.#@#...#.c...#.#...#.....#.
c#####.C.#.#.####c.#.#.###.#######.
.#.........#.#...#.#.#...#.#....a..
.#########.#.#.#.#.#.###.#.#.######
...#.....#.#.#.#...#...#...#.#.S...
C#.#.###.###.#.#######.#####.#.#.#.
.#.#.#.#.#...#.......#.#..!#.#.S.#.
##.#.#.#.#.#t#.#####.#.#.###.#####.
...#.#.#...#.#....R#.#.#.....R...#.
.###.#.#####.#.#####.######s##.#.#.
.#...#.....#...#...#.......#...T...
.#.###.S####.###.#.#.T.##C.#.#.###.
.#.TB......#...#.#.#.#.#...#.#.#.#.
.#.#####.#.#.###.#.###.#r###r#.#.#.
..rA...#R#...#...#.....#.#....r#...
.###.#.#.#####.#########.#.#####.##
...#.#.#.....#.....#...#.#...#.#...
##.#.#.###########.#.###.###.#.###.
.....#.............#.........#.....
