abcdefghijklmnopqrstuvwxyz-=[];/
ABCDEFGHIJKLMNOPQRSTUVWXYZ_+{}:?
OOOOOOOOOOOOOOOOCCCCCCCCCCCCCCCC
7
17 17
...#.....#.......
.a.#.###.#.###e#.
.#...#...#.#.....
.#######.###.###.
.......#...#.#@T.
.#####.###.#.#.#.
.#e..#...#.#.#.#.
.#.#####.#.#.#.#V
.#...#...S...#...
.###.#.#######.##
.....#.#.........
####.#.#.########
.#...#.#...#...#!
.#.###.##q##.#.#.
.#...#.......#a..
.###.############
.................
17 17
......S....F.....
.##A######.#.###.
.....Q@..#.#...#.
####.###.#.#WB.#.
.....#...#.#...W.
.#####.##u.#.###.
.#.....#...#...#.
U#.#.###.#.#.###.
.v.#.#...#.#.#...
.###.#.#####.#.##
.#...#.......#...
.#.#.#F#####.###.
...#.....#!#.#...
###A.#####.#.#.#.
...#.#.....#.#.#.
v###.#.#A#####.#.
.....#.........#.
17 17
....c...W..#.....
.V########.#####.
.#.......#.......
.#.#####.#######.
.#...#..f#.....#.
.###.#.#######.#.
.....#e..#c..#...
.###r##r.#.#.#.##
.#.....#...#.#Cf.
.a####.##e##.###.
.#.....E...#.#...
.#.###.#.#.#.#e##
...#.w.#@#.#.#...
####.#####.#.#.#.
.#...#...#.#...#.
.#.###D#.#.#####.
.......#...#!....
17 17
...........#.....
.A.########U.#.##
.#.....#.....s...
.#####.#.#######.
...#.#....@#...#.
##.#.#####u#T#.#.
.#.#.#.......#...
.#.#.#.##########
.....E.......#...
.###r#######.f.#.
.#...#.....S.#.#.
##.#.#.###.#.Ru#.
!#.#...#.#.#...#Q
.#.#####.#.w.###.
.#q....#.#.#.#...
.#####.#.#.###.d.
.......#.......#.
17 17
.....#...........
.###.#.#########.
...#.w.#.....s...
##.#.#B#B###.#.w.
.#.#...#.R.#...#@
.#.####q##.#T####
...e.....#...#!..
.##d#r##.###.###.
...#...#...#...r.
##.#.#.#.#.######
.#.#.#.#.#.......
.#.#.#.#a#####r#.
.#.#.#.#.....#...
.#.B.#.#######.#.
.#.#.#...#...#v#.
.#.#.###.#.W.#.#.
...F.#.....#...#.
17 17
.................
.#######.#.######
.#.d...#.#.......
.#.#U#.#######.#.
.#...#.#.....#.#.
.###.#.#.###.###.
E..s.#...#..s#...
##.#.#####.###v##
.#.#.#...t.#.....
.#.#.###.#######.
...#...#.#.....#.
.####W.#.#.###.#.
@#...#.#...#...#.
##.#.#.#####.###.
...#!#...#...#C..
.#######.#.###.#.
.........#.....#.
17 17
.............#...
.#s#.#######.#.#.
...#.....#...#.#.
f####u##.#.###.U.
...#.....#.#...#.
.#.#.#####.S##.#.
.#...#.b.#.....#.
.###.#.#.#######.
.#...#.#.#..!#...
.###C#.#.#.###.##
.#...#.#...#...#@
.#.#.#A#####.d##.
...#...#...#...#.
########B#####.#.
F#.....#.....#...
.#.#s#.w.#.#####.
.....#W..#.......
