abcdefghijklmnopqrstuvwxyz-=[];/
ABCDEFGHIJKLMNOPQRSTUVWXYZ_+{}:?
OOOOOOOOOOOOOOOOCCCCCCCCCCCCCCCC
7
17 17
...........#.....
.#########.#.###.
.....#.#...#...#.
.###.#.#.#####.#.
.#...#.#...#...#.
.#.###.###.#r###.
.#...#.#...#...#.
.###.#.#.#####.#.
...#Q#...#.....#.
##.#.#.###.#####.
.#.#.#...#.#.....
.#.#.#####.#.###.
.#.#.......#...#.
.#.###########.#.
...#@......#...#.
.#########.#.###.
...........#..!#.
17 17
.................
.###q#####Q#####.
...#...........#.
.#.#####a#.#####.
.#.....#...#...#.
######.#.###.#.#.
.......#.....#...
.####a#q.########
...#.#...#.......
.#.#.#.###.#####.
.#.#.#.....#...#.
.#.#.#######.#.#.
.#.#.....#...#.#.
.#.#.#.###.#.###.
.#.#.#...#A#.#...
.#.a.###.#.#.#.##
.#!#..@#...#.....
17 17
...#.............
.###.#####.#.####
.....#...#.#.....
.#####.#.#.#####.
.#!..#.#.#.#...#.
.###.#.#.###.#.#.
...#...R...#.#...
##.####q##.#.###.
...#...#.#.#.#...
.###.#.#.#.#.####
.#...#...#.#.....
.#.#.#####.#.###.
...#.#...#.#...#.
####.#.#.#.###.#.
.....#.#...#...#.
.#####.#########.
....@#...........
17 17
.........#.......
.#####.###.#####.
.#...#...#...#...
.###.###.#.###.#.
.......#...#...#.
######.##Q##.####
.#...#.....#.#!..
.#.#.#####.#.###.
...#.....#.#.....
.#####.###.######
.....#.....#.....
####.#########.#.
...#.#.......#.#.
.#.#.#.q####.#.#.
.#.#.#...#@#.#.#.
.###.###.#.#.###.
.........#.......
17 17
.#......@#.......
.#.###.###.###.#.
.#...#.....#.#.#.
.###.#######.#.##
.....#.#.....#...
.#####.#.#.#####.
...#.....#.#..!#.
##.#.#####.#.###.
...#.....#.#.....
.###.#####.######
.#.#.#...#.......
.#.#.#.#.#####.#.
.#...#.#.......#.
.#####.#########.
.....#.....#.....
####.#####.#.####
...........#.....
17 17
@#.....q.....#...
.a.#####.#####.#.
.#.#...#.......#!
.#.#.#.##########
.#.#.#......q..#.
.#.#.#####.###.#.
.#.#.#...#.#.....
.#.#.###.#.######
.#.#....a#q......
.#.#############.
.#.#...........#.
.#.#.#########.#.
.#.#.#...#...#...
.#.#.#.#.#.#R###.
.#...#.#.#.#.....
.#####.###.######
.................
17 17
.....#...........
.###.#.#########.
...#.#.Q...#.....
.#.###.#.###.###.
.#...#.#.#..a#@#.
####.#.#.#.###.#.
.....#...#.#...#.
.#######.#.#.###.
.#.......#.#.....
.#.#######.#.#r##
...#.......#...#!
.###.#.#########.
.#...#.#.......#.
.#.#####.#####.#.
.#.....#.....#...
.#####.#####.####
A....#...........
