abcdefghijklmnopqrstuvwxyz-=[];/
ABCDEFGHIJKLMNOPQRSTUVWXYZ_+{}:?
OOOOOOOOOOOOOOOOCCCCCCCCCCCCCCCC
7
33 33
.......#.....#.#...#...#.....#...
.#.###.#.###.#.#.#.#.#.#.#.###.#.
.#.#@#...#...#.#.#...#...#...#.#.
t#.#.#####.###.#.###########.#.#.
...#.....#...#.#.......#.....#.#.
.###.#######.#.##t.#####.#####.#.
.#...#........Q..#.#...#...#...#.
.#.###.###########.#.#.###.#.###.
.#.....#...#.......#.#...#...#.#.
.#.##Q##.#.#.#######.###.###.#.#.
.#...#...#...#.....#...#...#...#.
.###.#.#######q###.###.###.#C###.
.c...#.#.........#...T...#....!#.
.#####.###.#####.#.#B###.#######.
....c#.b...#...#.#.....#.#.....Q.
.###.#.#.###.###.#.###.#.#.#####.
...C...#...#.....#.#...#.#.#...q.
#qQ#####.#.#.#######.###.#.#.#.#.
.q.....#.#.#.#.......#...#.#.#.#.
.#####.###.#.##a.#####.###.#.#.#.
...#...#...#.#...#.....#...#.#...
.#.#.###.###.#.###.#####.###.###.
.#.#.....#R..#.#...#.......#.#...
##.##R####.###.#.#########.#.###.
...#...........#.#...#...#B#...#.
.###.###########.S.#.#.#.#####.##
.....#...........#.#...#.....#...
A##A##.###########.#########.Q##.
...#.Q.#...........#.#.......#...
##.#.#.#.###########.t.#C#####.#.
...#.#...#.....#...#...#.......#.
.###.#######.#.#.#.#.#####.#####.
.............#...#.#.......#..s..
33 33
.....a.#...............#.#.......
.#.###.#.######S######.#q#.#.###.
.b.#...#...s...........#...#...#.
.#.#.###.#.###.###T#########.#.#.
.#.#.#...#...#.......#.....#.#.#.
#A.#.#######.#######.#.###.#.#.#.
...#.#.......#.....#.#...#.#.#.#.
.###.#.##R########.#.###.#.###.#.
.#...#.#...#.....C.#.....#.#...#.
.#.#S#.###.#.#.##########B.#.###.
.#...#...#...#.....#.....#...#.#.
.###.#.#.#####.###.#.###.#####.#.
.#.#.#.#.....q.#...#.#.#..b......
.#.#.#####A#.#.#.###.#.##########
.#...........#.#.....#R..#.....#.
.##a##########.#######.#.###.#.B.
.....#.....#.t.#...#...#.....#...
####.#.###.#.###.#.###.#########.
...#...#...#.....#...#.....#.#...
.#######.###########.#####.#.#.##
.......#...#.......#.......#.#.#.
.#####.###.#.##T############.#.#.
...#.....#.#.......#.C.....#.#.#.
.###.###.#.###.###.#.###.#.#.#.#.
.#...#...#...#.#@#.#.#...#...#...
.#.#########.#.#.#.#.#.#########.
.#...#.......#...#...#...#.......
.###.#.#################.#.S#####
.#.#.#!#.#......B........#.#...#.
.#.#.###.#.#.#############.#.r.#.
...#.....#.#.#...#...#...#...#.#.
##.#.#####.#.#.#.#.#.#.#.#####.#.
...#.......#...#...#...#.........
33 33
...#.......#.#.......#.......#...
.#.#.###.#.#.#.###.#.#.#####.#.##
.#.#...#.#...#...#.#...s.....#...
.#.###.#.#######.#.##R##.###s###.
@#.....#.........#...#...........
R###################.############
...................#...#.........
.#.###############.#.#.#.###B###.
.#.#.....#.....B...#.#.#.......#.
.#.#.###.#.#####.#####.###.#####.
.#.#...#.#.....#.......#...#!#...
.#.###.#.#####.#.#######.###.#.##
.#.#...T.....#...#.....#...#.#.#.
.#.#.#######.####a.###.#.#tC.t.#.
.#.#.....#.#.......#.#...#...#.#.
.#######.#.#########.#####.###.#.
.......#.#.#.....#.....#...#...#.
.###.###.#.#.A##.#.###.#.q####.#.
.#.#.....#...#...#.#.#.#.......#.
.#.#######.###.#.#.#.#.#########.
.#.......#.#...#.#.#.#...........
.#.#####.#.#.####t.#.###########.
.#.#.#...#.#.....#.#...#.......#.
.#.#.#.#########.#.#.###.#####.#.
...#...#.......#.#.#...#.#...#.#.
####.#####.###.#.#.###.#.#.###.#.
...#.#.....#...#.#.#...#.#...#...
##.#.#.#####.r##.#.#.#a#.#.#.###.
...#.#...#.#...#.....#...#.#...#.
.#.#.A.#.#.#b#.#######.C###t##.#.
.#.#.#.#.#.#...#.......t.......#.
.###.###.#.#.###.#######.#.#####.
.........#.......A.......#.......
33 33
.....#...#.......#.........#.....
##.#.#.#.#.#####c#.Br#.###.###.#.
...q...#.#.....#...#.#...#...#.#.
.#######.#####.#.###.##R.###.#.#.
...#...........#.....#...#.#...#.
##.#####.#####.#####.#.###.#####.
...B...#.#...#.#.....#.#.........
.###.#.###.#.#.#.#####.#.##A#####
.#...#.....#.#.#.#...#.#.#...#...
.#.########s.###.#.#.#.#.#.#.#.#.
...#.......#.#...#.#.#.#...#.#.#.
.#####.###.#.#.###.#.#.#######.#.
.......#.b.#...#@..#.#...#.....#.
########.s.#####a###.C##.#.#####.
.R.#.....#...#.........#...#...#.
.###.#.#####.#.#.###########.#.#.
..c..#.#.......#.#..A..#...#.#...
######.#.#######.#.###.#.#.#.###.
.q...#.#...#...#.#.#.#...#...#.#.
.###.#.###.#.#.###.#.B########.#.
...#...#.#.#.#.....#.....#.......
.#.###.#.#.#.###########C#.######
.#.#.#.#.#.#.Q.........#.........
.#.#.#.#.#.#######b###.#########.
.#.#.....#..a#C....#.#.......#...
.#.#####.###.#.###.#.#######.#.##
.#.....#.#...#.#.....#.......#...
.#####.###.###.###a#.#.#.########
.....#.....#.....#...#.#.#.......
####.C########.#.#####.###.#####.
...#.........#.#.....#...Q.#!....
.###########.#######.###.#.######
.......................#.........
33 33
.........#.........#...#.......c.
.###.#####.#####.c.#.#.#######.#.
...#........a#...#.#c#T......#.#.
##.#Q########B.A##.#.#######.#.#.
.#.....#.......#.....#.....#.#.#.
.###.###.#############.####S.###.
.#...#...#.........#.....#...#...
.#.###.###.#######.#####.#.##q.##
.#.#.#...#...#.....#.....#...#...
.#.#.###.###.#.#####.###.###.###.
T#.#...#...#.#.#.....#.CQ..#.#...
.#.A##.#.###.#.###.#.#######.#.##
Q#...#.#.....#...#.#.#.......#...
.###.#.#########.###.#.#########.
.#...#.......#@#...#...#.......#.
.#.###.#####.#.###.#.#####.###.#.
.#.....#.c.....Q...#.#.B...#.#...
.#######.#.#####.###.#.#####.###.
...#.....#...#...#.#...#...#..c#.
.#.#.##Q.#.###.###.##T####.#.#.#.
.#...#.#.r.#...#.......B...#.#...
.#####.t#bT#.#######.#######.####
...#..S....#.......#.............
##.#.#############.#.########C###
..s#.#.......#.....#...#...#.....
.###.#.###.###.#.#######.#.#.###.
...#.....#...#.#.#.......#...#...
##.#.#######.#.###.###########.#.
...#...#r..#.#...#.#.....#.....#.
.######R.s.#.###.#.#.#C#.#.#####.
.....#...#...#...#.#.#.#.#...#.#.
####.#.#####.#.###.###.#####.#.#.
.......#.....#.........#!....#...
33 33
.#.....#...#...b...B...#...#.....
.#.#.#.#.#.##r#T.#.#.#.#.#.#.###.
.#.#.#.#.#.....#.#.#.#.#.#...#...
.#.#.#.#.#####.#.#.###.#.#####.#.
...#.#...#...#...#...#...#.#...#.
.c##.#####.#.#######.#.###.#.###.
.#.#...#...#.#.......#...#.#...#.
.#.###.#.###.#####.#####.#.###.##
.#...#...#...#...#.....#.#...#...
.#.#.#####.###.#.##B##.#.#.#.###.
.#@#...#...#...#...#.#.#...#...a.
.###.#Tc.###.#####.#.#.#####.###.
.....#.#.......#...#...#.....#...
####.###########.###.######S.#.##
...#.#.....#.....#.#.T.....#.#...
.##Cr#.###.#.#####.#.#.###.#.###.
.....#.#.#.#.#.....#...#...#...#.
.#####.#.#.#.#.###.#####.#####.S.
.#...#.#.....#.#..s..#...#.t.#.#.
.###.t.#.#####.#.###.#.#CR##.#.#.
.....#.#.#...#.#b#.#.#.....#.#.#.
####.#.###.#.#.#.#.b.Q####.#.#.#.
...#.#.....#.#.#.#...#.....#...#.
.#.###.#####.#.#.###.#.#########.
.#...#...#...#.#...#.#...#.....#.
.#T#.###.#.#######.#r###.Q.#.#.#.
.#...#...#.......R.#.#...#.c.#.#T
.#.#####.#Q#####.#.#.S.####B.#.#.
.#.....#.#.....#.#.#.#.....#.#...
.#####.###.###.#.#.#######.#.###.
..!#.#.q...#.#.#.#.......A.#...#.
####.######c.T.#.#.###.###.###.#.
.................#...#.........#.
33 33
.....#.......#.........#.........
.#####.#c###.#.####T.#.###.#####.
...#...#...#...#...#.#.....#.#...
.#.#.###.#.#######.#.######S.#.##
.#.......#.#...#...#.....#...#.#.
.#A#######.B.#.#.#.#####.###.#.#.
.#...#...#.#.#C#.#.r...#...#...#.
.#.#.###.#.#.#.#.###.#.###.#.###.
@#.#...#.#.#.#.#.#...#.....#.....
##.###.#.#.#T#.#.#.b######.#####.
...#.#.#.#...#..q#.#.......#...#.
.###.Q.#.###.##C##.######R##.#.##
...#...#.#...#...#.#.......#.#...
##.#.###.#.###.#.#.#.#####.#.###.
...#.#.......#.#...#.#...#.#.#...
.###.#########.###C#.#.#T#.#.###.
...#.....#...#...Q...#.#...#...#.
.#.#a###.#.#.###.#.###.#.#####.#.
.#.#...#...#....S#.#.#...#.....#.
##.#.#####.#######.#.#.###.#####.
...#...a...#...#!..#...#...#.....
.###########.#.#####.###.###.####
.............#.....#.#...#...#...
.############s####.#.###.#.#####.
.#...........#..q#.#.#...#.#.....
.#######.###.###.#.#.#.###.###.#.
.#.....#...#.....#.#...#.#.....#.
.#.###.#.#.#####.#.#####.#######.
q..#.#.#.#.#.Q...#.....#.........
####.#.###.T.#########.#.########
...#...#...#....Q#.#...#r#.......
.Q##.###.#######.#.#.###.#.#####.
.........#.........#.......#.....
