abcdefghijklmnopqrstuvwxyz-=[];/
ABCDEFGHIJKLMNOPQRSTUVWXYZ_+{}:?
OOOOOOOOOOOOOOOOCCCCCCCCCCCCCCCC
7
9 9
.....#...
.###.#.#.
t#.....#.
.#.######
.#@#!....
.#######.
.#.......
.#.##B###
.........
9 9
...c.#!#.
.A.#.#.#.
.#A..#.#.
.#####.#.
.....#.#.
.###.#.#.
...#.#.#b
##.#.#.#.
@..#.....
9 9
.....#...
.###.#.#.
...#.#!#q
.#c#####.
.#.....#.
.#####.#.
.#.C.#...
.#.S.##q#
...#....@
9 9
...#..a#.
##.#.#.#.
...#.#!#.
.###.s##.
C#...#...
.#.###.#.
.#.#...#.
.#.###.#.
c......#@
9 9
...R.#..@
.#S#.#T##
...#.#...
.#.#.###.
.#.#B....
##.######
...#....!
.###.####
.........
9 9
.#.......
.#.#####.
.#.#.#...
.#.#.#.##
.#.#.#..s
.#.#.#QS.
.#!#.....
.###.####
........@
9 9
.#.......
.#.#A###.
...#.#@..
.###.##T#
.#.#r....
.#.#####.
Q....q.#.
####.#.#.
.S.....#!
