abcdefghijklmnopqrstuvwxyz-=[];/
ABCDEFGHIJKLMNOPQRSTUVWXYZ_+{}:?
OOOOOOOOOOOOOOOOCCCCCCCCCCCCCCCC
7
17 17
...............#.
######.###.###.#.
.....#...#...QR..
.###.###.###.###.
...#...#...#...#.
.#.###.###.###.#.
.#.#.#...#...#.#.
##.#.###.###.#.##
...#...#...#.#...
.###.#.###.###.#.
...#@#...#...#.#.
.#.#####.A##.###.
.#...#...#...#...
.###.#.###.###.##
.#...#.......#...
.#.#########.###.
.#......!#.......
17 17
.A.....#.........
######.#.#######.
.......#!#.....#.
.#####.##R##.#.#.
.#...#.#.....#.#.
.#.#.#.#.###.###.
...#.#...#@..#...
.###.#########.##
...#.#.......#.#.
.###.#.#####.#.#.
.#...#.#...#...#.
.#.##A.#.#.#####.
.#.....#.#.....#.
.#########.###.#.
.#.........#.#.#.
.#####r#.###.#.#.
.........#.......
17 17
.#.........#.....
.#.###.###.###.#.
.#.#@#.#.#.r...#.
.#.#.#.#.q######.
...#.#.#.#...#...
.###.#.#.#.#.#.##
...#.#.#...#.....
##.#.#.##########
.a...#...........
.###########.###.
.#.........#...#.
.#.#######.###.#.
.#.#.....#.#...#.
##.#.###.#.#.###.
...#.#.#.#!#.#...
q###.#.#.#####.#.
.....#....a....#.
17 17
.....#!#.....#...
.#####.#.###.#.#.
.#.....#.#...#.#.
.#.#####.#####.#.
.#.....#.#.....#.
.#####.#.#.#####.
...#...#...#@#...
.#.#.###.###.#.##
.#.#.#.#...#.#...
##.#.#.###.q.###.
...#.#.........#.
.###.###########.
.....#...#.....#.
.#####.#.#.###.#.
.....#.#.#.#.#...
####.#.#.#.#.###.
..Q....#...#.....
17 17
!#.....#.....#...
.###.#.#.###.#.#.
.#...#...#.#.#.#.
.#.#######.#.#.##
.#.......#...#...
.#.##r##.#.#####.
.#.....#.#.#...#.
.###.###.#.#.#.#.
...#.#...#...#.#.
##.#.#.#######.#.
.#.#.#.#...#...#.
.a.#.#.#.###.###.
.#.#@#.#.#...#...
.#.###.#.#.###.#.
.#.#...#...#...#.
.#.#.###.#####.#.
.....#.........#.
17 17
.....#...#.......
.#.#.#.##r.###.##
.#.#...#.....#...
##.#.###.#####.#.
...#.#...#!..#.#.
.#.###.#####.###.
.#.#...#...#...#.
.###.###.#.###.#.
.#...#...#...#.#.
.#.###.#####r#.#.
.......#.......#.
.#######.#######.
.#.......#...#...
.#.#######.#.#.##
.#.........#...#@
.###############.
.................
17 17
.#.....#.........
.#.###.#.#######.
.#.#...#...#...#.
.#.#.#.###.#.#.#.
...#.#...#.#.#...
.###.#####.#.####
.#...#.....#.#..@
##.###.#####.#.##
...#...#...#.#...
.###.###.###.a#Q.
.....#.....#..!#.
.#########.#####.
...........A.....
#####q####.###.#.
.....#...#...#.#.
.#.#A#.#.###.###.
.#.....#.........
