abcdefghijklmnopqrstuvwxyz-=[];/
ABCDEFGHIJKLMNOPQRSTUVWXYZ_+{}:?
OOOOOOOOOOOOOOOOCCCCCCCCCCCCCCCC
9
17 17
.................
.T######.#######.
...#.....#.....#.
##.#.#.###.###.#.
...#.#.#...#...#.
.###.#.#.###.###.
...#.#.#...#.#.A.
##.#.###.###.#.#.
...#...#.#...#...
.#####.#.#.#.####
...#.#...#.#.C...
##.#.#####.###.#.
...#.....#.....#.
.#######.#######.
...#.......#.#...
##.#.#####.#.#.##
.....#@......#..!
17 17
.....#.....#!..#.
.#.#.###.s.###.#.
.#.R.....#...#.#.
##.#######.#S#.#a
...#.......#...#.
.#C#####.###.###.
.#..A..#...#.#...
.#.###.#####.#.#.
.#.#.#.#...#.#.#.
.#.#.#.#.#.#.#.#.
.#.#.#...#...#@#.
.#.#.###########.
.#.....#.........
.#####.#.#######.
.......#.....#.#.
.###########.#.#.
.............#...
17 17
...#.#...........
.#.#.#.#########.
.#.#R#.#...#.#...
.#Q#.#.#.#.#.#.##
.#.#.#!#.#...#.#.
.#.#.###.#####.#.
.#.......#.....#.
.#####.###.#####.
.....#.#...#.....
.###.#.#.##Q.###.
...#t#.#...#.#...
##.#.#.###.#.#.##
@#.#.#...#Q..#...
.#.#.###########.
...#.#.........#.
.###.#.###.#R###.
...#.....#C......
17 17
.#...#.......#...
.#.#.#.#.###.#.#.
...#...#.#.bB#.#.
########.#.#.#.#.
.........#.#...#.
.#.#######.#####.
.#.#.....#.#.....
.#.#.###.#.#.####
.#.#.#.#.#...#...
.###.#.#.#.###.#.
.#...#.#.#.#...#.
.#.A##.#.#.#.###.
.#.....#.#...#.#.
.#####.#.#####.#.
.#...#.#..!#.....
.R.#.#.##T##.####
...#...#........@
17 17
.................
##########.#####.
...........#...#.
.#.###########.b.
.#.#.........#.#.
.#.#.#######.#.#.
.#.#.......#a#...
.#########.#.####
...........#...#!
.#############.#.
...#.........#...
##.#######.#.####
...#.....#.#.#...
.###.##a.#.#.###.
.#...#.#...#.#...
.C.Q##.#####.#.#.
...#...........#@
17 17
.S......R....#...
.#########.#.###.
.#.q....r#.#.....
.#.#####.#.#####.
@#.#...#c..#.....
##.#.#######.####
...#...#.....#...
.###.#.#.#####.#.
!#...#.#.....#.#.
######.#####.#.##
.........#...#...
.#.#######.#####.
.#.R...#...#.a...
.###.#.#.b##.#.#.
.....#...#...#.#.
.#############.#.
.r.............#.
17 17
...#....B#...#...
.#.##c.#.#.#.#.#.
.#...C.#...#.#.#.
.#########.B##.#.
.#..t..#...#...#.
.#.#cR.#####.###.
.....#...#...#.#.
.#######Q#.###.#.
.#!#...#.......#.
##.#.#.#.Q######.
...#.#.#..@#...#.
.###.#.#####.#.#.
.#...#...#...#.#.
.#.#####.#.###.#.
.#...#.#.C.#.#...
.###.#.#.s.#.###.
.....#.....#...T.
17 17
...#..s....#.....
.#.#.###.###.###.
.#...#...#.....#.
.#####.###.#####.
.#.....#...#...#.
##.#####.###.#.#.
...#.......#.#...
.###.####R##.####
.#...#.#...#.....
.#.###.#.#.#.###.
...#...#!#.#.#...
.###.#####.###.##
...#.....#.#...#.
##.#####.#.#.###.
@#.....#.#...#...
.#####.#.####B##.
.................
17 17
....@#.......#Q..
.#.###.###.#.#.#.
.#.#...#...#...#.
##.#.###.#######.
.T.#.#...#...#.R.
.###.#.#####.#.##
.#...#.#...#.#...
.#.###.#.#.#.#T#.
.a...#.#!#.#.....
.###.#.###.#.####
...#.#...#.#.#t..
##.#.#.###.#.#.#.
...#.#...#.#.#.#.
.###.###.#.#.###.
.#...#.#.#b#...#.
.#.###.#.#.###.#.
.......#...#.....
