abcdefghijklmnopqrstuvwxyz-=[];/
ABCDEFGHIJKLMNOPQRSTUVWXYZ_+{}:?
OOOOOOOOOOOOOOOOCCCCCCCCCCCCCCCC
11
17 17
.....#.........#.
##.#C#.#######.#.
c..#...#...#.#.#.
.#######.#.#.#.#.
.#.......#...#...
.###.#.#####.###.
.Q.#.#.#.c.....#.
.#.###.#########.
.#...#.....#.....
####.#.r##.#.###.
.....#A..#.t.#!#.
.#####A###.###.#.
.........#...#.#.
.#######.#.###.#.
.....#...#.#...a.
####.#.##c##.###.
@....#....r.b#...
17 17
.......#.........
.#####.#.########
...#.....#.......
##.#######.#####.
...#...........#.
.#.#.###########.
.#.#.#.#!....#...
.#.#.#.#####.#.##
.#.#.#t..#..q#...
.###.#.###.#####.
...#.#.#...#...#.
.#.#.#.#.##t.#.#.
@#.#.#.#.#...S...
##.#.#.#.#.#####.
...#.#.#.#.....#.
.###.#.#.#####.#.
.......#.......#.
17 17
.................
.#######.#######.
.#.......#.......
##.#############.
...#..........!#.
.###.###########.
.#...#.......#...
.#.#a###.#.a##.##
...#.....#.#...#.
######.###.#.###.
.t.....#@..#....R
.###.###########.
...#.#...A.#...#.
##.#.#.q##.#.#s#.
...#.#.#.#...#...
.#####.#.########
........B........
17 17
.......#@........
.#.###.####S##.#.
.#.#.#.....#T..#.
##.#.#####.#.###.
...#.........#...
.###.#########.##
.#...#.......#...
.####r.#####.####
.......#...#.....
.Q######.#.#.###.
...#...#.#.#.#...
##.#.#.#.#.###.#.
...#!#...#.#...#.
.#########.#.####
.#.........a.....
.S.##C##########.
.#...............
17 17
.......#.........
##.###.###.#####.
...#!#.....#...#.
.###.#######.###.
...#.......#...#.
##.###B###.#.#.#.
...#.....q.#.#...
.###.###.#.#.####
...#.#.#...#.#...
##.#.Q.#####.#.#.
@#...#.....#...#.
.#####.###.S####.
.#.....#.....#...
.#.#####.###.#.#S
.#.#...#...#.#...
.#.###.###.#####.
.........#.......
17 17
.......#!#.......
.#####.#.#.#####.
.....#.#...#.....
.###.#######.####
...#.#.....#...S.
####.#.#.#####.#.
.....#.#.....#.#.
.##S##.#####.#.#.
.a.....#...#...#.
.#.#######.#####.
...#.....#.......
.###.T.#.#.#.####
...#.#.#.#.#.....
##.###.#.#######.
.#.#...#.......#.
.#.#.#########.#.
.c...#@..........
17 17
.........#.......
.#.#####.#.####S.
.#.#.#.....#.T...
.#.Q.#.##########
.#.#.....#...#...
##.#######.#.#.#.
...#.......#.#.#.
.###.##t####.#.#.
...#.......r...#.
.#.####C##.#####.
.#.......#..!#.#.
.#####.######t.#.
...#.#...........
##.#.#q##########
.#.#...B.........
.#.#.#.#####.###.
.....#.......#@..
17 17
.....#...........
.#.B##.S########.
t#.#...#.....#.#.
.###.###.###.#.#.
.#...#.....#...#.
.#.###.###.#####.
.T.#.#.#...#.....
.#.#.#.#.C##.####
.#!#...#...r...#.
.###.#####.###.#.
...#.#..@#...#...
.###.#.#####.###.
.....#.#...#...#.
.#b###.#.#.#.###.
.#...#...#.#.Q.#.
.#.#.#####.##S.#.
...#....S....#...
17 17
.c...#.....#@#...
.#.#.#.###.#.#.#.
.#.#...#...#...#.
.#.#####.#######.
c..#...#.#.......
.#####.#.###.###.
.......#...#...#.
######.###.###.#.
.....#...#...#.#.
.###.###.###.#.##
.#.#...#.#.#.#...
.#.###.#.#.#.###.
.#....T#.#.#..!s.
.#.#####.#.#####.
.#...#...#...#...
.#####.###.#.###.
...........#.....
17 17
.....#!..#.......
.#######.#.##a##.
.#.......#.....#.
.#.b########.###R
...#...r...#.#...
.###.#.#.###.#.#.
...#.#.#.#...#.#.
##.#.#.#.#.###.#.
.#...Q.#.....A.#.
.#####.#######.#.
.....#.......#.#@
.###########.#.##
.#.......#...#...
.#.###.#.#.###.#.
.S...#.#.#.#...#.
.###.#.###.#####.
.....#...........
17 17
...#.....#.......
.###.#.#.###.#.#.
.#...#.#...#.#.#.
.#.###.###.###.#.
...#.c...#.#...#.
.###.###.#.#.#q#.
.....#...#.#...#@
######.##t.###.##
.......#.#...#...
.##s####.###.###.
.#.........#.....
.#####B#.#.#####.
.#!....#.#...#...
a####q.#.#####.##
.....#.#.......#.
.#.###.#.#######.
.#.....#.....C...
