abcdefghijklmnopqrstuvwxyz-=[];/
ABCDEFGHIJKLMNOPQRSTUVWXYZ_+{}:?
OOOOOOOOOOOOOOOOCCCCCCCCCCCCCCCC
7
17 17
.....#...........
.###.#.#.#######.
...#...#.#...#.w.
.###a###.#.#.#.##
.#.......#.#.#.#.
.#.###U#R#.#.#f#.
.#.........#.#...
.###########.####
.#........@#.....
.###.##W########.
...#.........#!#.
##.##W##.###.#.#.
D..#...#.#...#..q
.##R.#.###.#.####
.#...#.#...#.Tx..
.#.###.#.###.#.#.
...#.....#.....#.
17 17
@......#.........
#u##U#.#.######Xu
.......#.....#...
.######g####.#.#.
.#.....#...#.#T#.
.#.###.#.#.b.B.##
.....#...#...#...
##############.#.
.......#.....#.#.
.#####.#B###.#.#.
.....#...#...#.#.
.###.#####d#####.
...#...#...#...#.
##.###.#.###.#.V.
.#...#.#.#...#.#.
.#.###.#.#.###.#.
...#!..#...#.....
17 17
.#.......#..G....
rE.#.###.#.#####.
.#.#...#.#@#...#.
b#.###.#.###.#.#.
.#.#...#...#.#w..
.#.#.#####.#.###.
.x.#s#...E...#.#.
.#.#.#########.#.
.#.#.C...#...#...
.#B#####.#.#.#.##
...#...#...#.#...
.###.#.#####.####
.#...#.....#.R...
.###.##E#W.#####.
.b...#.....#...#.
.#.#########.#.#.
...#!........#..A
17 17
....V..V.#..a#...
##.###.#.#.#.#.##
...#.#.#.#.#.A...
.###.#t#.q.#b###.
...v...#.#.#.....
.#.###.#.#.#####.
.#.U.#...#!#...#.
.###.#.#####.###.
...#.#.#.....e...
f#.#.###.e#######
@#.#.#...#V......
.#.#.#.###.#####F
.#.#.#...#.#...#A
.#.#.###.#.###.#.
.#.#...#.#...#.u.
.#.###.#.###.#.#.
X....T.......#...
17 17
.......#...#.....
##.#.###.#.#.###.
e..#.E...#.#..@A.
.#f###.###.#####.
...T...#...#...#.
##.#.###.###.#.#.
...#.#.#.#...Ev..
.#.Dc#.#.D.#.###.
.#.#...#.#.#.A.#.
.#.###.#.#.#.#.#.
F#S#...#.#.#.#.F.
.#u#.e##.#.#.###.
.....#.#.#.#...T.
.###x#.#.##X##.#.
..f...t#....!#.#.
#####TS#######.#V
...g...........#.
17 17
...#....@#.......
.#.#.#####.###.#.
.#.#.v.....#.#.#.
.#.#.#.###t#.#.#.
.#...Q...#...#.#.
.#######.#.#.#.##
.#.......#.#.v...
.#.#########.##e.
.#.........#.#...
.#########.#.#.##
.....#...#...#...
####.#.#.###.###.
.....#.#...s.#!#.
.#####.#.###.#.c.
.#...#.#...#.w.#.
.#.G.#.###.#.#.#.
...#.....r...#...
17 17
.........C.......
.#######.#.###.vw
...#@#.W.#.#.#.#.
.#.#.#.##t.#.#.#.
.#.#.#.#...#.#.#.
.#.#.#.f.###.#.##
.#.#...#.....#...
##.#.#######.###Q
...#.#.#.....#...
.#xr.#.W.#####.##
g#.#.#.#..a..#...
.W.#.#.#.#######.
.#.....#.#.r.....
.#######.#.#q###.
.........#...#.#.
.########w##.#.#.
...........#!#...
