abcdefghijklmnopqrstuvwxyz-=[];/
ABCDEFGHIJKLMNOPQRSTUVWXYZ_+{}:?
OOOOOOOOOOOOOOOOCCCCCCCCCCCCCCCC
7
17 17
...#...#.....#R..
.#.#.#.###.#.###G
.#...#.....#...#.
.#####.#######.#.
.#...#.#...#.#...
.#.#.#.#.#.#.U##.
..Q#.#.#.r.#.#...
####.###.#.#.#.##
...#.....#.#.#...
.#.######e.#.###.
.#.....#!..#...#.
.###.#######.###.
@#...#.........#.
##.C##.#######.#.
...#...#...E.#...
.##D.#######.####
..............W..
17 17
.........#..X....
.#######.#####.#.
.......#v#...#.#.
.##e##.#.#.#.#.#.
.#.#...#...#.#@#.
.#.#.#######.###F
.#.#.#.....#.....
.#.#.###.e##c#.##
...#...#.......#!
##.###s#######.#.
...#q#.......s.#.
.###.#######.#.#.
.....#...#...#.#.
###s.###.#.#####.
...#.....#...#...
.#G#####B###.#.##
......X....#.....
17 17
...........c.#.T.
.###########.#.#.
...#...#.....#.#.
##.#.#.#.#####.#.
.#...#.#.....#w#G
.#####.#u###.###.
.#...#.R.#q..#...
.#.#.#.###.###.#.
.#.#.d.#A..#...#.
.C.#####.###.#.#.
...#.#...B@#.#.#.
.###.#.###.#.#.#.
...#.#..!#.#.#.#.
##.#.c###u.#.#.##
.#.....#.....#...
.#####.#########.
...............V.
17 17
....T#.....#...#@
.###rf.###.#.#.#.
.#.......#.#.#.#.
.#.#######.#.#.#.
..r#.......#.G.#.
.###.#####X#.c.#.
.#...#.......#.#.
.#.###.#T###.#.X.
.#.#...#.....#...
.#.###.#.Q######s
.#..!#.#.....U.v.
.#########.###.##
.#..S....#..d#..g
.#.#####.#c#####.
.#.R...#.......#.
.f.#.#########.#.
...#...u...T.....
17 17
.#.....#!#.......
x#.G.#.#.#######.
...#.#.E...#.....
####.#.###.R.###.
...#.#..@#...#...
.#.#.########c.##
.#...#..R....#.#.
.C##.#.##g.###.#.
...#.#.#.#...#.#.
X#.###.#.###.w.#.
.#...G..e#.#.C.Ew
.###.###.#.#####.
.#.#...D.#..UU...
.#.#####e#####.#.
.........#.....#.
#####b#C.#.#####.
.........T.#..E..
17 17
..w.V....#.X.....
.###g##G.#.#####.
.#...#...gq..#...
.#U#.#######.B.##
...#.....g...#...
s#######.#.e####.
.#b....#.....#...
##.B##.####q.#.#.
...#.#.#...#.#.#.
a###.#.#.#.##x.#.
!#...#.#.#...#.#.
##w###.#.###.#.#.
.....#.#...#...#.
.###.#t###.####C.
G#...#...#.T.#.W.
.#.####V.#A#.#.##
@#.........#.....
17 17
.U.#...#.....A...
.#.#.#.#.##b.#.E.
.#...#.....#...#.
####T###########.
...........#.....
.#########.#.###.
...#.#...#.#.#@..
B#.#.#.#.#.A.####
.#.f...#...#....W
##.#.#####x#####.
...#.#...........
.###.##F##.#####.
.#.........#.#...
.###########.#.##
.#!#.........#f..
.#.#.#######.###.
...#.......#.....
