abcdefghijklmnopqrstuvwxyz-=[];/
ABCDEFGHIJKLMNOPQRSTUVWXYZ_+{}:?
OOOOOOOOOOOOOOOOCCCCCCCCCCCCCCCC
7
29 29
.....#.#.....................
.###.#.#.###########.#######.
.#...B.#.#.......#...#.....#.
.#####.#.###C#.###.#####.#Q#.
.#...#.#.#...#...#.....#...#.
.#.#.#.#.#.#.###.#####.#.#.#.
...#.#.#...#...#....b#.#.#...
.###.#########.#.#.###.######
.#.#.#...#.....#.#...#.......
.#.#.#.#.#.#######.#.#######.
...#...a.#...#...#.#.#.......
##.#####.###.#.#.#.#.#.#####.
...#...#...#.#.#.#r#.#.#.....
.###.#.#.###.#.#.###.#.######
...#.#.#...#...#...#.#.#!....
###C.#.###.#######.#.#.#####.
.....#...#.......#...#.....#.
.#######.A.#####.###.#####.#.
.#.......#...#@#...#.#...#...
.#######.###.#.###.#.###.####
...#...#.....#...#.#...#.....
.#.#.#.#########.#.R##.#.###.
.#...#.#.........#...#.#...#.
.#####.#.#########.###.###.#.
.#...#.#.........#.#...#...#.
.#.#.#.#####.###.#.#.###.###.
...#.#.#...#...#...#.#...#.#.
###R.#.#.#.#B#######.###.#.#.
.....#...#...............#...
29 29
.#.....#.....#.......#...#...
.#.#.###.#.###.#.#####.#.#.#.
.#.#.....#.....#.......#...#.
.#.#########.###############.
.......#...#.......#.........
.###Q###.#.#####.###.########
.#.#...#.Q.#...#.#...#.....B.
.R.#.#.#.#.T.#.###.###.###.#.
...#.C.#.#...#.....#.....#.#.
##.#.#.#.###########.###.#.#.
.#.#.#.#.#.........#.#...#.#.
.#.#.#.#.###.#.###.###.###.#.
...#!r.#...#.#...#.....#...#.
.#####.###.#.###.#######.###.
.#...#.#...#.#.#...#.....#...
.#.#.#.#.###.#.#R#.#.#######.
.#.#.#.#...#.a...#.#.#.......
.#.#.#.###.a.###.#.#.#####.##
.#.#@#.....#...#.#.#.....#...
.#.###c#######.#.#.#####.###.
.#.#...........#.#.....#.....
.#.#.####T####.#.#####.#####.
.#.....#.....#...#.....#...#.
.#####.#.###.#####.#####.#.#.
.....#.#...#.......#.....#.A.
##A#.#####.#########.#####.#.
...#.......#.........#...#.#.
.#.#####a###.#.#######.#.###.
.#...........#.........#.....
29 29
.......#.....#...........#...
.#######.###.#.#.#######.#.#.
...#.....#.#...#.......#.#.c!
.#.#.#####.###########.#.#.##
.#.#.........#.....#...#.c.#.
.#.####R####.#.###.#.###.#.#.
.#.........#.#.#...#.#...#...
##.######c.#.#t#.#.#.###.###.
...#...#...#.#.#.#.T...#...#.
.###.###.###.###.#.###.###Q#.
.#.......#...#...#.#...#...#.
.##R####.#.###.###.b.###.#.#.
.#.....#.#.....#...#.#...#.#.
.#.###.#.#######.###.#.###.#.
.#...#.r.#@#...#...#.#.#.#...
.#.b##.#.#.#.#.###.#.#.#.####
.#.#...#...#.#...#.#.#.......
.#.#.QT#.###.#.###.#.#######.
...#.#.#t#...#...#.#.....#...
.###.#.#.#.#####.#.#####.#.##
.#.#.#...#...#...#...#..Q#.#.
.#.#.T.#####.#.#.###.#.###qB.
...#.#...#...#.#...#.#...#.#.
##.#.#.###.#a#.##Q.#.###.a.#.
.A.#.#.#.....#.#...#.#.#.#...
.##A.###.#####.#####.#.#.###.
...#...#.#.#...#.....#.#...#.
##.###.#.#.#.###.#####.#.###.
.....#.....#...........#.....
29 29
.#...#.....#...#.............
.#.#.#.###.#.#.#.###########.
...#...#...#.#.#.......#.....
.#######.#.#.#.#######.#.###.
.....#...#.#.#.......#.#.#.#.
.#####.#.###.q####.#.#.#.#.#.
.#...#.#.#...#.....#.#.#.#...
.#.#.#.#.#.###.#T#####.#a####
.#.#...#.#.#...#.......#.....
.#.####A.#.#.###.###########.
.s.#...#.#.#.....#...#.#.....
.#.###.#.#.#######.#.#.#.C###
.#c..#.#.#.#.......#.#.#.....
###B.#.#.#.###.#####.#.#####.
...#.#...#.....#@..#.#.....#.
.#.#.#.######q####.#.#.#.###.
.#...#...#...#.....#...#.#...
.#######.#.#.#.#######.###.##
.#.....#.#.#...#...#...#!..#.
.#.#b#.#.#.#####.#.#.#######.
.#...#...#...#...#...#.....#.
.###.#######.#.#########.#.#.
.#.......#...t.......#...#...
.#######.#.#.#######.#.######
.#.....#.#.#.#.....#.#.......
.#.###.#.#.#.Q.###.#.#.#####.
.#.#.#.#...#.#.#.#...#.#...#.
.#.#.#.######a.#.#######.#.#.
.....#...................#...
29 29
.............#.......#.......
.#.#########.###.#.###.###.#.
.#...#.....#...#.#.r...#@#.#.
.###.#.##a####.#.#.t.###.#.##
.#.#.#.......#.#.#.#...#.#...
.#.#.#.#####.#.#.###A#.#.###.
B..#.#.#...#.t.#.......#.#...
S###.#.#S###t#.#####.###.#.##
.....#...#...#..s..#...#.#...
.#######.#.####s##.###.#.###.
.#...#...#.......#.#.......#.
.#.#.#.B###R#A.#.#.#.#######.
.#.#.....#...#.#...#...#...#.
.#####.###.#.#####.#.###.#.#.
.#...#.B...#.....#.#.#...#...
.#.#.T##.#######.#.###.#####.
.r.#.....#.....#.#...#.....#.
.R########.###.#.###.#####.#.
.#...#...#.#.#...#.#.......#.
.#.#.###.#.#.#####.#########.
...#.....#.#.#...........#...
##########.#.#.#######.#.#.##
.........#.#...r!#.c...#.#...
.#######.#.#####.#.#########.
...#.......#.....#.....#...#.
.#.###B###q#.#####.###T#.#.#.
.#...#.#.....#...#...#.#.#...
.###.###.##s#b.#.###.#.#.####
...#.....#.....#.....#......b
29 29
...#...........#.............
.#.###.#######.q####.###.####
.#...#.#...#...#...#...#.....
.###.#.#.#.#.###.#.#A###q###.
.#...#...#.#.#...#.#...#.....
.#.###q###.#.#.#.#.#.#.#.###.
.#...#.T...#.#.#.#...#.#...#.
.###.###.###.###.#####.###.#.
.#.......#.#.....#...#.#...#.
.#########.#######.###.#.####
.....#...#.......#.....#.....
####.#.#.###.#####.#########.
.s.#...#...#.......#.#Q......
.#.#######.#.######a.#.#.###.
.#.#.....#.#.....#.b.#.#...#.
.###.s.#c#.#####.#.##B.###.##
.....#...#.#..T#.#.......#...
.#######.#.#.###.###########.
.#@..#...#.#...#.....R.......
.###.#.#.#.###.#####.#.#####.
...#.#.#.#...#...#...#...#.#.
##.#.#.#####.###.#.#####.#.#.
...#.#.#!#...#...#.#.....#...
.###.#.#.#.T##.#.#.###.###.##
.#...#.#...#...#.#.#...#.#.#.
.###.#.#####.#.###.#.###.#.#.
.C.#.#...#...#.....#.#.R.#...
##.#.###.#.#########.#.#####.
.......#........c....#.......
29 29
.......................#...#!
.#T#######.q########.s##.#.#.
.#.#.....#.#.....#...#...#...
##.#.###.###.###.#####.######
...#.#.#...#.#.#.#.....#.....
.###.#.###.#.#.#.#.#####.####
...#...#.#...#.#.#...#.......
.#.###.#.#####.#.###.#######.
.#...s...#.....#...#.........
.###.###.#R#.###.###########.
.#.#...#...#.#...#.....#.....
.#.#.##c##.#.#.###.#.###.####
.#.#.....R.S.#.....#.....#...
.#.##a######.#############.#.
...#.........#.............#.
##.#####.###.#.#####.#######.
.#.......#...#.#.....#...#.#.
.#########.#####.#.###.#.#.#.
...#.....#...#...#.#...#.#...
##.#.#.#####.#.###.#.###.#.##
...a.#.......#.#...#...Q.#.#.
.###.#########.######Q.#.#.#.
.....#.......#.....#...#.#.#.
.#######.###.###s#.#.###.#.#.
.#.......#.#...#.#...#...#...
.#.#######.###.#.#####.a####.
.#...#.......#.#.#.....a.#...
.###.#.#######.###.#####.#.##
.....#.............#@........
