abcdefghijklmnopqrstuvwxyz-=[];/
ABCDEFGHIJKLMNOPQRSTUVWXYZ_+{}:?
OOOOOOOOOOOOOOOOCCCCCCCCCCCCCCCC
7
29 29
.....#.......................
.###.###############.#######.
.#.....#.....#.....#.#...#...
.#####.#.###.#.A##.#.###.#.##
...#.....#...#.#.....#...#.#.
.#.#######.###.#######.#.#.#.
.#.#.....#...#...#.....#.#...
##.#.q##.###.###.#.#Q#.#####.
...#...#.#.#.....#...#...#...
.###.###.#.#######.#####.#.A#
.#...#...#.........#...#.#.A.
.#.###.#C#.####aq###.B.#.#.#.
.....#.#.R.a.#...#...#...#...
######.#.#.#.#.#.#.#########.
...#...#.#.#...#.#.....S.....
.###.###.#.#.###.####s.R.####
...#...s...#...#.T...#...#...
##.###.###.C.b####.#######.#.
...#.#...#.#.#.....#.......#.
.#.#.##A.#.###.#.###.###.###.
.#...#...#...#.#.#.....#...#.
.###.#.#####.#.###.####r##.#.
...#.#!#...#.#.......#...#.#.
.#.#####.###.#########.#.#.#.
.c.#.......#...#.......#...#.
##.#.c####.###.#.###########.
...#...#.#...#.#.#.......#...
.#####.#q#.###.#.#.#q#.#Q#.##
.........#.......#...#......@
29 29
.............#.......#.......
.#######.###.#####.#.#.#####.
..t....#.#.........#.#.....#.
########.#######b####C.###.C.
.........#.......#...#...a.#.
.#####.###.#####.#.#.#.###.#.
...#Q#.#...#...#...#.#.#...#.
.#.#.#.#.###.#######.#.#.###.
.#.#...#...#.........#.T.#.#.
.#.#######.#.###########.#.#.
.#.....#...#.#...........#.#.
.#####.#.###.#.t##.#######.#.
.a...#.#.#...#.#...#..C#.....
.#####.#.#.###.#.###.###.####
.#.....#!#...#.#...#.#...#...
.#.###.#####.#####.#.#.###.#.
.#.#.#...#.#.......#...#...c.
.#.#.###.#.#T#######.#B#.###.
.t.#.......#.#.......#.#.#...
.#.#######.#.#.#t#####.t.#.#.
.#...#...#...#...#.#..A..#.#.
####.#.#.###.###.#.#.#####.#.
.....#.#.#.....#.r...#.....c.
.#####.#.#####.#.#####.######
.......#.r...#.#.....#.......
.c######.#.#.#######.###.###.
.....#.#.#.#.......#...#.#...
####.#.#.#.###.#######.###.#.
@......#.....#..........S..#.
29 29
.....#.....................#@
.T.###.###b###.#######.###.#.
.#.....#.A.#!#.#.#.....#...#.
.#########.#.#.#.#.#####.###.
.#.........#.#.#.#.#.....#...
.###.#.#.###.#.#.#.###.##r##.
...#.#.#.#...#...#...#.#...#.
b#.###.##T.#####.###.#.#.#.#.
...#...#...#...#.#...#.B.#.#.
.###.###.###.#.###.#######.#.
...#...#...#.#.....#t..#...#.
##.###.###.#.#########.#.###.
.#.....#...#.........#.#.....
.#####.#.###########.#.#####.
.#...#.#.#.....#.....#.....#.
.#.#.#.#.#.#.#.s.#####.#.###.
.#.#...#.#.#.#.A...#...#...#.
.#.#####.###.#.#.#.###.###.#.
...a...q.#...#.#.#...#.#.A...
.c##.####R.###.###.#.#.#.####
...#.#.......b...#.#.#.....#.
A###.#######.###.###.#####.#.
.....#.......#...#...#...#.#.
.#####.#######.###.###.#.#.#.
.......#.......#...#...#.#.#.
########.#########.#.###.#.#.
...#...#...#.....#.#.#.#.#.#.
.#.#.#.###.#.###.#.#.#.#.#.#.
.#...#.......#.....#...#.....
29 29
.......#.........C......@#...
.#####.#.###.#####.#######.#.
.....#.#.#.#.....#.#.....#.#.
##.###.#.#.#####.#.#.###.#.#.
.#.#..a#s#...#...#.#...#...#.
t#Q#.###.#.#.#.#######.#####.
.#.#.....#.#.#...c.#...#.#...
.#.#######.#.#####.#.###.#.##
...#...#...#.....#.......#...
.###.#.###.###.#########.###.
A#...#...#.#...#.....#...#...
.#.#####.###.#.#.###.#.##S.##
...#R#...#.Q.#.B.#...#...#...
####.#.###.#.###.#.####s.###.
.....#.#.Q.#.#...#.....#...#.
.#.###.#.###.#.#######.###.#.
.#.....#.Qq#.#.#.....#.#...#.
.#########.#.#.#####.#.#####.
.#.........#.#.....#.#.......
.#.###.###.#######.#.######A.
.#.#...#...#.......#s..#...#.
.###.###.###.#########.#.#.#.
...#.#.#.#.#.#...#.....#.s...
##.#.#.#.#.#.#.#.#.#####.####
...#.#.#...#...#.#.......#...
.###.#b###.#####.#.#########.
.#...#...#.#!#...#.....#.....
.###.#.###b#.#.#######.#.c##.
.....#.....#...#.........#...
29 29
.................#...#.......
.###.###########R#.#.###.###.
...#......Q..#.....#...#.#...
##########.#.######s##.###.#.
.........#.#.......#...#...#.
.#######.#.A######.#.###.###.
.#.....#.#...#.....#.#.....#.
.#####.#.#####.#####.#C###.##
.#.....#.#.....#...#.....#...
.#.###.#.b.#######.#####.###.
.#.#...#.#.#.....#.....#...#.
.#.#.#SB.#.s.###.#r#.#t###.#.
!#.#..@#.#.#.#...#.#.#.....#.
##.#####.#.#.###.#.T##.#####.
.......#.#.#...#...#...#.#...
.#####.#.Q.###.#.###.##a.#.#.
.#.....#...#...#.#...#.....#.
##.#########.###.#.#S######c.
...#.........#...#.....#...#.
.#.#.#####.###########.#.T.#.
.#.#.#...#.#.........#...#...
.###.#.###.#.#####.#########.
...#.#...C...#...#...........
##.#.###.#B#Q#.##############
...#.........#.......#...#...
.###########.###.###.#.#.###.
.#.......#...#...#.#.#.#...#.
.#.#####.#.###.###.#.#.###.#.
.......#.......#.......#.....
29 29
.......q.....#.............#.
.S.#####.###.#.#######.###.#.
.#.......#.B.#.#.......#.#.r.
.#########.#.#.#.#######.#.#.
.....#.qQ..#.#.#...B.....#.#.
####.#.#####.#.###.#.###.#.#.
.....#.#...#.....#.#t..#.#...
####.#.#.#.#######.#.T.###r#.
...#.#.#.#.......#.#.#.......
.#.#.C.#.#######.#.#.q#######
.#.A...#...#...#...#.#.......
.#.###.###.###.#####.#.######
.#...#...#.#...#.#...#.......
.###.#####.#.#.#.#.###.#####.
.#.#.#..s..#.#.#.#...#...#...
.#.#.#.#####.#.#.###.###.#.#.
.#...#.....#.#.....#.#...#.#.
.#.#######.#.#####.#.###.#.##
.#...r...#.#.....#.#...#@#...
.###.#.#.#.#.A##.#.###.#####.
.#...#.#.#.#.#...#...#.......
.#.###.#.#.###.###.###.#####.
.#.#...#...#...#.A.#...#...#.
.#.#.#######.#######.###.#.#.
.#...#.................#.#.#.
.#################.#####.#.#.
.....#.....#.....#.#.....b!q.
.###.#.###.#.###.###.##b####.
.r.#.....#.....#.....#.......
29 29
...................#.........
.#####.b.###########.#####b#.
...#.#.#.#...........#...T...
##.#.#.#.#.###########.#.#.#.
...#c#.#.c...#...#.....#Q..#.
.###.#.#####b###.#.#########.
.....#...........#rC....!#...
####.#############.#.#####.##
...#.#.......Q...#.#.#.#...#.
.###.###.#.###.#.#.#.#.#.###.
...A.....#.#...#...#.#...q...
.#.#.#######.###.###.#######.
.#A..#.....#.#.r.#...#...#...
.#####.###.#.###.#.###.#.#.##
...#A#.#.#.#...#.#...#.#.#...
##.#.T.#.#.###.#.###.#.#.###.
.#.#.#.#.......#.#@#.#.#...#.
.S.#.#.########C.#.#.#.###.##
.C...#.#.....#.....#.#.#.#...
.###.#.#.###.#.#####.#.#.###.
...#.#.#...#.a.#...#...#.#...
##.#.#.###.#.###.#.#####.#.##
...#.#...#.#.#..a#.....#...#.
.###.#.###.#.#.#######.#.###.
...#.#.....q.#...#.....#.....
#b.#.#######.###.#.##T######.
...#...#.#...#...#.........#.
.#####.#.#b###.###########.#.
.........#...............#...
