abcdefghijklmnopqrstuvwxyz-=[];/
ABCDEFGHIJKLMNOPQRSTUVWXYZ_+{}:?
OOOOOOOOOOOOOOOOCCCCCCCCCCCCCCCC
7
29 29
.............#.....#.........
a###.A##.#.###.#r#.#.###.t###
...#.#...#@#...#.#...#...#...
.#.##b.#####.###.#####.###.S.
S#...#...#...#.#.#....s#...#.
.###.###.#.###.#.#R###.#.#S#.
...#.....#.#...#.....#.#.t...
.#.#######.#.#.#####.###.#.#.
.#.#.........#.....#.....#.#.
##.#.#############.S###t##.#.
...#.#...#.......#.#...#...#.
.###.#.###.#####.#.###.#.###.
.#.....r...#.c...#..S..#...#.
.#.#####.#####.#######.###.##
...#...#.....t.#...#.....#...
####.#.#.###.#.#.#.#########.
.....#.#...#.#...#.......#...
.c####.#####.###########.r.#.
.....#.......#....q....#...#.
####.#########.#a#####r#####.
..!#.....#...#.#.#...#...#.S.
.#######.Q.C.#.#.#.#.#.###.##
.#.......a.#...#.#S#..q#...#.
.#.#######.#####.#.C####.###.
.#...#...Q.......#.......#...
.###.#.#########.##Q########.
...#.#.........#.#........b.t
##.#.#.###.#####.#####.#####.
.....#..r#...s.........#.....
29 29
.#.............#...#T........
.#.#.###S#A###.#.#.###.#####.
...#.#.......#.#.#...#...#...
####.#.#####.#.#.###.#####.#.
!..#.#.....#A#.#.#.#.....#.#.
##.#.#####.#.#.#.#.#####.#.##
...#...#...#.#.#.#.....#.#...
.###.#.#.###.#.#.#.###.#.###.
.#.#.#.....#.#.#.#.#.t...#...
.#.#.#a#####.#.#.#.A.####c.#.
.#.....#.....#.#.#.#...#...#.
.r.#####.#####.#.#.#.a.###.#.
.#.#...#...#.#...#...#...#.#.
.###.#.#.#.#.###########.#.##
.....#.#.#.#...........#.#..t
######.###.#.#.#######.#.###.
.....#.....#.#.....#...#...#.
.###.#######.#####.#######.#.
.#...#...#...#@..#.......#.#.
.###.#.#.r.#####.#######.#.#.
...#.#.#...#...#.....#...#.#.
.#.#.#.S####.#.###.###.###.#.
.#.#.#.#.....#.#...#...#...#.
##.###.#.#####.#.###.Q##.###.
...#...#.....#.#...#.....#...
.#.A.###.###.#.###.#######.##
.#.#.#.....#.#.......#.......
.###.#######.#######.#######.
.............#...............
29 29
.#.b.......A.....#.....#.....
a#.#####c#######.###.#.#.#.##
...#.....#...#.......#.#.#...
####C#####.#.#########.#.###.
.....#.....#.....#...#.#...#.
.#.###c#####q###.###.#.#.###.
s#.#...........#...Ta..#.#...
.###.###########.#.#####.#.#.
.....#.....#...#.#...#...#.#.
####.#.###.#.#.#####.#.###.#.
...#R#.#.#...#.#..!#.#.#.#.#.
.a.#.#.#.#####.#.###.#.#.#.##
.#.#A#.#.....#.#.c.....#.#...
.#.###.#####.#.#.#.#####.###.
.#...#.#...#.#.#.#.#..@#...#.
.###.#.#.#.#.#.#.#.#.###.#.#.
...#...#.#...#...#.#.....#.#.
##.#####.###.#####.#######.#.
.#.#...#...#.....s.....#...#.
.#.#.a##.#.#####.#####.#.###.
...#.....#...#...#...#.#.a...
.###.#######.#.#####.#.#.#.##
.#Q#.......#.#...#...#.#.#...
.#.#S#####.#.##S.#.###.#.###.
.#.........#.#...#.........#.
.###########.#.###r######s##.
.......#.....#.........#...#.
######.#.#############.#.#.#.
.........#...............#...
29 29
.........#.........#.....#...
####.###.#.#######.#.#####.#.
.....#...#.#..bc...#.......#.
.#####.###.#.#.#.###.#######.
.#...#.....#.#.#...#.....#...
.#.#.#######.#####.#####.#T##
.#.#.#...........#.....T@#...
.#.#.C.#####.###.#####.#####.
.#.#.#.#...#...B.............
.#.#.#.#.#.#.###############.
.#.#...#.#.#.#.......#.....#.
.#######.#.###.#####.#.#####.
.....#...#...#.#...#.#.......
####.#.#####.#.###.#.#.######
...s...#.....#.#...#.#...#...
.#.###.#.###.#.#.#.#.###.#.##
.#...#.#...#.#...#.#.#...#...
.###.#.###.#######.#.###.#.#.
...#!#...#.......#.#...#.#.#.
##.#c#A#.###.#####.###.#.###.
.#.#...#.#B#.#.....#...#.....
.#.#.###.#.#.#.#####.#######.
...#.......#...#...#.#...#...
.#########.#q###.#.T.C##.#.##
a........#.....#.#.#...#.#...
########.#######.#.###.#.s##.
...#.....#.......#.#...#...#.
.###.##b##.#######.#.###.###.
...........#.........#.......
29 29
...........R.........#.......
.#######.###.#####.R.#.#####.
...#...#...#...#...#.#.#.....
.###.#.###.###.#.#####.#.####
.#...#...#...#.#.#.....#.#...
##.#####.#.#.#.#.#.#####.#.#.
...#...#.#.#...#.#.....#...#.
.###.#.#.#######.#####.#####.
...#.#.#.......#.....#.....#.
##.#.#.#######.#.###.####C.#.
.#.#.#.....#.#.#...#.#.....#.
.#.###.###.#.#.###.#.#.#####.
.#.....#...#As!#...#......@#.
.#####c#.###.###.###########.
.....#...#.c.....#...#.......
.###.#.###.#####.#.#.#.####c.
...#.#...#c#...#.#.#.#.#.....
##.#.###.#.#.#.#t#.#.#.######
...#.....#.#.#.#...#.#.#.....
.###########.#.#####.#.#.###.
.............#B#...#.#.....#.
##############.#.#.#####.###.
...........#...#.#.....#.#...
.###.###.###.#C#.#####.#.#.#.
.#...#.#.#...#.....#.#.#.#.#.
.#.###.#.#.##b.###q#.#.###.#.
.#.#.....#.#.....#.#.#.....#.
.#.#Ss####.#######.#.#######.
.#.................#.........
29 29
.......#.........#@..........
.#####.###.#####.#####.###.#.
...#.#...#.....#.....B...#.#.
.#.#.###.#.###.s##Q#.###.#.#.
.#.#.....#.#...#.#...#...#.#.
.#.###.#####.###.c.#######.#.
.S...#.......#.......#.....#.
.###.#.#r###########.#.######
.#.#.#T#.....#..!#a#.#.#.....
.#.#.###.###.#.###.#.#.#.T##.
.#.#.......#.#.#.....#.#.#.#.
.#.#########.#.R.#####.#.#.#.
.#...#.....#.#.#.......#.#...
.#.###.###.#.#.B###A####.#.##
...#...B.....#.........#.#...
##.#.#######.#########.#.###.
.#.#.#...#...#.....#.#.#.#...
.#.#.#.#.#.#####Q#.#.#.#.#.##
...#.#.#.#.......#...#...#...
.###.#.#.###.###A###########.
...#.#.#...#.#.............s.
####.#.###.##s.#####.#######.
.....#.#...#...#...#..b......
.#S###.#.#.#.#####.##########
.#.....C.#.#...#.......#.....
.#.#s###.#.###.#.#####.#####.
.q.#.T.#.#.#...#...#.#...#...
.#.#.#.#.a##.#####.#.###.#.#.
.....#.#.......b..t#Q......#.
29 29
.#...#.......#.......C...#...
.#.#.#.#####.ta#.###.#####.#.
...S.#.#...#...#...#.......#.
##c#.#.#.#.###.#####b##T####.
.....#...#.#.#...#...........
.#########.#.###.#.##T####C#.
.........#.#...#.#.#...#...#.
.#######.#.###.#.#.#.#.#.###c
.#...#...#...#.q.#.#.#...#...
.#.###.#####.#.#.#.#.###.#.##
...#...#.....#.Q...#...#.#.#.
a#.#.#.#.#############.#.#.#.
.#.#.#.#.#.....#.......#.#...
.#.#.###.#.###.#.##C########.
...#...#...#.#.#.......#...#.
.A####.#####.#.#.#####.#.#.#.
.#...#.......#.#.#...#...#...
.#.#####.###.#.#.#.#.########
.#.....#...#.#!#C#.#.........
.###.#.###.#.###.#.###.#B###.
...#.#...#.#.#...#.#...S...#.
##.###.###.#.#.###.#####.#.#r
...#...#...qR#...#.#.....#..q
.###.#.#.###.###.#.#.######q.
.....#.C.#.#.#...#.....#.....
######.#.#.#.#.#########.#S#.
@#.....#.#...A...........#.#.
.#.#####.#################.#.
.......#.....................
