abcdefghijklmnopqrstuvwxyz-=[];/
ABCDEFGHIJKLMNOPQRSTUVWXYZ_+{}:?
OOOOOOOOOOOOOOOOCCCCCCCCCCCCCCCC
7
17 17
.....#.........#.
.###.###.#####.#.
.#.......#R..#...
.#.#######.#####.
.#.#...#.........
.##B.#.#.#######q
.#...#.#...#r..#.
.#.###.###.#.#.#.
...#.#...#...#.#.
####.###.#####.#.
.....#@#.#..!#.#.
.###.#.#.#.###.#.
.#.b...#...#.#...
S#####.#####.###.
.#...#...#...#...
.#.#.#####.#.#.##
...#.......#.....
17 17
.......#.....#...
.#####.#.#.###.#.
.#...s...#.#...#!
.#.#.#####.#.####
..Rq.#..@#.#...#.
.###.#.b##.###.#.
.#...#.....#...#.
.#.###.#####.r##.
.#...#.#.....#...
####.###.#####.##
.....#...#...#...
.#.###.###.#.#.q.
.#R#...#...#.#.#.
.###.###.R##.#.#.
...#.#.....#...#.
.#.#.r####A#####b
.#...q...........
17 17
.............#...
.#.###########.#a
.#.......#!....#.
.######b.#######.
.#@..#...#...#...
.###.#.#.#.#.#.b#
.#...#.#...#.R...
.#.###.#####.###.
...#...#...#.#...
####.###.#.###.##
.....#...#.....#.
.#####.#########.
.......#.........
.#######.#######.
.#..s..#.#.......
.#.###.###.#####.
...#.a.....#.....
17 17
...#.............
.###.###########.
...#.....#.....#.
##.#####.#####.#.
..B....#.......#.
.#########.####R.
.......#...#!#...
.#####.#.###.#.##
.#..r#...#...#...
.###.#####.###.#.
...#.....#.#...#.
##.#.#####.#####.
...#.....#.....#.
.#######.#####.#.
.......#.....#...
######.#.###.####
.........#@......
17 17
.....#.........#.
.#.###.#####.#.#.
.#...#.#...#.#...
.###.#.#.#.#.###.
.#.#...#.#...#...
.#.#####.########
.#.....#.........
.###.#.#B#######.
.....#...#@#.....
##.#####.#.#.#.##
...#...#...#.#.#!
####.#.#####.#.#.
.....#.......#.#.
.#############.#.
...A.#.......#.#.
.###.#.#####.###.
...#.......#.....
17 17
...a.....#...#...
.###.###.#.#.#.#.
.#.#.#.....#...#.
.#.#.#########S#.
...#...#...B@#...
.#####.#.#.#.#.##
.#.....#.#...#...
.#.#####.#######.
.#.#...#.........
.#.#.#.#.#######.
.#...#.R.#.....#.
.#a###.###.###.##
.....#.......#...
.#############A#.
.#..!#.........#.
.#.###.#######.#.
.#.....#.........
17 17
.........#@......
.##Q####.#####.#.
.....#!#...#...#.
####.#.###.#.####
...#.#.....#.....
.#.#.#######.###.
.#.#.....#.#.#.#.
.#.#####.#.#.#.#.
.#...#...#.#...#.
.#####.###.#.###.
.#.....#.....#..s
.#.#####.#####.##
.#.....#.....#...
.##R##.b.#######.
.#Q..#.#.#.....#.
.#.#.#.###.###.#.
...#.......#.....
