abcdefghijklmnopqrstuvwxyz-=[];/
ABCDEFGHIJKLMNOPQRSTUVWXYZ_+{}:?
OOOOOOOOOOOOOOOOCCCCCCCCCCCCCCCC
7
29 29
.......s.......#.....#.......
.###.#.#.#####.#.c.###.###.#.
.#...#...#.#...#.#.....#...#.
.#.####T#R.B.###.#######.####
.#.#@......#.#.#.#...#...#...
##.a####.#.#.#.#.#.#.#.###.#.
...#.....#.#...#.q.#.#.#...#.
.###.###.#####.#.#.#.#.#.###.
.#...#..Rq.....#.#.#.#.....#.
.#.#######.###b#.###.#######.
.#...T.#...#...........#...#.
.B.###.#.###.#########.#.#.#.
.#.#...#.#.....#.....#.#.#...
.###.###.#.#####.###.###.####
...#.....#.#.....#.#.....#...
##.#######.#.#####.#########.
...#.......#.#..c.C#.........
.###.#####.#.###.#.#.#####.r.
.#...#!..#.#...#.#...#.....#.
.#.##S##.#####.#.s####.#####.
.#...#.#...q...#.#...#.#...#.
.###.#.###.#.#####.#.#.#.#.#.
...#.#...#...#.....#.#.#.#.#.
##.#.#.#######.#.###.#.#.###.
...#.#..C....#.#.#.#.#.#.....
.#.#.#.###.#.#.#.#.#.#.###.##
.#.a.#...#.#.#.#.#.#.#...#.#.
.###.#####.#.###.#.#.###.#.#.
...........#b....#.......#...
29 29
............R......#...#.c...
.#######.#########.#.###.#.#.
.#...#...#.....#r#.#...#.#.#.
.#.#.#.###.###.#.#.#.#.#R#.#t
.#.#.#.#!..#...#...#.#...#...
.#.#.#.#####.###.###########.
.#.#.......#...#.#...........
##.#######.#B#.#.###.#######.
...#.....#.#...#...#...#.#...
.###.#.###.#q#####.###.#.#.##
.#...#.#...#.#......A..#..c#.
.#.###.S.###.#######c###.###.
.#...#.#...#.......#.....#.B.
.#.#.###.##q######.#.#####.##
.#.#.....#.......#.#.#B..#...
.###.#####.#.#####.#.#.#.###.
...#.....#.#.......#.#.#.....
##.#######.######R##.#.#####.
...#.....#...#.....#...#..b#.
.###.###.###.#.###.#######.#.
.#.....#...#.#@#.....#.....r.
.#.t####.###.s##.#ct.#.#####.
...#.b...#...#...#c....#.....
.###.#.#.#.###.#########.####
.#...#.#.#.#.....#...#...#...
B#.#.#.###.#.###.#.#.#.###.##
...#.#.#...#.#...#.#...#.t...
####.#.#.###.#.#B#.#########.
.....#...#...#..............S
29 29
...#.....#.......#....t#.....
.#.#.#.#.#.#####.#.###.#####.
.#..a#.#.#.....#.#.#.........
.#####.#.#####.#.#.#########.
.S.....#.....S.#.#...#@....#.
.#.###########.#####.###q#.#.
.#.#...........#...#...#...#.
.#.#.###########.#.###.#.###.
.#.#.....#.....#.#...#.#.#...
.#.#####.#.#####.#.###.#.#.##
.#...#.S.#.#.R...#...#.#...#.
####.#.#.#.#.###r###.#.#.###.
.....#.....#.....#.#.#!#.#...
.###.####s######.#.#.###.###T
.#...#...#.......#.#...#...#.
.#####.#.#A#######.#.#####.#.
.#.....#...#.....#.#..C..#...
.#.T##########.#.#.#####.###.
...#....r..#...#.q..a#.#.....
.#####a###.#.#######.#.######
.....#...#...#...#..Q#.......
####.###.#####.q.#.#a#####.#.
...#...#...#...#.#.#.......#.
.#####.###.#.#####.#.#.#####.
.....#A..#.#.#...A.#.#...#...
.#.#####.#.#.#.#R#####.#.###.
.#.....#...#.#.#.....#q#...#.
.#####.#####.#.###.#.#####.#.
.....#.............#.......#.
29 29
...............#.#...........
.#############.#.#.#########.
...........#...#...#.......#.
##########.#.#######.#####.#.
.#...#...#.#.#..A..#.#...b.t.
.#C#.#.#.#.#.#T###.#.#.#.#.a.
..C#.#!#...#.#...#...#.#.#.#.
.#C#.#######.###.#######.c.#.
...#.......#...#.#.......#...
######.###.###.#.#####.#####s
.......#.#..Q#.#.#...#.#.T...
.#######.#.###.#.#.#.#.#.B###
.#.........#...#.#.#.#Q......
.###########.###.#.#.#######.
.............#.....#.#.....#.
.###################.#.###.##
.....#...#.......#...#...c...
####.#.#.###.###.#.#####.###.
...#...#.....#.#.#...#....@#.
.#.##T#######a.#.###.#.###A#.
.#.....#.#.......#...#.#.....
.###.#.#.#.#######.###.#.####
...#.R...#.#S..#.......#.R...
#s##.#####.#.#.#.#######.#.#.
.....#.....#.#.....#...#...#.
.#####.###S#######.###.#####.
.#.....#.........#.a.......#.
.#.#########.###.###########.
.............#.......C.......
29 29
.....#.............#.........
.###.#.#####.####A.#.##t####.
...#...#...#.#.....#.#.....#.
##.#####.#.#.#.#s###.#.###.q.
@#...#.#.#...#...#...#...#.#.
.###.#.#.#########.#####.#.#.
...#...#.#.......#.#.....#...
.#####.#.#.s####.#.#.##A####.
.#.....#...#.#...#.#...#.....
.#.c######.#.#.#.#.###.#.####
.#.#.#...#...#.#.#.#.#.#.....
.c.#.#.#.###.#.###.#.#.#####.
.#...#.#.#.#.#...#...#.....#.
.#.###.#.#.#.###.###.#####.#.
.#.#...#.#.....#.......#...#.
.#.#.###.#####.###s#####.####
.#.#.#...#...#.....#...#.#...
.#.#.#.###.#.#######.#.#.#.#.
.#.#.q.....#.........#.#.#.#.
.#.#.B##B####T#####c##.#.#.#.
.#.#.......#.........#.#.#.#.
.#.#######.#.#######.#.#.#.#.
.#.#.....#.#.#.....R.#.#...#.
.#.#.###.#.#.#####.#.#.#.###.
.#.#.#.#.#.#.......#.#.#.#...
.#.#.t.#.#.#######A#.#.#.#.##
.#...#.#.#...#...#.#.#.#.#...
.#####.#.###.#.#.#.#.#.#####.
...........#!#.#...#.........
29 29
.............#.......#A......
##.#########.#.##A##.#.######
...#...#.....#...#...#.......
.###.#.###.#####.#.#####Q###.
.....#..!#.......#.t.....#...
##################.###.#.#.#.
.......#.........#...#.#...#.
.#a#.#.#.###.###.###.#.#Q#S#.
.#...#.#...#.#.....#.#...#.#.
.#.###.#####.#######.#.q.#.#.
.S.#.#.......#.......#.#.#...
##.#.#######.#.#######.C.#.##
...#.......#.#.#..a#...#.#...
.###.#.#####.#.###S#.###.###.
.#@..#.......#...#.#...#...#.
.###############.#S#.#####.#.
...............#.#.#r#.a.B.#.
.q#c########.###.#.#.#.######
.#...#....R#.#...#...#.......
.#.#.###.#.#.t.#####b##A##.#.
..q#.c...#.#...#......r..#.#.
####.#.###.####t.#######.#.#.
.#...#.#...#.....#...#B..#.#.
.#.###.#.Q##.#####.###.#####.
...#...#r..Aq#.........#.....
.#####.#########.########A.#.
.#s..#......q..#.#...r....a#.
.#.#.#########.#.#.#.#.#####.
...#...........#...#...#....a
29 29
@#.....C.....#.............#.
.#.#.###.S.###.###s#####.#.#.
...#.#...#...#.....#..s..#...
####.#.#####.#####.#.##t.####
...#.#.....#.s...#.#.#...#...
.#.#.#####.#.#####.#.#####.#.
.#.#.....#.#...#...#.......#.
.#.B##.###.###.#.s#A########.
.#.....#...#...#.....#...#.a.
.#.#####.###.#.#####.#.###.#.
.#.#...#...#.#...#...#.#...#.
.###.#.###.#.#####.R##.#.###.
.#...#...#.#.....#.#...#.#.#.
.#.#####.#.#####.#.#.###.#.#.
...#...#.#.#...#...#...#.#.#.
.###.#.#.#.#.#.#######.#.#.#.
...#.#.#.....#.#.......#.#...
##.#.#.#######.#.#####.#.###.
...#.#...#.....#.#.....#...#.
.###.##A.#.##b##.#.#######.#.
...#...#.#...R...c.......#.#.
##.#t#.#.###########.#####.#.
...#.#.#...#.#.....#.#..Q..#.
.###.r.###.#.#.#.###.#.#####t
.....#.#!#.#.c.#...#.#.#...#.
####.#.#.#.######s.#.#.#.#.#.
...#.#.#.#.r.....#...#.#.#...
.###.#.#.#######.s####.#.####
.....#...#.............#.....
