abcdefghijklmnopqrstuvwxyz-=[];/
ABCDEFGHIJKLMNOPQRSTUVWXYZ_+{}:?
OOOOOOOOOOOOOOOOCCCCCCCCCCCCCCCC
13
17 17
.........#...#...
.####B##.#.#.#.#.
!#@....#...#.#.c.
######.#####.###.
...........#...#.
.###.####q###Q.#.
.#...#...#.....#.
.#####.#.#.#####.
.....#.#...#.....
.###.#.#######.#.
...#...#.#.....#.
##.#####.Q.#.#r#.
.B.#.r..T..#.#...
.#.#.#.#####.#.##
.#.#...#.....#.#.
.q.#####.#####.#.
.........#.......
17 17
.......#......t..
.#####.#.###q###.
.#...#.#.#.#...#.
.###.#.#.#.###.#.
...#.#.#.....#.#.
##.#.#.#####.#.##
.#.Q.#..a....#..!
.C.#.##R#########
.#.........#.....
.#########.#####.
.........#.....#.
.#.#.#########.#.
.#.#.#..c....#...
.#.###.#####.###.
.#...#...#.#...#.
.###.t##.#.###.#.
..@#.........#...
17 17
.......#...R.....
.#.###.#.##R##.##
.#.#.#.#.B...#...
##.#.#.#########.
...#.......#.....
.########a.#.###.
.......#.....b...
.#####r#######.##
T....#.......#.#@
####.#######.#.#.
...#.....#.#.#...
C#.#####.#.AQ###.
.#.#.....#.#.#..Q
##.#.#####.#.####
...#...#...#.....
.####c.###.#####.
...............#!
17 17
.....#...#.......
.###.#.#.#.#.####
.#.....#...#.#...
.#############.#.
.....#.........#.
.###.#.#########.
...#.......#!..#.
##.###c#######.#.
...#.........#.#.
.###.#######.#.#.
...#...#.#...#.#.
#####a.#.#.###.#.
.......#.#.....#.
.#######.#######.
.....#.....#.....
####.###.#.###.#.
.........#.....#@
17 17
.......#...#.....
####.#.###.#.###.
.....#...#.#...#.
.#######.#.#.###.
.#....@#.#...#...
.#.#.#C#.#####.#.
.#.#...#.#...#.#.
.###.#.#.#.#.#.#.
...#.#...#.#...#.
.#A#####.#.#####.
.#.#!..#...#...#.
.#.###.a####.#.#.
.#...#.......#.#.
.##s.#########.#.
.#.....#.......#.
.#.#####.#######.
.#.......#.......
17 17
.......#...#.....
.#.#####.#.#.###.
b#.#.....#!#.#.#.
.###.#######.a.#.
.A.#.#.......#...
.#.#.#.##Q.#####.
.#.#.#...#.....#.
##.#.#########.#.
...#...r.......#.
.#####.#.S######.
.......#...#@....
.b########.###r##
.#....s..#...#...
.#.#####.###.###.
.#.#...#...#...#.
.#.#.#####.###.#.
...#...........#.
17 17
.#.....#@........
.#.###.#########.
...#.#........!#.
.###.###########.
.#.....#.......#.
.#.#t#.###.###.#.
...#...#...#...#.
####.###.###.t##.
...#...#.#...#...
##.###.#.###.###.
...#...#...C...#.
.###.###.#.###.#.
.#...#...#.#.R.S.
.#.#######.#.#.#.
.#.#.......#...#.
.#.###.#####.###.
.....t.c.........
17 17
.#.....#.........
.#.#.#.#.#####.##
...#.#.#.#...#...
.###.###.#.#.###.
.#.#.......#...#.
.cb###########.#.
.........#...#.#.
##.#####.#.#.###.
.#.#...#.#.#..!#.
.#.A.#.###.#####.
.#.#.#.....s.....
.r.#.##C####.####
...#.....#...#@..
.###Q###.#.###q#.
...#...#...#...#.
##.###.#Ct##.#.#.
.............#...
17 17
.................
.#######.#.######
.#@A!..#.#.#.....
.#.###.###.#.###.
.#...C...#...#...
.###.###.#####.##
.......#...#...#.
######.###.#.###.
.#.....#.#.#...#.
.#.C####.C.###.#.
.#.#.....#.....#.
.#.#.###########.
.#.#...#.........
.#.#.#.#.#.#####.
...#.#...#.....#.
.#############.#.
...............#.
17 17
.#.......#...#...
.#.#####.###.#.#.
.#.....#...#.#.#.
.#.#######.#.#.#.
...#..!#...#...#.
.###.###.###.###.
...#.#.....#.#...
.###.s.###.#.#.#.
.#...#.#...#.#.#.
.#.#####.###Aar#.
.#.......#...#.#.
.####C####.#.#.#.
.....#.....#...#.
####.###.#######.
@#...#...#a#..A..
.#.###.s##.#.####
.......#.........
17 17
.........#.......
######.#.#.C####.
.......#.#.#.#...
.#.#c#####.#.#.##
.#.#!......#.#.#@
.###########.#.#.
.............#.#.
.###.#.#######.#.
.#...#.#.......#.
S#.###.#.#######.
...#...#.#.C.....
.#.#####.#B#.#.##
.#.#...#...#.#...
.###.#.###.#####.
...#.#...#.#.....
.#.#.#.###.#.###.
.#...#.......S...
17 17
.#.............#.
.#.#######.###.#.
.#.#.#...#...#...
.#.#.#.#.###.###.
...#.#.#.....#.#.
.###.#.#######.#.
.....#.#.....#...
####.#.#####.#.##
.#...#...#!#.....
.#.#####.#.####A.
...#.....#.....#.
.###.###.#####.##
...#.#...#...#...
##.#.#####.#.###.
@#.#.......#...#.
.#.###########.#.
.............#...
17 17
.....#...........
.#####.#.#######.
...#...#...#.#...
.B.s.#####.#.#.##
.#.......#.#...#.
.#######.#.###.#.
.#...#.B.#...#R..
.#.#.#.#####.###.
.#.#.#.#...s.#...
.#.#.#.###.#.#.##
.r.#!#.....#.#..S
.#.#######.#.####
.#.#@#.....#.#...
T#.#.#.#####.#.#.
.#.#...#...#...#.
.#.#####.#.#####.
.#.......#.......
