abcdefghijklmnopqrstuvwxyz-=[];/
ABCDEFGHIJKLMNOPQRSTUVWXYZ_+{}:?
OOOOOOOOOOOOOOOOCCCCCCCCCCCCCCCC
7
29 29
.........#...A.#.....#.......
.#####.#.#####.a.###.###.###.
.#.....#.......#...#...#...#.
.#.###############.###.###.#.
.#.......#.......#...#...t.#.
.#######.#.###.#####.###.#.#.
.#.....#.#.#.#.....#...#.#.#.
.#.#####.#.#.#a#.S.###.#.#.#.
...#...#...#...#.#.#...#.#.#@
.##T.#.#.##S##.#.###.###.#.##
.#...#.#.......#.......t.#...
.#.###.#########S#######.#t#.
.#.#.#.....#...#.....#!#...#.
.#.#.#####.#.#.#.###.#.#.#.c.
.#.T.....#...#...#.#...#.#.#.
.#.#####.#########.###b###.#.
.#...........#...#.......#.#.
.###########.#.#.#.#####.#.#.
...#.......#...#.#.#...#.#.#.
##.###.#r#.####t.#.#.#s#.#.#.
.#...#.#...#...#...A.#...#.#.
.###.a##.#.#.#.#####.#.###.#.
...#.#...#.#.#...#...#...#.#.
.#.#.#.###.###.#.###.###.#.#.
.#...#...#.....#.......#...#.
.######q.#############.#####.
.#.....#.#...........#...#...
.###.#.#.#.#.###A#######.###.
.....#...#.#.................
29 29
.......#...........#.........
.#####.#####.#####.#.#.#####.
.#...........#...#.#.c.#...#@
.#############.###.#.###.#.#a
.#.........#.#...#.#.....#...
.#.#######.#.#.#.#.#.#######.
.....#.....#.#.#...#.r.....#C
.#####.#####.#.#C###.#.###.#.
.#.....#.....#.#...#.#.r...#.
.#.#####.###.#.#.#.#.#.###.#.
.#.....#.#...#...#.#.#...#...
.###A#.#.#.#######.###cs.###.
.....#.#.#.#.....#...#.#...#.
##.###.#.###.#.#.###.#.###T#.
...#...#.....C.#.#...#...#.#.
.###.#.#####.#.###.#####.#.##
...#.#.#...#.#.....#.....#...
.###.#.#.#.#.###########.###.
.#...#.#.#.#.....#.....#...#.
.#.#####.#.#####.#.###.#####.
.#...#...#...#.#...#.....#...
.###.#.##T##.#.#.####r##.#.#.
...#.#...#.#.#...#.....#...#.
####.###.#.T.#####.###.#####.
.......#...#.#...#...#.#...#.
.#########.#.#.#.###.#.#.#.##
.B...S.....#...#.....#.#.#..!
.#.#.#.###############.#.####
...#.................#.......
29 29
.....T.........#...#...#.....
##.#.#######.#.#.#.#.#.#.###.
...#.........#b..#.#.#.#.#...
.###C#############.#.#.#.#.#.
...#.......#.....#...#.#.#.#.
.#.#.B####.#.#.#######.###.#.
.#.#...#...#.#.........#...#.
.#.#.#ct.###.########A##.###.
.#.#.#...#...#.....#Q....#.#.
##.#.#.#.#.#####.#.#.#.###.#.
...#.#.#.#.....#.#...q.#.#...
.###.#.###t###.###.q##.#.#.#s
.#...#.......#...#.#...#.#.#.
.#####.###.#.###.###.###.#.#.
.#...#.#...B...#...#..r#.#.#.
.#.#.#s#.#####.###.#.#.#.#.#.
a#.#.#.#.#...#...#.A.#.#.#...
.s.#.###.###.###.#.##t.#.###.
...#...#...#.....#.#...S.#...
######.###.#.#####.#.###.#.##
!......#...B.....#...#.#...#.
########.#############.#.###.
@#.......#.........#...#.....
.#.#.b##.#.#######.#.#.#####.
...#.#...#.......#.#.#.....#.
####.#.#######.###.#.#.R####.
.....#.#.....#.#...#.#...#...
.#######.###.#.#.###.###.#.##
...........#...#.......#....r
29 29
...............#.......#.....
.#####.#.##R##.#####.#.#####.
.#.#...#.#...#......r#.......
.#.#.###.#.#.###############.
.#.#.#...#.#.#.S.......t.....
.#.#.#####.#.#.#######.#.####
...#.......#.#.......#.#.....
##.##t######.#######.#.#.####
.#.#.#.....#...#.....#...#...
.#.B.#.###.##S.#.#########.#.
.#s#.#...#.....#.#.....#...#.
.#.#.###.#######.#.###.#.###.
.#...#.#.#...#...#...#...#...
.###.#.#.#.###.#####t#####.##
...#.#.#.#.........r.#...#...
.#.#.#.#.S##########.A.#.###.
.#.#...#.#...........#.#...#.
##.###.#.#.####B######.#####.
.....#.#.#.....#...........#.
.#####.#.#####.#.#####T###.#.
.#R....#.....#.#@#.........#.
.#.#####.#####.###.#######.#.
.#.....#...........#.....#.#.
.#####.#######q##T##S###.#.#.
...........#...........#...#.
.###########.#.###Q###.#####.
.#.....#....q#.#...#.#.#A..#.
s#.###.#.#######.#.#.#.#.#.#.
...#...#.........#!#.....#...
29 29
.............#...#....@#.....
.#.#q#######.#.###.#.###.#.##
.#.......q..S#.#...#...#.#...
.#######.###.#.#.#####.#.###.
...#...T...#...#...#.#...#...
##.###.###.###B###.#.#####.#.
.#.....#.#...#b..T.....#...#.
.#####.#.###.#########.#.####
.......#...#.s..s..#...#.....
.#######.###.#.###.#.#######.
...#...#...#...#.#.#.#...#.#.
##.#.#.###.#####.#.#.#.#.#.#.
.#...#...#.....#.#...#.#...#.
.#######.###.#.#.#####.#.###.
...#...#.....#.#.......#.#...
.#.#.A.#######.#.##Q####.#.##
.#...#.#.........#...#.#.#...
.#####.#.#########.#.#.#.###.
.#.....#...#.......#.#.#.#.#.
.#.###.###.#.#######.#.#.#.#.
.#.#...#...#.#.#...r.s.....#.
##.#.###.###.#.#.#.#.#.#####.
...#.#...#...#.#.#...#.#.....
.###.#.#r#.C##.#.######S.#r#.
...#.#...#.#...#.#...#...#...
.a.###.#c#.#.###.#.#.#.###.##
.#.....#...#.....#.#...#.B...
.###C###.###.#####.#####.###.
.......#..!#.......#.........
29 29
.....#...............#.......
.#.#.#############.#.#.#####.
.#.#.#....Q..#.....#...#.....
##.#.#.###bb.#.#########.#B##
...#...#.#...#...#.........#.
.#######.#.#####.#########.#.
.#.r.#...#.#...#.........#...
.###.#.#.#.#.#.#.#######.####
.#...#.#.#...#.#.......#....c
.#.###.#.#####.###.#########.
.#...#.#...c...#...#.........
.#Q#.#.###.#.rC###.#.#######.
.#.#...#R..#.#...#.#...#.#...
.#.#####.###.#.#.#q###.#.#.##
.#.....#...#.#.#.......#.....
.#####R#.#.#.#.#####.########
.#.....#.#...#.#...#.#.......
.#.###.#####.#.#.#.#.#.#####.
.....#.#...#...T.t...#...#...
.#####.#.#.#####.#######.q.##
...T...#.#...#@..#!......#...
##.#.###.###.########A#####B.
...#.....#.#...............#.
.#########.#########.#######.
.#....b....#.......#.....#...
.#.#####.#.#####.#.###C#.#.##
.#.....#.#.#...#.#...r...#...
.#######.#.#.#.#.###.#.#####.
........B#...#...#...#.......
29 29
...r.....#...#.....#.........
.###.###.#.#.#.###.#.#####.#.
.#.#S#.....#...#...#.S.....#.
q#.#.#############.###.#####.
.#.#.....#...#...#.....#.....
.R.#B###.#.#.#.#.#######.####
.#.....#...#.#.#.....#.......
.#.#####b###.#.##S##.##t####.
..q#....R....#.#...#.....#@#.
.###.#####.###.T##.#####.#.#.
.#...#...#.#...#...#...#.#...
.#.###.#.#.#.###.#.#.#.#.####
.#.#.#.#...#.....#...#.#....!
##.#.#.###############.######
...#.............#.....#.....
.########s########.#######.#.
.#.........#...#...#.....#.#.
.#.#######.#.#.s.#####.#.#.##
...#.......a.#...#.....#.#...
.###.#######.###q#.#####.###.
.#.#.........#.#.......#...#.
.#.###########.#.#####.###.#.
...#.#.......#...#...#...#...
##.#.#.###.#.#####.#.###.###.
...#...#...#.#.....#.....#...
.#t#.###.###.t.##a########.##
.#...#...#.#...#...#.......#.
.#####.###.#####.###.#######.
.......#.....................
