abcdefghijklmnopqrstuvwxyz-=[];/
ABCDEFGHIJKLMNOPQRSTUVWXYZ_+{}:?
OOOOOOOOOOOOOOOOCCCCCCCCCCCCCCCC
5
17 17
.....#..!q.......
##.#.#.###.#####.
...#.#.#.......#.
.###.#.#########.
.#...#.....#...#.
.###.C####.#.A.#.
...#.#..@#...#.#.
##.#.#.#######.#.
...#...#.......#.
.#.#####.#######.
.#.#...#.#...#...
.##C.#.#.#.#.###.
...#.#...#.#...#.
.#.#.#####.#q#.#.
.#...#...#.#.#.#.
.#####.#.#.#.#.A.
.......#...#.....
17 17
.#.......#.....#.
.#.#.#####.###.#.
...#...B.#.#!#.#.
.#######t#.#.#.#.
.#...#..Q#...#.#.
.#.#.#.#.#####.#.
.#.#...#.....#...
.#.#########.###.
.#.R...#.....#@#.
.#.#.#.#.#####.#.
.#.#.#.........#.
A#.#.#######.###.
.#.#.#.....#.#...
.#.###.###.###.##
.#.....#.#.....#.
.####a##.#######.
.................
17 17
.#...a...#.#.....
.#.#####.#.#.#.#.
.#.#...#.#...#.#.
.#.#.###.#####.##
.#.#.#!..#C..#...
.#.#.###S#.#.###.
.#.t.......#...#.
.#A##A##.#.###.#.
...#...#.#...#...
.###.#.#####.###.
.#c..#..q..#...#.
.#.#######.#.#.#.
.#...#@#...#.#.#.
.###.#.#.###.#.##
b....#.#.#...#...
######.#B#######.
.................
17 17
.....#...#...#...
.#.###.#.#.#.#.#.
T#.#...#R#.#...#.
.#.#.##T.#.#####.
.#..S..#.#.#.....
######.#.#.#.q##.
.....#.#.#.#...#.
.s##.###.#.###.#.
.#.......#.#...#.
.#######.#.#.###.
.....r...#.#.#@..
r###.#####.#.####
...#.......#.#!..
##.#########.###.
.#...#.....#...#.
.###.##A##.###.#.
.............#...
17 17
..c..#...#.......
.###.#.#.#.#####.
.#...#.#.#...#...
.#.###.#.#.#.###.
.#.#...#.#.#...#.
.###.###.#####.#.
...#..!#.......#.
.#.#############.
.#...........#...
.#####.#.#####.##
.....#.#.#..s#...
.#####.#.#.#.###.
@#.....#.#.#...#.
##.#.#####.###.#.
...#.#...#.#.#.#.
.#####.#.#.a.#.#.
.......#....t#...
