abcdefghijklmnopqrstuvwxyz-=[];/
ABCDEFGHIJKLMNOPQRSTUVWXYZ_+{}:?
OOOOOOOOOOOOOOOOCCCCCCCCCCCCCCCC
7
33 33
@....#.......#.............#.....
###s.#.###.###.#######.###.###.#.
.....#.#.#..t....#.....#.#...#.#.
.#####.#.###A###s#.#####.##q.#.#.
.......#.......#...#...........#.
.#####.#####.#.#.###.###########.
.#...#.#...#.#.#.#.....#.....#.#.
##.#.#.#.#.#.#.#.#######.##t.C.#.
...#.#...#...#.#.#.......#.#.#...
.###.#######.###.#.#######.#.#.##
.#.#.#.....#.#...#...#.....#.#...
.#.#.#.t##.###.#####.#####.#.###.
.#...#...#...#....s#.....#.#.#..S
.#.#####.###.#####.#####.#.#.#a##
.#.#...#.#.#...#.......#.#.#.#...
.#.#.#r#.#.###.#.###.#R#.#.#.#.#.
.#...#...s.#...Q...#.#.....#...#.
.#########.#.#####.#.#.#########.
.#.....#.....#.....#.#...#.....#.
.#.#####.#####.#####.###.#.###.#.
.#.........#...#.....#.#.#...#...
.###.#####.#.###.#a###.#.###.####
...#.#...R...#...#.....#.#!#.....
##.###.#.#####.#####.###.#.#.###.
...#...#...#.#.......#...#.#...#a
.###.#####.#.#######.#.###.#####.
.#...#.....#...#.....c.#.#...#...
.#.###.#####.#.#.#SA##.#.###.#.##
.#.#.#.#...#.#B#...#...#...#.#...
.#.#r#.###.#.#.#s#.#.###.#.#.#.#.
.#...#.q.#...#.....#.#...#.#.#.#.
.###.###.###########.###.#.#.###.
.......#.................#.#.....
33 33
.......#.....#...#.....#...#.....
.#####.#.#.#.#.#.###.#.#.#.#.###.
...#.#.#.#.b...#.....#...#...#.#.
.#.#.#.#.#.b##################.#.
.#.#...#.#.#...........#.........
.#.#r#.#q#.#S#.###.b####.########
.#...#.#.#...#...#.#.....#.......
#T##.#.#####.#.#.###.#c#b###.###.
.....#.......#.#...#...#.t.r.#...
.#########.#s#####.###.#.Q.###.#.
.#.....#...#.....#.#...#.#...#.#.
.#.#s#.#B###.###.#.#.###.###.#.#.
...#...#.....#...#.#.#..Q#.#...#.
.###.###.#q###.###.#.#.###.#####.
.#...#.......R.#.....#...#.....#.
.t.S##.#######.#.#####.#.###.#c#.
.#...#...#!#...#.#.....#...#.#...
S##T.###.#.#.#r#.#######.#.#.####
.....#...#...#.........#.#.#.#...
c#.###.#s#############.#.#s#.#.#.
.#.#...#.......#.....#.#.#.#.#.#.
.###.#######.#.#.#.###.#.#.#.#.B.
...#.....#...#.#.#.#...#.#.#.#.#.
##.#####.#.T##.#.#.#.###.#.#.#.#.
.#.....#...A.#.#.#.#...#.#.#.#.#.
.###.#######.#.#.#.###.r.#.#.B.#.
...#...........#.#..@#.#.#.#...#.
.#.rC###########.#####.###.##R##.
.#...#....a#.q.....#...#S..#.#...
.#.#.#.#.#.#.##S##.#.###.###.#.##
.#.#.#.#R#.#...#...#.#...#.C.#...
.#.b##.#.#####.#.###.###.#.#.###.
.#.....#.......#.........#.#.....
33 33
...........#..B....#.........#...
.#########.#.#####.#######.#.###.
.#.......#.#.....#.........#.....
.#.#.###.#.#####.#.#############.
.#.#.#!#.#.......#.#...#.....#...
.#.###.#.#######.###.#.r.###.#.##
.#.....#.#...#...#...#...#.#.b.#.
.#######.#.###.###.#######.#.#.#.
.......#.#.....#...#.....#...#...
.#####.#.a######.###.###.#.#####.
.#...#.#.........#.#.Q.#.#.#...#.
.#.#.#.###########.#.#.#.#.#.###.
.#.T.q.......#.#.....#.cA..#.....
.T.#.#B#####.r.#.#####.#####.##C#
.#.#...........#...#.#.....#.#...
.#.###############.#.#.###.#.#.#.
.#.#......b......#.#.....#.#.#.#.
.###.######t####.#.#.#####.#.###.
.#...#.........#...#.#.....#.....
.#.#########.#.#######.#.#R#####.
...#.........#...#.....#.#.......
######.#####b#.b##.#.#####.######
....T..#.#.....#...#.....#.#.#...
.#######.#.#####.#T###q#.#.#.#.#.
...#...#.....#...#.....#.#.#...#.
.#.#.#.#######.###.A##.#.#.#####.
@#.#.#.#.....#...#...#...#.#...#.
##.#.#.#.a##.#.#####.#.###.#.#.#.
...#.#...#.#...#...#.#.#...#.#.#Q
.###.#####.#####.#.#.#.#.###.#.#.
.#...#...#.....#.#...#.#.....#.#.
.t.###.#.###.#.#.#############.#.
.......#.....#.#.................
33 33
.#.........#...#.....#.....#.....
.#.#.#####.#.#.#####.S.###.#.###.
.#.#.....#.#.#.....#.....#...#...
.#.#####.#.#.#####.###########.#.
...#.q...#...#.....#...#...#...#.
.###.#.#######.#####.#.#.#.#.####
.....#.#.....#...#...#...#.#.....
######.#.#T#####.###.R####.#####.
.......#.#...#.......#...#.......
.#######.#.#.#.####t##Q#########.
...#.......#.#.#...#.....#.......
.#.#.###S###.#.#.#.#C#.#.#.######
.#.t...#...#...#.#...#.Q.#.#.....
##.#####.#.#####.C##.###.#.###.##
...#.....#.........#...#.#...#...
.###.#############.###.#.###.###.
...#...#.....#...#.a...#...#.b...
.#.###.###.#.#.#.###.###.###.#.#.
.#...#...#.#.#!#...#.#.#...#...#.
c#.#.###.#.#.#####.#.#.#.#.#####.
...#.#.#.#.#...#.#.#.#...#.......
.###.#.#.#.###.#.#.#.###.########
.#...#.#.#.#...#.#.#...#...#.....
.#.###.R.#.#.###.#.###.C##.#.#.#.
.#...#.#...#.#...#.....#...#.#.#.
.###.#.#####.#.#.#######.#####.#.
...#q....#...#.#.......#.#.....#.
.#.#######.#######.#.#.#.###.###.
.#.#.....#.......#.#.#.#...#...#.
.#.#.###.#######.#.#.#####.#.#.#.
.#...#...#.....#.#.#..A..#.#.#.#.
.#####.###.Cb#.#.#.#####.#.###.#.
.....#......@#...#.....#.......#.
33 33
...#...#.......#..c......#.......
.###.#.R.#.###.###.###S#.#.#####.
.#...#A..#.#.....#.....#...#.....
.Bq#######.#####.###.t.Q###q#####
.......#.#...#.#s..#.#.#...#.....
#A####.#.###.#.###.###.#.#.#.###.
.....#.....#.#.........#.#.#...#.
.###.#######.###########.#.#.###.
.#.......#...#...........#...#...
.#######.#.###.#############R#.#.
.#...#.#...#...#.#.....#.......#.
.#.#.#.###.#.###.#.#.#.#.#.#####.
...#.#...#.#.#.#...#.#.t.#.#...#.
.###.#.#.#.#.#.#.###.#.#.###.#.##
.#...#.#.#.#.#.#.#...#.#...#!#...
.#.###.#q#.#.#.#.#.###.S##.#####.
.#.#...#...#.#.#.#.#...#...a.#...
.#.#######B#.#.#.#.#.#a#.#####.##
.#...........#.#.#.#...#.....#.#.
.###########b#.#.#.###.#####.#.#.
.#...#...#.....b.#.#...#...#...#.
.#.#.#.###.#####t#.###.#.#.#####.
...#.#...#...A...#...#...#.....#.
Q###.#.#.###.R.#.###.#########.#.
...#.b.#.....#.#...#...#.........
.#.#.#.#######.###.###.#########.
.#.#.#...#.....b.#...#.........#.
.#.#.###.#.#B###.##t.###.#####.#.
.#.#.#...#.#.......#...#.....#.#.
.R##.#.###.###.#######.#######.#.
.....#.#...#...#.......#.......#.
.#######.###.###.#b#####.#######.
.........#...............#@......
33 33
...#......a..#!....#...#.....#...
.#.#.#a#.#########.#.#.###.T.##b.
.#.#.#.#.....#...#.#.#.....#.....
.###.#.#####.#.#.#.#.#S#########.
.#.Q.#...#...#.#...#.......#.....
.#.#####.#.###.#########.#.#.####
.........#.#...#.......#.#.#.#...
######.###.#.###.#R###.###.#.###.
..b..q.#...#.#...#.........#.#..c
.###.###.###.#.#.###b#######.#.#.
.#.......#...#.#.........#.#.#.#.
.#######.#.#############.#.#.#.#.
.......#C#.............R.#.#.#.#.
######.###############.#.#.#.#S#.
.....#...............#...#...#.#.
.###.###########.#####B###.###.#.
.#.....#.........#.....#...#...#.
.#####.#.###.#####.###.#.###.###.
.....#.#.#.q.#C....#@#.#...#.#...
.###.#.#.#####.#####.#.###.#.####
.#.#.#...#...#...#...#.....#.....
.#.#.#####.#.###.#.#########.##R.
.B.#.......#.#...#.#...#...#.#...
.#.##Q######.#.###.#.#.#.#.#.#.##
.......#...#...#.....#.#.#...#...
####A#.#.#########.###.#.#####.#.
.B...#.#.........#...#.#.#...#.#.
.#.###.#.q#C##.#.#####.#.#.#.#.#.
.#...#.#.#...#.#.....r...#.#.#.#.
###a.#.#.###.#.#####.###.#.Q.###.
.....#.#..A..#.#...#...#.#.#.....
.#####.######s.#.###s#.###.#####.
...............#...........#.....
33 33
.......#.....#.......#..@#.......
.##B##.#.#.#.#####.#.#.###.#.#s#.
.....#...#.#.#...#.#.#.....Q.#...
####.#####.#.#.#.#.#.#######.###.
...#.#...#.#...Q.#.#.#.....#...#.
.#.#.###.#.#####.#.#.#.###.###.#.
.#.#.....#.....#.#.#.#.S...#...#.
.#.#####.####B.#.#.#.#.#.###.###.
R#.#.....#.....#.#.#...#.....#...
.#.#.#####.#####.#.#s#####.#####.
.#.#.#.....#.#...C.#...#...#...#.
##.#.#.#####.#.###.#.a.#####.#.##
...#.#.#...R.......#.#.......#...
.#.#.#.########a####.#####s#####.
.#.#.#...........#.............#.
.#.#.###########.#.#########.###.
.#.#.......#...#...#...#...#.#...
.#########.#.#.#####.#.###.#.#.##
...........#.#...r.#.#...#...#...
.########a.#######.#.###.#######.
.#...#...#.........#.#.#...#.....
.#.#.#.#.###########.#.###.#.###.
...#.#.#.......#.....#.#...#...#.
####.#.######B.#.#####.#.#####.#.
...#.#.#...#...#.....#...#...#.#.
.#.#.#.#.#Q#.#######.#.###.#.#.#.
.#...#.#.#...#.....#.#.....#...#.
.#####.#####.#.###.#.######aB###.
.....#.....#...#.#...#.......#...
##.#######.#####.#####.#####.#.##
...#.......#.......q...#...#.#...
.###.#######.###########.#.#####.
...R....!#.........r.....#.......
