abcdefghijklmnopqrstuvwxyz-=[];/
ABCDEFGHIJKLMNOPQRSTUVWXYZ_+{}:?
OOOOOOOOOOOOOOOOCCCCCCCCCCCCCCCC
7
17 17
.......#.......#.
.#####.#.#.###.B.
.#...#...#.#@#.#.
.#.#.###.#.D.#.#.
.#.#...#c#.#.....
.#.###.###.######
.U.#.#...#.d....q
.#.#.###.#v#####.
.#!#...#.#...#...
.###.###.#####.##
...#...#.......#.
##.#.#.#########.
.#.aU#...........
.#.#############.
...#...#...#.....
.###.#.#.A.#.###.
Q....#u..#...#...
17 17
.....#.......#...
.###.###.#####.#.
.#...#...#.....#.
.#.###.#.#.#####.
.#.....#@#.#!..#.
.#########.###.#.
.........#...#.#.
.#######.###.#.#A
.#...#...#...#...
.#.#.#.#.#.##A##V
q#.#.#.#.#.#....A
##.#.#.###.#.###.
...#...#...#.#...
.#####.#.###.v.##
..f..#.#...#.#...
.###.#####.#f###F
...b.............
17 17
...#.#....E......
.#.#.#.#d#####.#.
.#.#...#.....#.#.
.#.#.###.###.###.
.#.dS#...#@#.....
.#.###.###.#####.
.#.....#...F...#.
.#########.#.#.#.
.#.....#...#.#...
.#.###.#.###.####
.#...q.#.........
e###.#.#########.
.....#.#.......#.
.#q###.v.#####.##
v#.....#.#.c.#..!
.#.#####.ta#.E###
.#...............
17 17
.....#...B.#.....
.###.#.#.###.###.
!#@#.#.#....Q#...
E#.#.#w#######.A.
...#...........#.
.a.#############.
.#.........#.#r..
.#######.#.#.#.##
.....#...#...#.#.
#b.###.###.###.c.
...#...#...#...#.
.###.###r###.###.
.B.F.#.....#...#.
.#.########Q##.d.
.#...........#.#.
u#########.###.#.
.W.....Va#.......
17 17
.w.....#.....#...
.#####.#.###.#.#.
...#.#...#...#.#.
##.#.#####.###.#.
...#...a...#...#W
.#########.###.#.
.....#...#.....#.
.###.#.#.###.####
.#.#.#.#.#@..#...
.#.#.#.#.#####.#.
...#...#.#...#.Q.
.v######.#.#.R.#.
R#.....#...#...#.
.#.#s#.##A##.B##.
.#.a.#.....#...#.
.###.###b#.#####.
...#..!#.........
17 17
.#....D#.........
.#.#.#.#####.V##.
.T.#.#.....#...#.
.#d#.###a#.###.#.
...#.....#.....#.
##.#q###.#######.
@#..V..#...#.....
.#.#######.#.###.
...#.....s.#.#!#.
.##T.#######B#.#.
...#.......R...#.
##########.#.###.
.B...#.....#.#.#.
.###.Q.###.#.#.#.
...#...#...#.#...
.#.#########.#.##
.#...........#...
17 17
.................
.###.#R#####.####
.R...#.C.#...#...
.#####.#.#####.#.
.......#.#.....#.
t#######.#.#####.
...#...#.#.#.#...
##.t.#.#.#.#.#.#.
...#.#.t...#E#.#b
.###v#.#####.#.##
.#...#.#.....#.#!
.###.#.#.###.#.w.
.....#...#...#...
#v########.######
......@#...#a....
.##v.###.#######.
...#........q....
