abcdefghijklmnopqrstuvwxyz-=[];/
ABCDEFGHIJKLMNOPQRSTUVWXYZ_+{}:?
OOOOOOOOOOOOOOOOCCCCCCCCCCCCCCCC
5
17 17
.....#.......#...
.###.#.#.#####.#.
.#...#.#.....#.#.
.###t#.#####.#.#.
.#.....#...#.#.#.
.#.#####.##b.#.#.
.#.#.....#...#!#.
.#.#.####s.#.###.
...#.....#.#...#.
.#######.#.#####.
....C#...#.......
####.#.##########
..@#.#R........#.
.###.#######.#.#.
...#.........#.#.
.#.###########.#.
.#...T...........
17 17
R#...#.......#...
.#.#.#.#####.Q.#.
.#.#.#c#.....#.#.
.#.#.#.###.###.#.
c#.#.#...#.#@..#.
.#.#.###.#.#####.
...#.#...#.#.....
.###.#.###.#.####
.#!..#.C...#.....
.#####.###.#####.
.#.#.....#.......
q#.#.###.#######.
.#...#..b#.....#.
.#####.###.#####.
.#.....#.........
.#Q#####.########
...Ar.........B..
17 17
...#............@
.#.#.###.########
.#...#...#.......
.#########.#####.
.q...#.......#...
.#.#.#.#####t#.##
...#.#.#.a...#.#.
.###.#.#.###.#.#.
.#...#.#..!#...#.
.#.###.S######s#.
.#.....#.#....A..
.#######.#.#.####
.#.....c...#.#...
.#.###.###.#.#.a.
.#...#...#A#...#.
.#s#.###.#######.
.r...#...........
17 17
...#....t......s.
.#.#.#######.###.
.#.#.#.....#.#...
.#.#.#.###.###.##
.#...#...#...#...
####.###.###.###.
..B#...#.#.....#.
.#.#####.#####.#.
.#.......#..!#...
.###.#####.#####.
.#...#.....#...#.
.#####.#######.#.
.....#.......#...
.###.#######.#.##
.#...#.....#A#.#B
.#.###.###.#.#.#.
@#.......#...#...
17 17
.#.......#.......
.#.###.#.#####T#.
...#...#S........
####.#.######B##.
.....Sb#.....#...
.#######.a##.#.##
.#...#...#...#...
.#.#.#.###.#####.
.#.#.#..!#.....#.
.#.#.#########.#.
.#.#.......#.#.#@
.#.#.#####.#.#.##
.#.#.#...#...#...
.#.#.#.#.q######.
.#r#.#.#...#.....
.#.#.#.###.#.####
...#.....#.......
