abcdefghijklmnopqrstuvwxyz-=[];/
ABCDEFGHIJKLMNOPQRSTUVWXYZ_+{}:?
OOOOOOOOOOOOOOOOCCCCCCCCCCCCCCCC
11
17 17
@#.............#.
.#.T####.#####.#.
.....#...#...#.#.
######.#####.#.#.
.....#.#.....#.#.
.###.#.#.##r##.#.
...#...#.#.....#.
##.#####.#.#####.
.#....!#.#...C...
.####b##.###.###.
.........#.#.....
.#######.#.#####.
...#.......#...#.
.#.###.#####.#.#.
.#...#.#.....#...
.###.###.########
...#.............
17 17
...#...#..C......
.###.#.#.#####.#.
.#...#.#.....#.#.
.#.###.#####.#.#.
.....#...#.c.#.#R
.#######.###S#.##
.#.....#.#...#...
.a.###.#.#.#.###.
.#...#...#.#...#.
.###.#####.###.#.
.#.#.......#@#!#.
.#.#########.###.
...#.......#.....
##.###.###c#.###.
...#.b.#.#.#...#.
.###.###.#.###.#.
.....#.b.......#.
17 17
.....#...#.......
.###.#.#.#####.#.
.#.....#.......#.
.#########.#####.
.....#R#...#...#.
####.#.#.###.#.##
....T#.T.#!#.#...
.#######.#.#.###.
.......#.#...#.#.
.#####.#.#####.#.
.#.#...#..@#.....
.#.#.#######r##T#
...#...q.....#...
##.###.#.a####.#.
...#A#.#.#.....#.
.###.#.#.#####.#.
.....#.........#.
17 17
...........#...#.
.#########.#.#.#.
...#.....#...#...
##.###.#.#######.
.#...#.#.....#...
.###.###.###.#.A#
...#...#...#.#...
.#.s##.#####.###.
.#.#.#.....#...#.
.#.#.#####.#.###.
.#.......#.#.....
.#########.###.##
.....#...#..!#.#@
.###.#.#.#####.#.
...#.#.#...#...#.
##.#.#.###.#.#S#.
..C#.....#.......
17 17
.....#..q#...#...
.#####.#.###.#.#.
.#!....#...#...#.
.#########.#####.
.........#...#...
########.###.#.#.
.........#.#...#.
.#######.#.#####.
...#...#.#.....#.
R#.#.#.#.#.###.#.
...#.#@T...#.#.#.
.###.######t.#.#.
...#........B..#a
##.#############.
..A#.......#.....
.###.#####.#.####
.........#..R....
17 17
.....#...........
.#.###.#.#.######
.#.S.#.#.#.#.t...
.###.#.#.#.c.T##.
.#...#.#.#.#.#...
##.T.#.#.###.#.##
...#.#.#.....#...
.#b###.#######a#.
.......#.....#.#.
.#######.###.###.
.....#...#.#.s...
####.#.###.#.#.#.
..@#.#..!#...#.#.
.###.#####.###.#.
...#...#.#...#.#.
.#.###.#.###.#.#.
.#.........#...#.
17 17
.....#!#.........
.###.#.#.#####.#.
.#...#.#@#...#.#.
.#S###.##r.#.r.Q.
.......#...#.#.#.
.#####c#.###.###.
...#.#...#.#.....
##.#.t.#.#.#####.
.#.#...#.#.....#.
.#.###.#.###.#.#.
.#...#.#...#.r...
.#t#.#.###.#.####
.#...#.#...#...#q
.#.#####.#####.t.
.#.....#...#...#.
.#####.##r.#.###.
...........#..q..
17 17
.......#.......#.
.###.#.###.###.#.
...#.#.#...#.#...
##.#.#.#.###.###.
.#.#.#...#.....#.
.#.#.##S##.#####.
...#.#.........#.
.###.#.#######.#.
...#.#.#.....#s..
####.#.#.#.######
.....#.#.#.......
.#####.#.###.###.
.#...#.#..S#.#.#.
.#.#.#.#.###.#.#.
.#.#.#.#.#...#...
.#.#.#.###.##C.##
!#.#.......#@....
17 17
.B.#.....#.#.....
##.#.###.#.#.###.
...#.#...#.....#.
.#.#.#.###.#####.
.#.#.#...#...C...
.###.##q.#####.#.
.#...#...#...#.#.
.#.###.#.#.#.#.#.
...#.#Q#.#.#!#.#.
.###S#.#.#.###.#.
...#.#.#.r.#...S.
##.#.#.###.#.#.#.
...#.#.....#.#.#@
.###.#######.#.##
...#...#.....#...
##.#.#.#########.
.....#...........
17 17
.#.......#.#.....
.#.#.#S#.#.#.###.
...#...#...#.#.#.
.#####.###Q#.#.#.
.....#.#...#...#.
####.#.#######.A.
.C.#.#.....#...#.
##.#.#####.#.###.
...#.#...#...#...
.#.a.#.#.#####.##
.#.R...#.#...#.#.
.#######.###.#.#.
.......#.....#!#.
.#####.#####.###.
.....#....@#.#...
####.#.#####.###.
.....#...........
17 17
.......#...#.....
.#.#A#.a.###.###.
.#...#.#.....#...
.b##.#.#######.##
.#.#.#.#.....s...
.#.#.#.#.###.###.
...#.#.#.#.#.#...
##.#.#.#.#.#.#.#.
...#.#.#.#.....#.
####.#.#.#.#####.
.....Q...#.#...#.
.###########.#.##
.#!..........#...
.##########Q####.
............@#...
.#####.#######.##
.....#...........
