abcdefghijklmnopqrstuvwxyz-=[];/
ABCDEFGHIJKLMNOPQRSTUVWXYZ_+{}:?
OOOOOOOOOOOOOOOOCCCCCCCCCCCCCCCC
3
17 17
.......#.......#R
.#####.#.#.###.#.
.#.....#.#...#...
.#.###B#.###.####
.#...#...#...#...
####.#.###.###.#.
.....t.#...#...#.
.#####.#.###.###.
.#.....#...#.#.#.
.#.#######.#.#.#.
...#a....#.#!#...
.###.#.###.###.##
.#..R#...#.....#.
.#######.#######.
.......#.........
######.###.#####.
...........#@....
17 17
...#.....s.#.....
.#.#.B##.#.#####.
.#.#...#.#.......
.#.#####.#R#t###.
.#.#.....#...#...
.#.#.#.#C#.#.####
.#...#.#...#.....
.#######.#######.
.........#@#q..#.
S#########.#.#.#.
...#.......#.#.#.
##.#.#####.#.#.#.
...#.C...#.#.#.#.
.#####q#.###.#.#.
.#.....#.#...#.#.
.###.#.#.#.###.#.
.....#...#!#.....
17 17
.....#.........#!
.#.#.#S###.###.#.
.#.#..t....#.#.#.
.#.#########.#.#.
.#.#r..#.......#.
##.q.#.##T######.
...#.#..b....#...
.###.#######.#.##
...#.#.....#a..#.
##.t.###.#######.
...#Q..#.#.T.....
.#####.#c#.#####.
.......#...#.t...
.###########.###.
A..#.........#...
S#.#####.#####.##
.....B...#......@
