abcdefghijklmnopqrstuvwxyz-=[];/
ABCDEFGHIJKLMNOPQRSTUVWXYZ_+{}:?
OOOOOOOOOOOOOOOOCCCCCCCCCCCCCCCC
7
17 17
.#...............
.#.#########.###.
.#.#.....#.#...#.
.#.#.###.#.###.#.
.#.#.#.....#@#.#.
.#.#.##q##.#.#.##
...#.#...#...#...
.###.#.#.#######.
.....#.#.#.......
##.###.#.#.#####.
...#...#...#.#...
####.#######.#.##
..!#.......#...#.
.#########.#.###.
.#...#.....#...#.
.#.#.#.####a##.#.
...#...#.........
17 17
.................
.######Q.########
...#...#.........
##.#.#.#########.
...#.#...#...#!..
.###.#.#.###.####
.#@..#.#.....#...
.#####.#####.#.##
.......r...#.#...
########.#.#.###.
.......#.#.#...#.
.q.#####.#.###.#.
.#.....#.#...#.#.
.#####.#.###.#.#.
.....#...#.#...#.
####.#####.#####.
.a...............
17 17
.....#...........
.###.#.#####.###.
!#.#.#...#...#...
##.#.#.###.#.####
...#.#.#...#.#...
.#.#.#.#.##A.#.#.
.#@#.#.#...#.#.#.
.###.#.###.#a#.#.
...#.#...#.a.#.#.
.#.#.###.Q.#.#.#.
.#.#.#.#.#.#.#.#.
##.#.#.#.#.###.#.
...#.#...#.....#.
.###.#.#######.#.
.....#.#....A#.#.
.#######.###.###.
.........#.......
17 17
...#.........#...
.#.#######.#.#.#.
.#.........#...#a
.###############.
...#...........#.
.#.q####.#######.
.#r#!..#.#.....#.
##.###.#.#.###.#.
....@#.#...#...#.
.#####.###.#.###.
.#...#...#.#.#...
.#.#.###.#.#.#.##
.r.#.....#.#.#.#.
############r#.#.
.#...........#.q.
.#.#####.#######.
.......#.........
17 17
q................
.#####.#########.
.#.....#...#.....
.#######.#.######
.........#.......
.###############.
...#...........#.
##.##A######.###.
@#.#.........#...
.#.#.#####.###.#.
.#...#.....#...#.
.#####.#####.###.
...#...#...#.#...
.#.#.###.###.####
.#.#.#.....#.#..!
.#.#.#####.#.#.A#
.#.........#.....
17 17
.#.....#...#!..#@
.#.###.#.#.###.#.
...#...#.#.....#.
####.#.#.#######.
.....#.#.#.#.....
.#####.#.#.#.###.
.....#.#.#.#...#R
.###.###.#.#.###.
...#.#...#...#...
.###.#.###.###.#.
.#...#.#.#a#...#.
.#.###.#.#.#.###.
.#.#...#.#.#.#...
.#.#.###.#.#.###.
.#...#.....#...#.
.#############.#.
Q..............#.
17 17
.................
####.#######.####
.....R.....#.#...
.#####.###.#.#.#.
.#.....#.#a#@#!#.
.#.#####.#.#####.
.#...#...#.......
.###.#.#.########
.#...#.#...A.....
.#.###.#####.#.#.
...#.........#.#.
.#######.#####.#.
.......#.....#.#.
######.#######.#.
.....#.........#.
.#.#########q###.
.#...............
