abcdefghijklmnopqrstuvwxyz-=[];/
ABCDEFGHIJKLMNOPQRSTUVWXYZ_+{}:?
OOOOOOOOOOOOOOOOCCCCCCCCCCCCCCCC
5
17 17
.......#.........
.Q##.###.###.####
...#.......#.....
##.B######s#####.
...#.........R.#.
.###.#########.#.
@#...#...#.....#.
##.###.#.#.T####.
...#A..#.#.#.....
.###.#.###.###.#.
.B.#.#...#.....#.
.#.#.###.#.######
.#.....#...#.....
.#####.#####.##q.
.#...#...#...#!S.
.#.#.#####.##q.#.
...#.......a.#...
17 17
.....#.....#.....
.###.#.###.#.#.##
..!#.#.#.#...#...
####.#.#.#######.
...#.#......@#...
##.#.#######Q#.#.
...#...#.....#.#.
Q#.###.#.##B.#.##
.a.#...t.#.#.#T..
.###.###.#.#.###.
.....#...#.#.....
.#######.#.#####.
...#.....#.....#.
##.#.#####.#####.
.#.#...r.#.#...#.
.#.#####.#.#.#.#.
.........A...#...
17 17
...#.t.....#.c...
.#.#.###.#.#.###.
.#.#...#.#...#...
.#.###.#.#####.##
.#.....#.#.....#@
.#######.###.###.
.......#...#.....
######.###.######
.....#.#.#.#.....
.###.#.#.#.#.###.
.#!..#...#.....#.
.#######.#######.
.......#...#.....
##r###.#####.#c##
.....#.....#..b..
.###S#####.#####.
..R..............
17 17
.#...............
.#.#############.
.Q.............#.
.##########A##.#.
.........#.....#.
.#######.#.####B.
.#...#...#.#.....
.#.#.#.###.C.###.
...#.#.....#.#...
####.#a#####.####
...#.#.....#.....
.#.#.#.#c#.#####.
.#.#.#...#.#...#.
.#.#.#.#.###.#.#.
.#.#.#.#..B#.#..q
.#.#.#####.#.###.
@#.........#!#...
17 17
@..#.......#...#.
#a.#.#.###.#.#.#.
...#.#...#...#...
.#.#.###.##T#####
C#.#.#.#QB!......
.#C#.#.#.#######.
.#.#.#.#.......#.
.###.#.#######.#.
...#.......#.#...
.#.###R###.#.####
.#.#...#...#.....
.#.#.#s#.###.###.
.#.#.#...#...A.#.
##.#.###########.
...c.............
.###############.
..............S..
