abcdefghijklmnopqrstuvwxyz-=[];/
ABCDEFGHIJKLMNOPQRSTUVWXYZ_+{}:?
OOOOOOOOOOOOOOOOCCCCCCCCCCCCCCCC
7
13 13
..Q....#.....
.#####.###.#.
.#.....#...#.
.#.####t.###.
.#.#.......#.
.#.#######.#.
.a.........#.
.###########.
.......#...#.
######.#.#.#.
@#.C.#!#.#.#.
.#.#.###.#.#.
...#.....#...
13 13
.......#.....
.#A#.#.###.#.
...#.#...#.#.
##.#.###.Q.##
...#...#...#!
.##C#b.#####.
...#...#...#.
##C#.#.#.#.#.
...#.#.a.#...
.###.#S#.#b##
.#...#...#@..
.#.###.#####.
.#........B..
13 13
...#...#....A
.#.#.a.#.###.
.#.#.#..c#...
.#.#.#####.##
.#R..#...#.#.
.#####.###.#.
.#....T......
.#.##########
.#....@#.....
.#.#####.###.
.#.#...#..!#.
a###.#.a####.
.....#.......
13 13
...........#.
.#########.#.
.#...#...#.#.
.#.#.###.#.#.
.#.#...#...#.
.#r###.#t###.
...#.#!#...#.
####.#####.#.
@#...#...#...
.#.#.#.#.###.
.#.#...#...#.
.#.#######.T.
.........#..S
13 13
...........#@
######.###.#.
..!T...#...#.
.##Q.###.###.
.#...#.#.#...
q#.###.#.#.#.
.#...#.#.#.#.
.#.#.#.#.###.
.#.#.#.....#.
.###.#####.#.
...#...#.#.#.
##.###.#.#.#.
.......#.....
13 13
.....#.......
####.#.#####.
.....#.#..!#.
.###.#.#.###.
...#.#...#.#.
.#.#######A#.
.#.#.........
##.s.##S#####
...#.#@......
.#.#.#####.#.
.#.#.c...#.#.
.###.#.#.###.
...b...#.....
13 13
....@#.......
.#####.#####.
.#.....#.....
.#.####r.###.
.#.....#.#...
.#.#####.####
...#.....#...
####.#####.#.
.....C.....#.
.###.#.#####.
.#...#..!#...
.#########.##
........s....
