abcdefghijklmnopqrstuvwxyz-=[];/
ABCDEFGHIJKLMNOPQRSTUVWXYZ_+{}:?
OOOOOOOOOOOOOOOOCCCCCCCCCCCCCCCC
7
17 17
...............#.
####.#########.#.
...#.#.#...#...#.
.#.A.#.#.#.#.###.
.#...#...#.#...#.
.#.#####.#.###.#.
.#.#...#.#...#...
.###.#.#####.###.
...#.#.....#.#...
##.#.#####.#.#.##
...#!#.....#...#.
.#####.#####.#B#.
.#b....#..@#.....
.#.#####.#######.
.#.....#.#.....#.
.#####.#.#.###.#.
..q....#.....#...
17 17
.A.........s.....
.#######.###.#R#.
...#...#.#...#.#.
##.#.#.#.#.###.#.
...#.#b#...#...#.
.###.#######.###.
.....#...#!#.#...
.####R.#.#.#.####
.#.....#...#.....
.#.###########.#.
.#.......#...#.R.
.#######.#.#.###.
.#@....#.#.#.#...
.###.###.#.#.#.##
...#...#...#.#...
##.###.#####.###.
...........a.....
17 17
.....#.....#.....
.#.#.#.#.#.#.#.#.
.#.#.#.#.#.#.#.#.
q#.#.#.#.###.#.##
...#.#.#.#...#...
.###.###S#.#####.
...#...#.#.#...#.
##.###.#.#.###.#.
.#!#.#.#.......#.
.###.#.#####.###.
.....#...#...#...
.###.###.#####.#.
...#..@#...#...#.
.#.#######.#.###.
.#.........#...#.
.#############.#.
...............#.
17 17
...#.......#...#.
B#.#.#.###.#.#.#.
.#...#.#.....#...
.#####.##########
.#.#...#.........
.#.#.###.#######.
...#.....#.....#.
##.#####.#.#####.
...#...#.#.r...#.
.###.#.#.#.#.#.#.
..@#.#.#...#.#...
####.#.#####.###.
.....#.......#!#.
.#############.R.
...............#.
################.
.................
17 17
.#......!#...#...
.#.#######.#.###.
.#.....#...#.....
.#####.#.####A##.
.....#.#...#...#.
.#####.###.#.#.##
.#...#...#.#.#...
.#.#.###.#.#.###.
...#.....#...#...
.a########.###.#.
.....#@......#.#.
####.###.#####.#.
...#...#.#.....#.
.#.###.###.#####.
.#...#.....#..r#.
.###########.###.
.................
17 17
.......#...#@....
.###.#.#.#.#####.
...#.#...#...#...
##.#.#######.#.#.
.#.#.#...#...#.#.
.#.#.#.###.###.##
...#.#.#...#.....
####.#.#.#######.
.....#.#...#.....
.#####.###.#.###.
.#.....#...#...#.
.#.#.###.#####.##
.#.#...#r#...#...
.#.###.#.#.#.###.
.#...#...#.#.....
.#####.###.#####.
....!#.....#.....
17 17
.....#.......#...
.#.#.#.###.#.#.#.
.#.#.#...#.#.#.#.
.#.#####.#.###.#.
.#.......#...s.#.
.#########.#####.
.......#!#.#...#.
#####R.#.###.#.#.
.....#@#...#.#...
.###.#####.#.###.
.#.#.....#.#...#B
.#.###R#a#.#.#.#.
.......#...#.#.#.
A#####.###R#.#.##
.#...#...#...#...
.#.#.###.#######.
...#............Q
