abcdefghijklmnopqrstuvwxyz-=[];/
ABCDEFGHIJKLMNOPQRSTUVWXYZ_+{}:?
OOOOOOOOOOOOOOOOCCCCCCCCCCCCCCCC
1
17 17
....c#...A......T
.###.#.###.#####.
.#.S...#.#.#@..#.
.#.#####.#.###.#.
.#.t...S.#..s#...
.#.#.#####.#.####
B#.#.#...#.#.....
.#.Q.#.c.##b.###.
...#.#.#.q.#...#.
####.#.###.T.###b
..C..#!#...#.#...
.####b##.###.#.#.
...#..r..s...#.#A
####.#######.#.#.
.....#Q....#.#.#.
a#r###.###.###.#.
.......#......R#.
