abcdefghijklmnopqrstuvwxyz-=[];/
ABCDEFGHIJKLMNOPQRSTUVWXYZ_+{}:?
OOOOOOOOOOOOOOOOCCCCCCCCCCCCCCCC
7
17 17
!..#.............
##.###w####x.###.
...#...#.c.#.#.Q.
.###.#.#.#.###.#.
.#...#...#.....#.
.#.#############.
...#...#@..#.....
####.#.##S.#.####
.#...#..W#.#.#...
.#.#.###.#.#.###.
...#...#...#...#.
#QwT##.#######.#.
.......#.....#.#.
.#######.###.#.#.
.........#.#.#...
.B########.#.###.
...........#.....
17 17
.....#...........
####CF.###.#####.
.....V..FV.#.....
.#.#####.u.#.####
.#.#.....#.#....@
.###.#####.#dE##E
...#.U.A.#.E.....
.#.#####.#.#.###.
.#.......e.....#.
######.#######G#.
.....#...#.....#.
.###.#####.###.#.
.#.#.....#.#.#!#.
.#.#####.#.#.###.
.#.....#...#.....
.#####.#V##U.###.
.............#...
17 17
...#.............
.Qd#.#######.###.
...#..a#...#...#.
.#.#.###.#C###.#.
@#...#...#.#...#.
#v####.###.#.###.
.....#.#...#...#.
.###B#.#.#####.#.
...#...#.....#.#.
.#.#####G###.###.
.#.d.....u.....#.
.######V.#####.#.
...#...#.....#...
.###.#.#####.b##.
.#!..#.#.....#.#.
.#####.#.#####.#.
.....#...#.s.....
17 17
...#.....q.......
##.#.#.#.#.#####.
...#.#.#.#.#.....
.###.#.#.F##.###.
.....#.#....s#.#.
.#####.#####D#.#.
x....#.....#...#.
.####T####.###.#.
.w.......#.#...W.
.#.a####.#.#.###.
.#...#.#.#.#.....
.###.#.#.r.#.X###
.#@#!#...V.#...#.
.#.###.###.###.#.
.#.#...#.....#...
.#.#.#####d#.###.
...#.........#...
17 17
.......#.....#...
.###eQ.#G##t.###.
.#...#.#.#.....#.
.#.gdg.#.#####.#.
.#.....#...C.#...
.#.#######.#.#V#.
.#.........#...#.
.#######.#B#.###.
.#.#....D#!#.....
.#.#.#####.###.##
.#...#...#...#.#@
.###.#.#.###.#.#.
...#.#.#.A...#.#.
.S.#.#.#######.#.
.#.#.q.....#.#.X.
R#.###D###bD.#.#.
.#.........#.....
17 17
U#...#.#.g...f...
c#.#.#.#.#####.#.
...v.R...#...#.#.
q###.###.#.#.U##.
.#.#..!#.#.#.....
.#R#####.#.###q#.
..r#.....#.#...#.
#W.#######.#U###.
@#.........#.#...
.########f##.#.##
.#...#v...u..#...
.#.u.#.#.###W##v.
.#.#.#.DTD.....#.
.#.#.#.#.#.##B.#.
...#.#.#...#.#.#.
.###.#.##w##.W.#.
...#.....S...#...
17 17
.......#.........
.c###A.####t.###w
....F#.......#.#.
####.####v###r.#.
...#...t.#.#V....
.#.#B###.#X#.#F##
.#....a#.#.#.#...
.#####.#Et.#.###.
.....#.D.W.....#.
####.#.#.#####.#.
.#...#!#.#...#...
.s.#C###.#.#.####
.#...#.....#.S...
.###.#.#########.
...r.#@#.......#.
.###.###.#####.R.
.....e...#.s.....
