abcdefghijklmnopqrstuvwxyz-=[];/
ABCDEFGHIJKLMNOPQRSTUVWXYZ_+{}:?
OOOOOOOOOOOOOOOOCCCCCCCCCCCCCCCC
7
17 17
.......#...#.....
.###.#.#.#.#.#.#.
...#.#...#.#.#.#Q
##.#.#####.###.#.
...#.#...#.....#.
####.###.#######.
...#...#.....#...
.#.#.#.#.###.#.##
.#!#.#.Q.#.#.#...
.###.#.#.#.#.###.
.#...#.#.#.#...#.
.###.#.#.#.###.#.
...#.#.#.#...#.#.
##.###.#.#.#.#.#.
.#.#...#.#.#.#...
.#.#.###.###.####
.....#@..........
17 17
.#...#...........
.#.#.#.###.######
...#...#...#.....
####.###.###.###.
..!#...#.......#.
.#####.#########.
.....#.#.....#...
####.#.#####.#.##
...#.#.......#...
##.#.###.#######.
...#.#...#.......
.###.#.###.#####.
.....#...#.#...#.
.#########.#.###.
.#.......#.#...#.
.#.#####.#.#.#.#.
...#.......#@#...
17 17
.....#.........#.
.#####.#####.#.#.
.......#...#.#q#.
.#########.#.#.#.
.......#...#.#...
######.#.#.#.####
.#.....#.#.#.....
.#.#####.#######.
...#.......#.....
.###.#####.#.####
...#...#...#.....
##.#####.#####.#.
@#.......#..!#.#.
.#####.###.#####.
.#.....#...#.....
.#.#Q###.#####.#.
.......#.......#.
17 17
.....#.......#...
.###.#.#.#####.#.
.#.....#.#.....#.
.#######.#.#####.
...#.#...#.#...#!
##.#.#.###.#.####
...#...#...#.....
.#######.#######.
.#.....#.......#.
.#.###.#######.#.
.#...#.#.....#.#.
.###.#.#.#.###.#.
..@#.#.#.#...#...
.###.#.#.###.###.
.....#.#.#.#.....
.#####.#.#.######
.....#...........
17 17
...#...#.........
.###.#.#.#######.
.#...#...#.....#.
.#.#######.#####.
q..#.....#...#...
.###.#.###.#.#.##
...#.#.#...#.#...
##.#.#.#.###.###.
@#.#.#...#.....#.
.#.#######.###.#.
.#.......#...#.#.
.#######.###.#.#.
.....#...#...#.#.
.#.#.#.###.#.###.
.#.#.#.....#.#...
.#.#########.#.##
.#...........#..!
17 17
.#...#.........#.
.#.#.#######.#.#.
...#.#.......#.#.
.###.#.#######.#.
.#.#!#.....#@#...
.#.#######.#.###.
.#.......#.#.....
.#.#####.#.#####.
...#...#.#.....#.
####.###.#.###.##
...#.....#...#...
.#.#.###########.
.#...#...........
.#######.#######.
.#.....#.....#.#.
.#.###.#####.#.#.
...#.........#...
17 17
...............#.
.###########.#.#.
.#.....#!..#.#...
.###.#.###.#.####
.....#...#.#.....
########.#.#.###.
...#...#.#.#.#.#.
.#.#.q.###.#.#.#.
.#...#.....#...q.
.#############.#.
...#.....#.....#.
##.###.#.###.###.
.#...#.#...#..@#.
.###.#.###.#####.
...#...#.#.......
.#.#####.#######.
.#...............
