abcdefghijklmnopqrstuvwxyz-=[];/
ABCDEFGHIJKLMNOPQRSTUVWXYZ_+{}:?
OOOOOOOOOOOOOOOOCCCCCCCCCCCCCCCC
7
9 9
.#...Q...
.#.####B.
.....#...
.#####.q#
...#!#...
##.#.#.#.
@#.#.#.#.
.T.#.###.
...#.....
9 9
.....#...
.#S#.#.#.
.#.#@#.#.
.#.###.#.
.#...#.b.
.###.s.#.
.#.#...#.
.#.c####.
.....#!..
9 9
.#.....#@
.#.#.#.#.
...#.#...
.r##.###.
...#c#...
.###.####
.#...#!..
.#.#####.
.#.....q.
9 9
....R....
####.###.
.....#...
.#.#####.
.#.#!..S.
.#.###.#.
.#.#...#.
.a##.###.
.....#@..
9 9
.........
##.######
.B.#.....
.###.###.
...b.#.#!
.#####.##
.....s...
########.
@........
9 9
......A..
.#######.
...#.....
##.#a####
...#..!#.
r#######.
.#...#@..
.s.#.###.
...#....T
9 9
t........
.#.######
.#.......
.#######.
..@#.....
.###.##b.
.#...#...
##.###.##
!..#..C..
