abcdefghijklmnopqrstuvwxyz-=[];/
ABCDEFGHIJKLMNOPQRSTUVWXYZ_+{}:?
OOOOOOOOOOOOOOOOCCCCCCCCCCCCCCCC
7
17 17
...........#.....
######.A##.#####.
.....#.#.........
.###.#.#####.####
.#R..#.#...#@#..!
.##a.#.#.#.###.##
...#...#.#.....#.
##.r####.#######.
...#.....q.......
.#.#.#####.###.#.
.#.#...#...#...#.
.#.###.#.###.###.
.#...#.#...#...#.
.###.#.#######.#.
.#...#.......#.#.
.###########.#.#.
...............#.
17 17
...........#.....
.#.#######.#.###.
.#.#.....#.#..@Q.
##.#####.#.#####.
...#...#.#.....#.
.###.#.#.#####.#.
.....#.#.......#.
######.#.###.###.
.......#.#!#.#...
.#.#####.#.#.###.
.#.#...#.#.#.....
.#.#.#.###.#####.
.#.#.#.#...#..r..
.###.#.#.###.##Q#
.....#...#...#...
##########.###.#.
...............#.
17 17
.....#.#.....#...
.###.#.#.#.###.#.
.#.#.#...#...#.#.
.#.#.#.#####.#.#.
...#.#.#!..#...#.
.###.#.###.#####.
.#...#.#@#.#...#.
.#.###.#.#.#.#.#.
.#...#...#.#.#...
.###.#####.#.####
.#.#.....#.#.....
.#.#####.#.###.#.
.#...#.#.#...#.#.
.#.#.#.#.###.#.#.
...#.#.#.....#.#.
####.#.#########.
.................
17 17
.....#.....#.....
.#.#.#####.#.###.
.#.#.......#...#.
.#.###########.#.
.#...#.........#.
.a##.#.#########.
...#...#...#!#...
##.#####.###.#.##
...#@#.....#.#...
.###.#.###.#.###.
.#...#...#.#.....
.#.#####.#.####r#
.#.......#.....#.
.#####.###.###.#.
.#...#.#...#.#.#.
.#.#.###.###.#.#.
...#.....#.......
17 17
.........#..@#...
.#######.#.###.#.
...#...#.#...#.#.
.#.#.###.###.#.#.
.#.#.......#...#.
##.#######.#.###.
...#.....#.#.#...
.#.#.#R#.#.###.#.
.#.#.#.#.#.....#.
.###.#.#.#######.
.#...#.#.#.....#.
.#.##Q.#.#.###.##
...#A..#.#..!#...
.###.###.#######.
.#...#...#...#...
.#.#.#.###.A.#.##
...#.#.....#.....
17 17
.......#@#.......
##.#q#.#.#.###.#.
...#.q...#...#.#.
.###########.#.##
...#..q......#...
##.#.#######a#.#.
...#...#.#..!#.#.
.#####.#.#.q####.
.....#...#.......
####.###.########
.......#.#.#.....
.#####.#.#.#.###.
....A#.#.#.....#.
.###.#.#.#######.
.#.#.#.#.....#...
.#.#.#######.#.#.
...#...........#.
17 17
.........#.....#.
.###.###.#.#.#.#.
..Q#.#@#.#.#.#...
####.#.#.###.###.
.....#.#.#...#...
.#####.#.#.###.##
...#...#...#.#.#.
.#.#.#######.#.#.
.#.#.....#.....#.
.#.#.A.###.#####.
.#.#.#.......#..R
Q#.#########.###.
.#.#.......#...#.
.#.#a#####.###.#.
.#.#...#...#!#.#.
.#.###.#.###.#.#.
.#.....#.....#...
