abcdefghijklmnopqrstuvwxyz-=[];/
ABCDEFGHIJKLMNOPQRSTUVWXYZ_+{}:?
OOOOOOOOOOOOOOOOCCCCCCCCCCCCCCCC
7
9 9
C...@#...
.#####.#.
.......#.
.#####.#.
.#...#.#.
##.#.###.
!..#.#...
####.#.#.
..A....#.
9 9
.........
##.R.####
...#.#...
.###R#.#.
..b..#.#.
.###.#.#.
...#...#!
##.######
........@
9 9
.a...#@..
.###.###.
...#..!#.
#r.#####.
.#...#.a.
.###.#.#.
.#...#.#.
.#.#####.
.C...c...
9 9
S........
.#####b#.
......@#.
##.#####.
...#..!#.
.###.###.
.#.Q.#...
.#.###.#.
.#.....#t
9 9
@........
######.#.
.....#.#.
.###.#.#.
s#....B#.
.#######.
.......#.
.#####.#.
.#!....#.
9 9
.........
.###.####
..R#.....
##.##Q##.
@#.R.#...
.#.#.#.#.
.#...#.#.
.#.###.#c
...#!.q#.
9 9
...#@..T.
.#.t##.#.
.#...#.#.
.#B#.#.#.
.#.#!#.#.
.#.###B#.
.#.....#.
.B##.#.#.
r....#...
