abcdefghijklmnopqrstuvwxyz-=[];/
ABCDEFGHIJKLMNOPQRSTUVWXYZ_+{}:?
OOOOOOOOOOOOOOOOCCCCCCCCCCCCCCCC
7
17 17
...#.....#.......
.B##.#.###.#####.
...r.#.....#...#.
.#.#.#######.###.
.#...........W..s
.###########.#.#.
.....#.....#.#.#.
####.#.###a#.#.#.
...#.#.#...#.#c#.
.##e.#.#.E##.#.##
.....#.#!#...#...
.#####.T##.#W###.
...#.#.#...Q...#.
#w.#.#.#####.#.#.
.#.#.#.....#.#.#.
.#.#.#####.#.#.#.
........@#...#...
17 17
.v..U......#...#.
.#.#####.#.#.#.#U
.......#.#.#!#.#B
.#######.#####.#.
.#.......#r....#.
##.#e#.##D.#####.
...#...#...#.....
.#U#.###.#######.
.#.....#.....#.s.
.#####.#####.#.A.
..T..#.#.S.#.#.#.
.c##.#.#.###.#.##
.#.#.#...#...#...
.#.#.###.#B#####.
.#.#...#@#...R...
.#.###.#########.
.....#...........
17 17
.......#.....#...
.##Vw###.###.#.#.
...........#...#.
.##########B####.
...#@#.....#...#.
##.#.#.###.#.#.#e
.W...#.#...#.#...
####.#.###.#.###s
...#.v...#.#...#.
.#.#####.#.###.#.
.#.......#.....#.
.#.#############.
Q#.#!..#U......#.
.###F#.#.#####.#.
.#.....#...#.#.#.
.#.#######.#.#.#.
...#...a.....#...
17 17
.#...#.#.........
.#.#.#uD.###.T##.
.b.#.#...#...#...
.#.#.#####.###.##
S#.#.f...#...#...
.#.#.#.#.###.###.
.#.#...#...#...#@
.#.T######.#VV.##
.#!#.#.....#.#...
.###.#.#########.
.....#.#.........
.#.###.#.###.###.
.#...#.#...#.u.#.
.###.#.#######.#.
..d#...#...D.#.#.
##.#####.###.#.#.
.........a.....#.
17 17
.#.....#.....#...
f#.#.#.Q.###.#.#.
...B.#.#.#.#.#.#.
.###.#.#.#.#.###.
.#...#.#.#.#.#...
.#.###.#.#.#.#.##
.#.#.#.#.#...#w..
##.#.#.#.#.###.#.
...#...#.V.#...#.
.###.#R#.#.###.#.
.#F..C.#.#...#.#.
.#####.#.###.###.
.....#...#.......
.###.#####.#####.
...#.#...#.#...#.
##.#.#.#.###.#.#.
...R...#..q..#!#@
17 17
.#......v..#.....
.#w#B#####.#.#.#.
.#.#@..#...#.#.#.
R#.###.#.###.#.##
t#.....#..f..#...
T#.#######.#####.
...#.....#.....#.
####.###.###.###.
!..#.#.#.A.#.#...
##.#.#.###.#.#.##
.#...#...#.#.#...
.######U.#.####E.
.#.......#.....#.
.#.#.#.#######.#.
.#.#.#.#.....e.#.
.#.#w###.#.###.#.
...F.....#q......
17 17
.......#.....#...
.#####.#.###.###.
.#.....#...#.#...
.#.#######.#.#b#.
.#.....#...#...#.
.#a#.###.#######.
.s.#.#...#..!#...
.#.#.#.###.###.##
.#.#E#.....#.#.#D
.#.#.#######.#.#.
.#.#.#.F.....#...
.#.#.###.###.#c#.
.#.a.....V@#..Vd.
.#########.###.#.
.#...#.........#.
.#.#.###########.
...#....t........
