abcdefghijklmnopqrstuvwxyz-=[];/
ABCDEFGHIJKLMNOPQRSTUVWXYZ_+{}:?
OOOOOOOOOOOOOOOOCCCCCCCCCCCCCCCC
1
17 17
.#q..........#!#.
.#.Qr#.tb#####.#.
.#.#...#.#.....#.
.#.#.#####.#####.
.#.#A..#.a.#.....
.#.#T#.#.##B##.#.
...#.#...#...#.#.
.###.##S##Q#.#.#.
r..#.......#.#T#@
##.#.#######.#.##
...#C#....R..#...
.###.#####.#####.
.B.#....c#...S...
##.#.###.#######.
...#...#.....#t#.
.Q##########.#.#.
..s........t.#...
