abcdefghijklmnopqrstuvwxyz-=[];/
ABCDEFGHIJKLMNOPQRSTUVWXYZ_+{}:?
OOOOOOOOOOOOOOOOCCCCCCCCCCCCCCCC
13
17 17
.c.........#...#.
.#####.###.#.#.#.
...#...#!#.#.#...
##.#.#.#.#.#.###.
...#.#.#.#.a...#.
.###.###.#.###.##
...#...#.#...#...
##.###.#.###.###.
.#...#.#...#.....
.###.#.###.#####.
.....#.#...#...#.
.#####.#.#a#.###.
...#.#.#.#...#...
##.#.#.#.#.###.##
@#.#.#.#.#.#...#.
.#.#.#.#.#.#.###.
.....#...#.......
17 17
.#...#.........#s
.#.#.#.#.#####.#.
...#...#.....#...
.###########.###.
.R...#.......#...
.#.#.#.#########.
.#.#...#...#!..#.
.#.#.###.#.###.##
.#.#.#...#...#...
.#.#.#.###.#####.
@#.#.#...S.....#.
##.#.###.###.#.#.
...Q...#.#.#.#.c.
.#####.#.#a#.###.
.....#.#...#.....
.###.#####.######
...#.............
17 17
.#.....#.........
.#.#.###.#.######
...#t#...#...#...
####.#.#####.#.#.
...#....@q..C#.#!
.#.#######.#.#.##
.#.........#.#...
.##############S.
.#...#.....#...Q.
.#.#.#.###.#A#.#.
...#...#.#...#...
A#######.########
.#...#.......#...
.#.#.#.#####.###.
...#.#.#.B.#.....
####.#.b.#.###B#.
.......#.#.......
17 17
...........#.....
.#########.#####.
...#.......#.....
##.#.#######.###.
...#.#...#.....#@
.###.###.#.###.##
...#...#.....#...
##.###.########T.
...#...#.........
.###.###.##q#####
.#.#...#...#.....
.#.###.s##.#.###.
...#.#..!#.....#.
##.A.#####.#####.
...#.....#.#...#.
.c####.#.###.#.#.
.......#.....#...
17 17
.#...#.....#....r
.#.#.#.###.#.###.
...#.#.#!#.#.#...
.###.#.#.#.###.#.
...#...#...#...#.
##.#########.##q.
.R....Q#..b..#.B.
.#####.###.###.##
.....#.....#.#...
####.#######.###.
.....#.S......t#.
.#####.#.###.##C.
.......#...#.#...
.####B####.#.#.##
.#@#.......#.#.#.
.#.#.#########.#.
...#.............
17 17
.......#.........
.#b###.#####.#.#.
.#@........#.r.#.
.#####B###.#qr.#.
.#...#...#.#...#.
.#.#.#.#.#.#.###s
...#...#.#...#...
.#######.#####.#.
.......#.....#.B.
########.###R#.#.
......!#...S.#.#.
.#########.#.#.#.
.#.........#.#.#.
.#.#########.#.#.
.#.#.......#...#.
.###.#####.#####.
.....#...........
17 17
@....#...........
####.#.#####.#.##
..!#...#...#.#...
.#####.#.#.#####.
.#...#.#.#.......
.#.#.#.#.#####b#.
...#.#.#.#.......
####.###.#####c##
...#.#...#...#...
.#.#r#.###.#.#.#.
.#.#.#.....#...#.
.A##.#.#########.
.#...#......R#...
.#.#########.#.##
.#.#.......#.#...
.#.###.###.#####.
.......#.........
17 17
.........#.......
.#C#####.#.###r#.
...#...#.#.....#.
t#.#.###.#.#####.
.#.#...T.Q.S...q.
.#.###.###.#.###.
.#...#...#.#...#.
.###.###.###.#.##
.#...#.....#.#...
.#.#######.#B###.
.#.#...#...#.....
.#.#.#.#.###.####
.#...#.#.....#!..
.#####.###.#####.
.#@..#...#.#.....
.###.###.###.####
.......#.........
17 17
.....#...#!....#.
.#.#.#.#.#####.#.
.#.#...#.....#...
.#.########c.###.
.#.....#.......#.
.#####.##t.#####.
...#@#...#.#.....
B#.#.###.###.####
...#...#...#...#.
.###.#####.###.q.
.#.......#.....#.
.#######.###B###.
.......#.....#...
######.#.T.#.#.##
.....#.#.#.#.T...
.#####.###.#.###.
...........#.....
17 17
...#...........#.
.###.#.#######.#.
.#...#.....#.#.#.
.#.#######.#.#.#.
.......#...#...#.
.#####.#.###.###.
...#!A.#.#...#...
####.#.#.#.#####.
.....#.#.#.#...#.
.#######.#.#.#.#.
.#.......#...#...
.#.#############.
...#T.........@#.
####.C##S###.###.
...#.......#.#...
.###.#####.#S#.##
.........#.......
17 17
C#.....#.......#.
.#.b.#.#.T####.#.
...#.#.#.....#.#.
.###.#.#.###.#.#.
.#...#.#.#...#...
.B.###.###.#####.
.#.#.#...#.....#@
.#.#.###.#####.##
.#.#.....#...#...
##.#.##q##.#.###.
...#.....#.S.....
.####B##.#.#####.
.#.....#...#.#...
.#.###.#####.#.##
...#.#..!#...#..s
####.#T###.#.###.
.B.........#.....
17 17
...A.....#.......
.#.#.#S#.#.###.##
.#...#...#...#...
.#####.#####.###.
.#.....#@....#...
.#####.##q.###.#.
.....#...#.#...#.
####.###.###.##c.
!A...#.#...#.#.#.
.#.###.###.#.#.#.
.#.#.....#.#.#...
.#.###.#.q.#.####
.#...#.r...#.....
.###.#.###q#####.
.....#.#.........
######.###.#####.
...........#.....
17 17
...#...#q..#.#...
.#.#.#.#.#.#.#.#.
.#...#.S.#.#...#.
.#######.#.#####.
.....#...#.....#.
.###.#.######C.#.
..@#.#!#.....#.#.
####.###.###.#.#.
.....#...#.#.#.#q
.#####.###.#.#.#.
.....#.#...#.#.#.
.###.T.###.#.#.#.
...#.#.....#.#a#.
##.#.#T###.#.#.#.
.#.#.....#.#.#.#.
.#.#a###.#.#.#.#.
.......#...#.....
