abcdefghijklmnopqrstuvwxyz-=[];/
ABCDEFGHIJKLMNOPQRSTUVWXYZ_+{}:?
OOOOOOOOOOOOOOOOCCCCCCCCCCCCCCCC
13
17 17
...........#.....
##.#######.#.###.
...#!#.....#.#.#.
.###.#.#####.#.#.
.#...#.#.......#.
.#.###.#######.#.
.#.#.......#...#.
.#.#######s#####.
.#.....#.#.......
.#####.#.#######.
.#.....#.......R.
.#.##r##.###.###.
.#.#.....#.#...#.
.#.#.#####.c##.#.
...#...#.....#...
######.###.#.####
@..........#.....
17 17
.................
.###########.###.
.#.........#...#.
.#########.###.#.
.#.........#.#.#.
.#.#######.#.#.##
.#.#...#@#...#...
.#.#.#.#.###.R#A.
.#...#.#.#...#.#.
.#####.#.#.###.#.
.#.....C.......#.
.#.#############.
.#.#!..#.........
.#.###.#.#######.
...#.#.#.#.......
##.#.#.#.#.######
.....#...#.......
17 17
........@#..T..#.
.#.#######.#.#.#.
.#.........#.#.#.
.###########.#.#.
.#...#.......#.#.
.#.#.#.####Q##.#.
.#.#.#.....#.....
.#.#.#####.#.####
...#...#...#.#...
####.###.###.#.#.
.....#...#...#.b!
######.B##.t##.##
.......#.....#.#.
.###########.#.#.
.#......R..#.#.#.
.#.#######.###.#.
.........#.......
17 17
...#.....#...#...
.#.#.#####rc.###.
.#.#.#...#.#.....
.#.#.#.#.#.#####.
.q...#.#.#.....#.
.###.t.#.#####.#.
.#...#.#.....#.#.
.#.###.c##.###.#.
.#...#.#...#...#.
.###.#.#.#.#.###.
.#...#.#.#.#!#.#.
.#####.#.####r.#.
.....#.#.#.......
.###.#.T.#.######
..C#...#.#.......
##.#####.#######.
......@#.........
17 17
...t.#...........
.#.#.#.#########.
.#...#.#@......#.
.#####.#######.#.
...#...#...#...#.
.#.#.###.#.#.b.#.
.#...#...#...#.#.
.#####.#####.###.
.#.....#T....t...
.#.###.#.#####.#R
.#.#...#.#...#...
.###.###.#.#.###.
.#...#!#.#.#.....
.#.#.#.###.#####.
.#.#.#...#.#...#.
.#.#.###.#.#.###.
...#...#...#.....
17 17
.....b...........
c#.##############
.#.#............!
.###.############
.....#.......#...
.#########.#.#.#.
...#.......#.#.#.
##.###.#a###.###.
...#...#.....C...
.###.##t.####a.#.
.....#B#.#....c#.
######.#.b####.#.
.......#...#...#.
.#.#######.#.###.
.#.#.....#.#.#@#.
.#.#.###.#.#.#.#.
.#.....#.....#...
17 17
...........#.....
.#######.#T#.###.
.......#.#...#...
.q######.########
.#...#!#.........
##.#.#.#.#######.
...#...#.#.....#.
.#######.#.##b.#.
...#.....#...#.#.
##.#.#######.#.#.
...#@#.......#...
.#####.#########.
.#...#.#...#...#.
.#.#.#.#.#.#.#.##
...#.#...#...#...
####.###########.
................A
17 17
.........#.......
.#######.r.#.###.
.#.....#.#.#...#.
.#.#.#.#.#.##q.#.
.#R#.#.#.#.#...#.
.#.#.###.#.#.####
.#.#.#...#.#.....
.###.#.###.#####.
..a#.t...#....@S.
.#.#.###.#######.
.#.#c............
.#.r.###########.
.#.#.#...#...#..t
.#.#.#.#.#.#.####
.#.#T#.#...#.....
.#.###.#########.
.#.........#!....
17 17
.#.....#.........
.#.###.#.###.###.
.#...#.....#.#.#.
.###r####A##.#.#.
.....#q..#...#...
.#####.#.#.###.##
.#!....#.#...#...
.#######.###.###.
...#...#.#...#.#.
##.#.#.#.#.###.#.
...#.#...#.#@..#.
.###.#####.###.#.
.#.#.#...#.t...#.
.#.#.#.#.#.#.###.
...#...#.#.#.....
##.#####.#.#.####
.......#...#.....
17 17
...#!#.......#...
.#.#.#.#.###.#.#.
.#...#.#...#...#.
.##B####.#.#####.
.#.....#.#.#.#...
.s##.#.###.#.#.##
...#.#.....#.#...
##.#.###At##.##q.
...#.#.......#...
.###.#.#####.#.##
.#...#.#...#@#.#.
.#.###.#.#.###.#.
...#.....#...#.#.
####.#######.#.#.
...#.......#.#...
.#.#######.#.###.
.#.........r.....
17 17
..@#.............
.###.#######.###.
.......#Q....#...
########.#####.##
.....#...#...#.#.
.###.#.###.#.#.#.
.#.#!#...#.#.#.#.
.#.#####.#.#.#.#.
.........#.#.#...
#########Q.#B#Q#.
...#...........#.
.#.#.#######.###.
.#.#.......#.....
.#####c###.######
.....#...#...#...
.#.###.#.###.###.
.#.....#.........
17 17
.....#@..........
.#.#.#########.##
.#.#......S..#...
.#.#########.###.
.#.#...#...#.#...
##.#.#.#.###.#.##
...#.#.#.....#...
.###.s.#.#######.
.....r.#.#.....#.
.#####.#.#.#.#.#.
.#.....#.#.#.#.#.
##.#####.###.#.#.
...#.........#...
.#########.######
.#...#...#.#.....
.#.#.#.#.###.t##.
...#...#.......#!
17 17
.............#...
.#########.#.###.
...#.c.....#.#...
##.#.#.#####.#.#.
.....#.#...#.#.#.
####A#.#.#.#.#.#.
!..#..b#.#.#...#.
##.#.#.#.#.####A.
.#.#.#.#.#...#...
.#.#.##A.###.#.##
.s.#.....#.#.#..@
.#.#.#####.#.####
...#..Q....#.....
.R##############.
.#.......#.....#.
.#.#####.#.##t.#.
...#.......#.....
