abcdefghijklmnopqrstuvwxyz-=[];/
ABCDEFGHIJKLMNOPQRSTUVWXYZ_+{}:?
OOOOOOOOOOOOOOOOCCCCCCCCCCCCCCCC
7
17 17
...#.......#R....
.#.#.###.#.#####.
.#@#.#...#.......
.###.#.#.####a###
.....#.#.#.......
######.#.#.#####.
.......#.#.#A..#.
.#########.#.#.#.
.#.......#.#.#...
.#.A####.#.#.##Q.
.#...#!#...#.#...
.#.###.#.###.###.
...#...#...#...#.
.###.#######.#.A#
...#...#...#.#...
##.###.#.#.#####.
.....#...#.......
17 17
.....#...#...#...
.#.#.###.#.#.#.#.
.#.#.....#.#...#.
.#.#######.#####.
.#.....#...#...#.
.#####.#.###.#.#.
....@#.#.....#.#.
######.#######.#.
.......#.....#.#.
.###.###.###.#.#.
.#...#!..#.#...#.
.#########.#####.
...............#.
.#####.#########.
.#...#.........#.
.a##.#########.#.
.............#...
17 17
...#...........#.
.#.#.#.#######.#.
.#.#.#.#.......#.
.#.#.#.#######.#.
.#.#.#.......#...
.###.#######.###.
...#...#...#...#.
##.###.###.###.#.
....@#.#.....#.#.
.#####.#.###.#.#.
.#.......#!#.#.#.
.#.####r##.#.#.##
...#.#.....#.#...
.###.#.#####R###.
.#...#.#.....#...
.#.#.#.###.#.#.#.
...#.#.....#...#.
17 17
.....#...#.......
.###.#.#.#.###.##
.#.#.R.#.#...#...
.#.#.#.#.#######.
.#.....#.........
.###############.
.......#.......#.
######.#.#####.#.
.......#.#..@#...
.#######.#.######
.....#.#.#.......
.###.#.#.#######.
...#.#...........
####.##########a.
..!#...#.......#.
.#####.#.#.#####.
.......#.#.......
17 17
.#...#.........#.
r#.#.#.#r###.#.#.
.#.a.......#.#...
.#.#####r###.###.
...#.q.......#.#.
####.#########.#.
.....#.........#.
.#######.#.#####.
...#.....#.#...#.
.#.#.#r#####.#.#.
.#.#.A.......#...
##.#########.####
...#...#...#...#@
.###.r.#.#.###.#.
.#!..#...#.#.#...
.#########.#.###.
...........#.....
17 17
.....#.......#...
.#.#.#.#####.###r
.#.#.#...#@......
##.#.#.#.#######Q
...#.#.#.......#.
.###.####Q####.##
.#...#......Q#...
.#.###.#####.###.
.#.....#.......#.
.##r##########.#.
.#.........#!#.#.
.#.#######.#.#.#.
...#.....#...#...
####.###.#####Q#.
...#.#.#.....#...
.#.r.#.#.#####.##
.#.....#.........
17 17
.#..q..#.....#...
.#.#.###.#.#.#.#.
...#.#...#.#.#.#.
.###.#.###.#.#.#.
.#...#.#...#.#.#.
.#.###.#.###.###.
.a.....#...#.....
##########.#####.
.....#...#.#@....
.###.#.#.#.#####.
...#...#...#...#.
##.#.#######.#.#.
...#.#a..#...#!#.
.#####.#.#.#####.
.#...#.#...#.....
.#.#.#.#####.####
...#...#.........
