abcdefghijklmnopqrstuvwxyz-=[];/
ABCDEFGHIJKLMNOPQRSTUVWXYZ_+{}:?
OOOOOOOOOOOOOOOOCCCCCCCCCCCCCCCC
11
17 17
.#.......#.#.....
.#.#.###r#.#.#.#.
.#.#...#...#.#.#.
.R.###.#####.#.#a
...#...#.....#Q#.
.###.s##.###S#.##
..@#.........#...
##############.#.
....r........#.#.
.###########.###.
.......#...#.....
.#####.#.#.#.####
.#...#.#.#...#...
##.#.s.#.#####.#.
...#...#...#.q.#.
.##########b.###.
...............#!
17 17
...#...........#.
##.#.#########.#.
...#.#...#...#b#.
.###.#.#.###.#.#.
...#...#..!#.#...
.#.#########.###.
.#.......#...b.#.
.#.##b##.#.#.#.#.
.#.#...C...#...#.
.#.#######.#####.
.#...C...#.#...#.
.#######.#.#.#.#.
..@#.....#.#.#.#.
####.#.#####.#.#.
.....#.#.....#...
.#######.########
.................
17 17
.......#.........
.#####.#.#.#####.
.#...#.#.#.#.#...
.#.#.#s###.#.#.t#
.#.#...#...#...#.
.###t###.###.###.
...#.....#.#...#.
.#.#.#####.###.#T
.#.#.#...#...#.#.
.#.##Q.#.###.#.#.
.#.....#...#.....
.#########.#####.
.#.......#...#...
.#######.###.###.
.#...#.....#...#.
.C.#.#.#.#####.#.
...#...#.#!....#@
17 17
...#...........#.
.#.#.#.#######.#.
.#...#.#.....#.#.
######.#.#####.#.
.......#.......#.
.####A##q#.#####.
...#.....#.#...#.
##.#.###.#.#.#.#.
...#.#.#.#...#...
.###.#.#.###q###.
...#...#...#...#.
##.#.#####.#.#.#.
...#.#.....#.#.#.
.###.#.#####.#.#.
.#...#..!#...#@#.
.#.#######.#####.
...#.............
17 17
.......#.......#.
.#.###.#.##s.#.#.
.#B..#.#.#.#.#...
####.#s#.#.#.###.
.....#...#.#.#...
.#####.###.A.####
.#c....#...#...#!
.#.#####.#.###.#.
...#..q..#...#...
.###.c######c####
.#.......#......@
.#######.#.#Q####
...#.....#.......
##.###########.#.
.#.......#..R#.#.
.#######.#.#.###.
...........#.....
17 17
.................
.##a############.
.#.............#.
.#.#######a###.#.
...#.....#.....#.
##.#.###.#######.
.#.T!#...#.......
.#.###.###.######
.#.#...#.....#@..
.#.#.c######.###.
...#...#...#...#.
.##s##.#.#.###.#.
...#.#.#.#.....#.
##.r.#.#.#######.
.#...#...#.....#.
.#r#.#####.###.#.
...........#.....
17 17
.....c.....#.....
.#########.###.#.
...#...#.....#.#.
.#.#.#.###C#.#.#q
.#...#.....#...#.
.#########.######
.....#.....#.....
####.#.T####.###.
...#.#...#.....#.
.###.###.#.#####.
.......#...#...#.
.#######.###.#.#.
.#....!#.#...#...
.#.#######.#####.
.#.#...#...#.....
.#.#.#.#.###.####
@s...#...#.......
17 17
.......#...#....!
####.###.#.#.####
.....#...#.#.....
.#####.#S#.#####.
...#...#.#...#...
.#.#.s##.###.#.##
.#.#.#.....#a..#.
.#.#.#.###.#####.
.#...#.#.#...#...
.#####.#.###.#.#.
...#...#...#.#.#.
##.###.#.#.#.###.
.r.#...#.#.#...#.
.#.S.###.#.###.#.
...#.#@#.#...#...
.###.#.#.#.#####.
.....#...#.......
17 17
.......#.........
.t.#####.###.###.
.#...#...#!#.#...
.###.#.###.#.####
...#.....#.#.....
##.#######.#.###.
.#...#.....A.#...
.##c.#.#####.#.##
...#.#.#.....#...
.#.#.#.#########.
.#.s.#...........
.###.#####q######
.....#...........
.#########.#####.
.#.........#.....
.###.#######.####
.....c@..........
17 17
...#.....#.#.....
.#.#.###.#.#.###.
.#...#...#...#@#.
.#####.#####.#.#.
.#...#.....#...#.
.#.#.####C.#####.
...#...#!..#...#.
#####r.#####.#.#.
.....#.......#.#.
.#############.#.
.#.........#...B.
.#.###.#####.###.
.#.#.#.#.....#...
.#.#.#.#.#####.B#
.#.#.#...#...#...
.#.c.#####.#.###.
...........#.....
17 17
......!#@#..S....
.#######.#.#.####
...#.......#.#...
##.######a.#.b.#.
.#.#.....#.#...#.
.#.#.###A#######.
.#.#.#.#...#.....
.#.#.#.###.#.####
.#...#.....#.....
.#####.##c######.
....T#.#.......#.
.###.#.#.#.###.#.
.#...#.#.#...#...
.#####.#####.###.
.....#.......#.#.
.###.#B#######.#.
...#.............
