abcdefghijklmnopqrstuvwxyz-=[];/
ABCDEFGHIJKLMNOPQRSTUVWXYZ_+{}:?
OOOOOOOOOOOOOOOOCCCCCCCCCCCCCCCC
7
35 35
...#...........#a..#..B..#..q......
.###.###.#####.#.#.#.###.#.###q###.
...b.#.#.#...Qq#.#...#.#.#.....#.#.
.#####.#.####Q##.#####.#.#####.#.#.
.#c..R.#...............#.....#.#.#.
.###.#.##T##################.#.#.#.
...#.#...........#.........#S....#.
##.#.###########.#.#######.#####.#.
.#.#.#...#.......#.C...#.#.....#.#.
.#.#.###.#.#####.#####.#.#####.###.
.#.#.....#.#...#...#...#b....#.....
.#.###.###.#.#.###.#.###.#########.
.#.#...#...#.#..s..#.#...#.......#.
.#.#####.###.#######.#.#.#.#.###.#.
.#.#.....#.#.T...A.#.#.#.#.St#...#.
.#.#.#####.#.#.#####.#.###.#.#####.
...#.....#.#.#.#.....#.....#tA.#...
.#######.#.#.#a#.#####.#######.#.#R
.........#.....#.#....a..#...#.....
##########.#####.#######.c.#.######
Q........#...#...#S....#.#.#...#...
B#######.#t#.#.#.#.###.###.###.#.#.
.......#.....#.#.#...#.#...#.#...#.
.#####.#####S#.#####.#.#.###.####Q.
.....#.#...#.#.......#.#.....#....a
.###.#.#.#.###.#######.#####.#.###.
...#b#.#.#...#.....#.......#.#...#.
####.#.#.###.#####.#.#######.###.#.
.....#.#.#...#.....#...#...#...#.#.
.#####.#.#.###########.#.#.###.#.#.
.#.......#.#..RS.....#...#.....#.#.
.#########.r.#.#.###.###########.#.
........!#...#.#...#...#.......#.#.
######B######c.###.###C#.#####.#.#.
@..................#R....#S......#.
35 35
.......#.....#...........#...#.....
####.#.#.###.###.#######.#.#.#.###.
.....#...#.#.....#...#...#.#.#.#...
.#########.#######.###.###.#.#.#.##
.#.#.............c..t#.#...#.#.#...
.a.#A########R######Q#.###.#.#.###.
.#..B......#...#.....a.....#.#..S#.
.###.#####.#.#.#.##c.#######.#.###.
...#.#...#.#.#...#...#...c.#.#.#...
##.###.#.###.#####.###.#.T.#.#.#.##
.#.....#...#...#...#...#...#.#.#...
.#########.###.#.###.#####.#.#####.
.....#...#...#.#.....#...#.#.#...#.
t#.#.#.#.###.#.#######.###.#.#.#.#.
.#.#...#.#.s.#.#...........t.#.#...
.#.#####.#.#.#.#######.#####.#.###.
.#.#...A...#.#.......#.#.#...#...#.
.#.#######.#.#######.#.#.#.S####B##
.#.....#.#.#....!#...#...#.....#...
.##q##.#.#T#s#####.#####ac####.#.#.
.#...T.#.#.....#...#.......#.#.#.#.
.#.#.#.#.#.#####.#.#.###.#.#.#.#.#.
.#.#.#.#.r.#...#.#.....#.#...#.#.#.
.#.###.#####.#.#.#######.#####.#.#.
.#...#...#...#...#.......#.....#.#.
.#t#.t##.#.#######.###.BA#.#######.
.....#.#...#.....#.#...#...#.....#.
####.#.#####.t##.#.#####.#Q###.#.#.
...#.........#...#...#...#.....#...
.b#Q##########.#####.#.###.#######.
.#...........#.....#.#.#...#..@#...
.#.#####.#######a#.#.#.#.#.#.#b#.##
.#.#...#.#.....#...#...#.a.#...t...
.#.#.#.#.#.###.#.#########.#.#.###.
.....#.#.....#.............#.#.....
35 35
.T.#.......#.........#.............
.###.#.###.#.#.#######.#####.#.####
.#...#...#.#.#.........#.....#.#...
.#.#####.###.###########.#.####a.#.
..A#...#.....#@#.........#.#.....#.
####.#.#.#####.#.#######B###.#####.
.....#.#...#...#.............#.....
.#####.RA#.###.#############.#.####
.#.....#...#...#.#.........#.#.....
.#.#######.#.#.#.#.#######.#####.#.
.#.#.....#...#.#.#.#...........#.#.
.#.#.###.#####.#.#.#####.#####.###.
.#.#...#.#.......#.#...#.#...#...#.
.#.#s#.#.#.#######.#.#.###.#.###.#.
.#.....#.#...#.....#.#.....#...#...
.#######.###.#.###.#.#########.###.
.....#.#...#.#...#.#.....#...#.#...
####.#.###.#####.#######.#.###.#Q##
...#.#.....#...#.......#.#.....#...
.#.#.#.#####.#.###.###.#.###.######
.Q...#.......#...#.#...#...#.#.....
.###############.###.#####.#.##T.#.
.......#...#...#.....#...#.#.....#.
.#####.#.#.#.##S.#####.#.R.#######.
.#...#...#.#.#...#...B.#!#...#.#...
.###.#####.#.#.##q.#.#.#####.#.#.##
...#.....#.#.....a.#.#.......A...#.
##.#.####t.#######.#.#########.###.
...#...#...#A....#.#.........#.#...
.#####.#.#.#.###.#.###.#####.A.#.#.
...#...#.#.#.#...#...#.#.Q...#.#.#.
Q#.#.###.#.#.#.###.###.#.t####.#.##
.#.#...#.#.#.#.....#...#...#...#...
.#.###.#.###.####ac#.####A##.#####.
.......#...........#...............
35 35
...#.....#...........#.......Q.....
.#.#.#.###.###.#####.###Q#.#.#####.
.#...#.......Q...#.#.....#.#.#.....
.####B##########.#.####c.###.#####.
.....#.....#...#.B.........#.....#.
####.#.#.###.#.#.#########.#####.#.
.#...#.#b#...#...#.......#.#....Q#.
.#.#C###.#.#.####R.####t.s.#.#####.
.#.......#.#.#...#.#...#.#...#.#...
.###.#####.###.#.#.#.###.#####.#.##
.#...#...#.....#.....#...#...#...#.
.#.###.#.###.#######.#.##R.#.#.###.
.#...#.#...#...#...#.#.#...#.#C#...
.###.R.###.#####.#.###.###.#.#.#.##
.....#.#...A...#.#.....#...#.#.#...
.#####.#.C##.#.Q.#######.#####.#.#.
.#.#...#.....#...#.....#...#...#.#.
.#.#.#####R#######.###.#.#.#.###.#.
...#...........#.....#...#.#.#.#.#.
##.#######.##c.#####.#####.#.#.#.#.
...#.#...#...#...#.....#...#.#...#.
.b##.#.#.###.###.#######r###.#####.
.#..S#.#...#...#.......#.........T.
.#.###.###.###.#######.#########R#.
.#.#!#...#.#...#.....#.....#.......
.#.#.###.#.#.###.q##.#####.#####.##
...#.#...#.#.#...#.......#.....#...
##.#.#.###.#.###.#######.#####.###.
.R.#...#...#.#...#...#@..#.....#.#.
.#.#####.###.#.#.#.#.#####.#####.#.
.#.....#.#...#.#.#.#.....#...#...#.
.#####.#.#.###.#.#.#####.###.#.###.
...#...#.#.....#.#.#...#.#...#...#.
.###.A##.#########.#.#C#.#.###.#.#.
.......#...........R.#.....#...#...
35 35
.....#.......#...#...#.........#...
.#.#.#.#####.#.#.#.#.###.#####.###.
.#.#...#.....#.#.#.#...#.....b.#...
.#C#######.###.R.#.###.B##.t.#.#.##
.#.......#.....#...#.#...#.#.#.#...
.#######.t##########.###.#.#.#.###.
.......#...#.#...#.......#.#.#.#...
.#######R#.#.#.#.#.#######.#.#.#.##
.#.....#...#...#...#....T..#.#.#...
.#.###.#.###.#####.#########.#.###.
.#.#.....#.#.#...c.........#.#.#...
.#.#######.#.#.#.#########.#.#.#.##
.#.#...#A....#.#.#.....#.#.#.#.#...
.#.#.#.#.#####.#.#.###.#.#.#.#.T.#.
.#...#.#.#...#.#.#.#.#.#...#.#.#.#.
.#####.###.#.#.#.#.#.#.#.###.#.###S
.....#.#...#...#.#.#.#.#.....#.....
####.#.#.#######.#.#.#.#######.####
.....#.....#.#...#...#.....#.#.#...
.#########.#.#.#####.#####.#.#.#.#.
@#.....#.#.T.#.....q.#..br.#...#.#.
##.###.#.#.#.#c###.#.#.###.#####.#.
...#...#.........#.....r...#.....#.
.###.###########.#######.#.#.#####.
.#...#...#.........#...#.#.B.#.#...
.###.#.#.###########.#.#.###.#.#.#.
...#.#.#...........#.#...#...#.#.#.
.#.#.#.#.#########.#.#####.###.#.B#
.B.#...#.#...#...#.#...#...#...#..!
##.#######.#.#.###.###.#.###.######
...q.......#.#...#.....#...#.......
.###.#######.#.#.#.#######a#.###.#.
.....#.....#.#.#...#q....#.#...#.#.
.#########.#.#######.###.#.#####.#.
...........#...........R.........#.
35 35
.......#.#...#...#.............#...
.###.#.#.#.#.#.#.#.#########.#.###.
.#...#...#.#...#...#.......#.#.#...
##.#####.#.###########.###.#.#.#.#.
...#...#c#.#.....#.....#...#.#...#.
.###.#.###.#.###.#.#####.###.####b.
.#...#...#...#.#...#.......#.#.#...
.#.####q.#####.#####.#######.#.t.##
.#.....#...#.....#...#.......#.#...
.#####.##T.#.#.#Q#.###.#######.###.
.....#.#.#...#.....#.#...#.........
####.#.#.###########.###.##########
.....#.#...............#.#.........
.###.#.###.###########B#.#.#######.
...B.#...#.#.....#.....#.#.....#.#!
.#.#####.#.###.###.##Q##.#####.#.##
.#.....#.#.....#...#...#.....#.....
.#####.#.#######.#c#.#.###.#.#####.
...#.#...#.....#.#...#...#.#.#.....
##.#.#####.###.#.#.###.###.###.##T#
...#.......#.T.#.....#.tq#.....#r..
.S##.#######.#.#########.#######.#.
...#...#.....#.#...........#.R...#.
##.###.#.###.#.#.#########.#r#.B##.
.#...#.#...#.#...#.......#.#...#...
.###.#.#.#.#######.#.#####.#####.#.
...#...#.#.#.......#.....#.#.....#.
.#.#####.#.#.#########B#.#.#.#####.
.#.#...#.#...#...#.....#s..#...#.#.
.#.#.#.#.#####.#.###.#.#####.#.#.#.
.#.#.#...#.....#...#.#...#@..#.#...
.#.#.#########.###.#.###.#####.###.
.#...S.......#.#.#...#.#.....#...#.
.#########.#.#.#.#####.###t#.###.#.
...........#...#.................#.
35 35
.....#...............#.#...........
.###.#.#.###########.#.#.#########.
..@#...#...#.....#...#.........#...
######.###.#####.#.#######.#####.a.
.....#.#...#.....#.#...#...b....r#.
.###.#.#.###.###.#.#.#.###.#.#####.
...#.#.#.#...#...#...#...#.#...B...
.#.#.###.#.#############.s####.###.
.#.#.....#...........#...#...#...#.
.Q.####B######r#.#####.###.#.#.#.##
.#.#.....#.......#...#.....#.#.#...
.#.#.###.#.#####.#.#.#S#####.#.##q.
.#.#...#.#.....#.#.#.......#.#.#...
##.#.#.#.#####.#.#.#######.#.###.#.
!#.#.#.#.....#.#.#...#.....#....B#.
.#.###.q###t.#.#.###.#.###.#######.
.#...#.....#...#.#...#.#.......#...
.###.#####.#######.###.#.#####a#.##
...c.#...#.....#...#.#.#.#...#...#A
##.#.#.#.#.###.#.###.#.###.#.#.###.
...#...#.#...#.#...#.#.....S...#...
.#######.###.#.###.#.############b.
.#.....#.#...#...#.#.#.............
.#.###.#.#######.#.#.#.#########.##
.#...#.#.......#...#.#.#.......#...
.###.#.#######.#.###.#.q.#####.###.
.....#.........#.Q.#...#B..#...#...
########q#########.#.#####.#.###.#.
...#.........#.sq..#.....#.#B#...#.
.###.#####.R##.###q###.###.#.###.##
...#...#.#.....#.....#.#...#...#...
#A.###.#.#######.###.#.#.#####.###.
.....#.#.........#.#.#.#.....#Q..#.
.#####.#######.c##.#.#######.###.#.
...........a...#.............#.....
