abcdefghijklmnopqrstuvwxyz-=[];/
ABCDEFGHIJKLMNOPQRSTUVWXYZ_+{}:?
OOOOOOOOOOOOOOOOCCCCCCCCCCCCCCCC
7
17 17
.#....!#.........
.#.#####.#q#####.
...#.....#...#...
.###.#####.#.#.#.
.#.#.#...#.#.#.#.
.#.#.#.#.#.#.#.#.
b#...#.#...#...#s
.###.#.######b##.
...#@#...#...#...
#d.####c.##A.#.##
...#...#...#.....
.###.#.#.#.######
.....#.#.#.#.....
######.###.#.###.
.....#...#.....#.
.#######.#######.
.................
17 17
@......D..A......
######.#.###.####
..S..#.#.Q.#.....
.###.#.#.#.D####.
.#...#.#.#....s#.
.#.###.#.#.###.#.
.#.#...#.#...#.#.
.#.##q.#.#####.#.
.t.....#...#...#a
.#####S###.#.###.
.#.......#.#.#...
.#r###.a##.#.#.##
.#...#.....#.#!#.
.##r.#######.###.
...#..s..........
.###############.
.................
17 17
.#.....#.........
.#.###.#.#.#####.
...#@#...#.#...#.
.###.#####.#.#.##
.#...#.#..C#.#...
.#.#.#.#.###.###.
.#.#.#.#.#...#...
.#.#.#.#.#.###.##
.#.#...#B#.#..q#.
.#.##R##.#.###.#.
...#.....#..!#.#.
D###.#########.#.
.#...#.....#...#.
.#.###.###.#.###.
.#...#.#.#...#...
.###.#.#.#a###.#.
...#...........#.
17 17
...............#.
.###.#########.A.
.#...#.....#..U#.
.###.#.###.#.###.
...#.#...#.#.....
.#.#####.#.#.####
.#..R..#.#.#.#...
.##Q.###.#.###.#.
...#...#.#.....#.
##.###.#.#s#####.
...#.#.#...#...#.
.###.#.#B#.#.#.#.
...#.#...#.#!#.#.
##.#.#.###.###.#.
@#...#...d.#.s...
.###.###.#.#.####
.......#.........
17 17
.....#...........
##.#.#.#########.
...#.#...d.#...#.
.##T.#####.#.###.
...#.....#.#b#...
##.#####.#.#.#T##
...#...#.#.#...#.
.###.#.#.#.###.#.
.#...#.#.#...#.#.
.#.B##.#.#.#.#.#.
.#.S...#.#.#.#...
.###.###.U##.###.
...#.........#!#.
.#.#######.###.#.
.#...#...#.#...#.
.###.#.#.#U#.###.
...#...#.....#@..
17 17
.........#.......
######.#.#.#.####
!......#.#.#.#...
###u####.A.###.#.
...#.....#...#.#.
.#.#.#######.#.#.
.#...#.....#...#.
.#####.###.#####.
.#.C...Q.......#.
.r.#.#########.#.
.#.#t....#...#.#.
.###.###.#.###.c.
...#...#.#.....#.
##.###.#.#.#####.
.#.#...#.#.......
.#.Q####.#######.
.........#@......
17 17
.U...#.....Q...#.
.###.#.#######c#.
...#@#.......#...
##.#########.###.
...#.....c!q.t...
.s##.###.#.#.#.##
.....#.#.#...#...
.#####.#.#######.
T#....q#.u.#.....
.##S##.###.#.####
.......#.#...#...
######.#.##b##.##
.#...#.....#.....
.#.#.#####.#.###.
...#...#...#.#...
.#U#.###.#####.#.
...#........u..#.
