abcdefghijklmnopqrstuvwxyz-=[];/
ABCDEFGHIJKLMNOPQRSTUVWXYZ_+{}:?
OOOOOOOOOOOOOOOOCCCCCCCCCCCCCCCC
7
21 21
...#.......#.........
.###.#.###.###.#####.
.....#B#.#...#.#.....
c#####.#.###.###.###.
.#.#...#.......#.#...
.#.#.#########.#.#.##
.#.#.#.......#...#.#.
.#.#.#.#####.#####.#.
...#.#.....#.#...#.#.
#Q##.#.r###b.###.#.#.
.....#.#.....#...#...
.#####.#.#####.#####.
.......#.....#s#.....
.##C########.#.#.####
.#.........#.#.#.#...
.###.###.#.#.#.#.#.#.
...#...#.#.#.#.....#.
##.#####.t.#.########
@#.......#.#.........
.##q######.#########.
............T..#!....
21 21
.....#...............
.a####.#.###.#######.
.......a...#.#...#...
.#########.###.#.####
...#.......#...#.....
####.A#A.###.#######.
....C#...#...#...#...
.#########.###.#.#.#.
...#.....#.....#.t.#.
##.#.###.###.#####.#.
...#...#.....#...#.#.
.Q####.#######.#.#.#.
r#...#.#.....#.#.#.#.
.#.#.T.#.#####.#.#.#.
...#...#.#.....#..A#.
####.###.#.#########.
...#t....#.#.........
.#.S######.#.########
.#.....#...#.....#@..
.#####.#.#######.###.
..!#.....#.s.........
21 21
.......#...#........C
.###.#.#.###.#####.#.
...#.#...c...#.....#.
##.#.#####.##r.#####.
...a...#.R.#...#...#.
.####r.#.###.###.#.##
.#...#.....#.....#...
.###.###########.#a#.
.#...#...#.....#...#.
.#.#.###.#.###.###.#.
...#...#.#.#.#...#.#.
t#####.A.#.#.###.###.
.......#.#.#.#.......
.#####.#.#.#.#.####C.
@#...#...#.#.#.#...#.
##.#.#####.#.#.#.#.##
...#.....#.#...#.#...
.####T##.#.#####.###.
.#.....#...#.....#...
.#.###.#####.#####.#.
.....#.......#!....#.
21 21
.........#...#...#...
.#######.#.#.#.###.#.
.......#...r.#.#...#.
.#####.#####.#.#.###.
.#...#.....#...#.#...
.#.#.#####.#####.#.##
.#.#.#.....#.....#...
.#.#.#.#####.###Q###.
.#.#.#.#...#.A...#...
.#.#.#.#.#.#.###.#.##
.#.#.#...#.......#...
.#.#.#######s#######.
S#.#.#!........#...#.
.R##.#########.#.#.#.
.....#.......#.#.#.#.
####.#A#Q###.#.#.#.#.
...#.#...#...#...#.#.
.###.#####.#.B####.#.
...#...#...#.#...q.#.
.#.###.#.###.#.#####.
.#....t..#@..#.......
21 21
.....#.............#.
##.#.#.#.###q##s##.#.
...#.#.#.#...#...#...
.###.###.###.#.#.###.
...#.....#...#.#.....
##.#######.#.#.######
@#.......#.#.#.....#A
.#######.#.T.#####.#.
.#.......S.#.....#...
.#.#######.#####.###.
.#.....#.....#...#...
.#####.#####.#####.##
.....#.a...#.#.....#.
.###.###A#.#.#.#####.
.#...#.....#.#...#...
.##a##.#####.#c#.#.#.
...#!..#.....#...#.#.
.#.#####.###.#.#####.
.#....t#.#.#...#...#.
.#.###t#.#.#####.#.#.
.#...............#...
21 21
..............c#...#.
.#####.#######.#.#.#.
.#.....#!..q...#.#.#.
##.###.##t.#.###.#.#.
...#...#.#.#.#...#...
.#####.s.#.#.###.###.
.#...#.R.#.#...#...#.
.#.#.#.###.###.###.#.
.#.#.#.#...#.#.#...#.
.#.#.###.###A#.#.####
...#.#...#...#.#.#...
####.#.###.#.#.#.#.#.
.....#.#...#.#.#...#.
.#####.#.###.#.#.###.
.......#...#.#.#.#...
###r######.#.#.###.T.
...........#.#.....#.
.###########.#######.
.#@....#...#.........
.###.#.###.####r#####
.....#.S.............
21 21
...#.......#.....#...
.#.#.#####.###.#.###.
.#...#.#.......#.....
.#####.#.#####.######
.Q.#.....#...#@#.....
.#.#######.T.###.###.
.#...#.....#.....#...
.###.#.#####.#####.##
.#.#.#.#...#.#...#.b.
.#.#.#.#.#.###.#.###.
...#...#.#.#...#...#.
##.#####.#.#.#####.#.
.#.#.#!#.#...#.#...#.
.#.#.#.#.#####.#.###.
...#.#...s.....#.#...
.###.#####.R##.#.###.
.#.........#...#...#.
.#.#######.#.T####.T.
.#...#.....#.#...#...
.#####.#####.###.####
.......#.....c.......
