abcdefghijklmnopqrstuvwxyz-=[];/
ABCDEFGHIJKLMNOPQRSTUVWXYZ_+{}:?
OOOOOOOOOOOOOOOOCCCCCCCCCCCCCCCC
7
25 25
.#...........#...#.......
.#.###.#.#####.#.#.#.####
.#...#.#.#...#.A.#.#.#...
Q###.#.###.#.#.#.###.#.r.
...#.#.....#...#...#...#B
##.#.###a#########.#.###.
...#.........#!..#.#...#.
.######A####.###.#.#####.
.......#.....#...#.....#.
.r####.#.####T.##C##a#.#.
.#.#t..#.#.....#...#...#.
.#.#.###.#.####a.#.#.###.
.#.#.....#.......#...#..q
.#.########b########a###.
...............#.....#...
##############.#.###.#.a.
...#.....#...#.#...#...#.
.#.#.#t#.#.#.#.#.#.#####.
.q...#.....#.#.#.Q...#...
.#.#########.#.#T###.T.##
.#.#...#.#...#.#...#.#.#.
.###.#.#.#.#t#.#.###.#.#.
.#...#.#...#...#.#...#...
.#.###.#####.#####.#####.
b....#.............#@....
25 25
.......#.......#@........
##s#.###.#####.#########.
....Q#...#...#...#.......
.###.#.###.#.###.a.#####.
.#.#.#.#...#...#.#.#...#.
.#.#.#.#####.###.#.#.###.
.#...#.#.....#...#.R.....
.#####.#.#####.###.#####.
...#.....#.....#.......#.
.#.#.#####.####A######.##
.#.#.#...#.#.....#...#...
.#.#.#.#.#.#.###.#.#.#.#.
.#...#.#...#...#...#.#.#.
.#####.#######.#####.q##.
.....#.......#.....#...#.
#a##.#######.#c###.###.#.
...#...#.....#.....#...#.
.#####.#.#.###.#####.###.
.#...#.#A#.#...#...#..!#.
.#.#.#.#.##b.###.#.#####.
...#...#.....#...#.......
.##c##########.#########.
.#...........#.#.......#.
.##T####.###.###.#####.#.
.........#.......#.......
25 25
.....#.....#.......#.....
.B##.#.###.#.#####.#.#.##
.#...#...#.#.#...#...#...
.#.#####.#.#.###.#######.
.#.......#.......#.......
.#################.######
...#.....#!..#....a#.....
##.#.##b.###.#.####t.#.#.
.#.#...#.#...#.#...#.#.#.
.r.#.#.#.#.###.A.#.###.#.
...#.#.#.#.....#.#.#...#.
.###.#.#########.#.#.#B#.
...#.#...........c...#.#.
##.#.#########.#s#C###.#.
.#.#..@#...#...#.#.......
.#.#####.#.#.###.#.######
.#.#.....#...#...#...#...
.#.#.#########.#####.###.
.#...#.#...#.......#.....
.####b.#.#.#.###.####BA#.
.#...#...Q.#...r.#.......
.#.#.#.###.###.#.#.#b####
.#.#.#.#.#.#...#...#a....
.#.#.#.#.#.#.#######.#s#.
...#.....#...........#...
25 25
.........#...#.......#...
.#######.#.#.s.#####.a.#.
.......#...#.#...Q.#...#.
.#####.#####.###.#.#####.
.....#.r.#.#.#...#.......
#####q.#.#.#.#.r##.a#####
.....a.#.#.#.#.#@..#.....
.###.#.#.#.#.#.#####.###.
.#.#.#.#.#.#.#.........#.
.#.#.###.#.#.###########.
.#.......#.........#...#.
.#################.#.#.#.
.#...........#...#...#.#.
.#.#########.#.#.#####.#.
.r..!#.......#.#...#...#.
.#####.#########.#.#.###T
.....T.#.........#.#.Q...
.###.#.#.#.#######.#.###.
.#...#.#.#.......#.#.....
.#q#.#.#.#######.##t####R
.#.#.#.#.#...#.#.#.....#.
.#.###.#.#.#.#.#.#.#.###.
.#.#...#...#.#.#...#.....
.#.#.#######.#.##A#######
.#...#...................
25 25
.#.......#...#...........
.#c###.#.#.#.#.#####.####
.#.#@#.#.#.#.......#.....
.#.#.q.###.#############.
.#.#.#.....#.....#.....#.
.#.#.#######.###.#.###.#.
.#.........#.#...q...#...
.#####.#####.#.#T#.#.####
.......#...#.#.#...#.....
.#######.#.#.#.#s#.#####.
.#.......#...#...#.r.Q...
.#.#########r###.#.###.c.
.#...#.........#.a.#...#.
.###.#####.#####.###.####
...#.#...#.....#...#.....
####.#.#.#####.###.#.###.
...#...#.#!..#.....#...C.
.#.#####.###.#.#####.###.
.#...#...#...#.#.Q.#.#...
.###.#.###.###.###.#.#.##
.#...#.#...#.#...#...#...
.#.###.#.###.###.#.#T###.
.#.....#.#...#...#...#...
.#######.#.#.#.#######.#.
.........#.#...........#.
25 25
...S...#.................
.#R#####.#####T#.#######.
.#.#...#.#.....#.#.......
.###.#.#.#.###.#.#.######
.....#...#.#@..#.#...#...
.#######t#.c####.###.#.#.
...#.R.........#...#...#.
##.#####.#####.###.######
.#.....#...#.....#.......
.#####.#.###.###.#######.
...#...#.#...#...#.......
.#.#.###.#.#######.#####.
.#.#.#...#.#.....#...#.#.
.#.#.###r#.#.###.###.#.#.
.#.#.#...#...#.....#.#.#.
.#.#.#.#.#####.#.###.#.#.
.#.#.#.#.......#.#...#...
.##C.#.#.#########.###.##
.......#.#.........#..s..
#####Q##.t.##############
...#..!#.#.#.........#...
.#.#.###.#.#.#######.#.#.
.#...#...#...#.....#...#.
.#############.###.#####.
...............#.........
25 25
...........#.....#...#...
.#######.###.#.###.#.#.#.
.#...#...#...#.....#...#.
.#.#.#####.#########.###.
C..#.#...#.#...#...r.#...
####.a.#.#.###.#.#.###.#.
...#.#.#.#.....#.#.....#.
.#.#.#.#.###.###.#######.
.#...#.#.....#...#.......
.###.#.#######.#.########
...#.#.....#...#.#...#...
##.###T###.#.#####.#.#.#.
...#.......B.......#...#.
.###.###########.#######.
.#...#.....#...#.#...#...
.#.###.#.###.#.###.#.#.#.
.#.B...#@#...#.#...#.#.#.
.#####.###.###.#.###.#.#.
.#.....#...#.#.#...#.#.#.
.#.#####.###.#.###.#.#.##
...#.....#...#...#.#.#...
.###.#####.#####.#.#.#.#.
.#.#.#...#.....#...#.#.#.
.#.#.#.###.#.#######.###.
...#!#a....#.............
