abcdefghijklmnopqrstuvwxyz-=[];/
ABCDEFGHIJKLMNOPQRSTUVWXYZ_+{}:?
OOOOOOOOOOOOOOOOCCCCCCCCCCCCCCCC
7
17 17
@#......T........
.#.#############.
.#.......#.#c..f.
.#######.#.#.#.#.
.s.....#...#.#...
.#########.#x###.
.#W........#...#.
.#.#########.E.##
...#...#...#.#...
.####g.#.#.###.#.
.#.....#.#...#.#.
.#.###.#.###.###.
.#.#...#.#.U.....
.#.#####.#.##r##.
X#.#!#...#...Q.D.
.#.#.#.###.#####.
...#...#.........
17 17
...........B.....
.#####.###.#####.
.....#.#.S.#...#.
##w#.#.#####.#.#.
...A.#.#.....#.#.
.###.#.#.#####.#.
c#...#...#.#t..#.
.#.#######.#.#V##
...#...E.#.#.#..!
.##x##.#.#.#.W.##
.#...#.#.#.#s#...
.#.#.#.#.#.#.###.
.c.#...#...#.....
.#.#######.######
.#...#r..#.#...#@
.###.U.#.#.#.#.#.
.....#.#.....W...
17 17
@........#...#...
######.#.#.V.###.
.......g...#...#.
C#############.#.
.#.......#.....#.
.#.#####.#.###.v.
.#...g.#.#.#!#.E.
e#####QBD#.#.#.#.
.#.....#...#.#.F.
.#########.#q###.
R....#...#.#...#.
.###.#.#.d####.C.
...#.#.#...#...#.
##.#.#.###.#.###.
...#...#.#.#...#G
.##a####.#.###.#.
.........#.....#.
17 17
...#.......#@...X
.#.#.###d#.#####.
.#.....#.#.....#.
.###Q###.#####.#.
...#.....#...#.#.
###v.#####.###.#.
.....#.#.....#.#.
.#####.W.u##.#.#.
.#.....#.#...#.#.
.#v#r#.r.#.###.#.
.#.#!#...#.......
.#.#.#####C#####.
.#.#.....#.#...g.
.#######rA##.#.##
.......#.....#...
.#.#############.
.#..............b
17 17
......@#.........
.#.#####.###.####
.#.#...#.#!#.....
.#.#.#.#.#.#.###.
.#...#...#.#...#.
######.###.u####.
.....#.#...#.....
.###.###.###.####
...#.....#....f..
##.#############.
...#...........#.
.###.###.#####.#.
.#...#.#...#...#.
.#.###.#g#.#.###.
.#.....#..A#.....
.####b##.#######.
..u....v.#.......
17 17
...............#.
f##E.#x#####.#.#.
...#..@#...U.#...
.#.#####.R#######
.#.a...#.........
.#####.###XV####.
!#...#...#...#...
####.###.#####.#.
.......#.......#.
.#.###.#########S
.#.ut#r..#..f.r#E
.###.q##.#.###.T.
.cE#.#...#...#...
.#.#F##U.###.####
.#.#...#...#.....
.#.E##.######R##.
.....#.....C.E.E.
17 17
g........#...w...
.#####.#.#.#.###.
.#.#...#.#.v.#...
.#.#.#####.#.#S#.
.#.#.......#...#.
.#.#######F###.#.
....D..#...#...#.
######.#.#.#.###.
@#...#.#.#.#.#...
.#.#V#.#.#.#.G###
...#...#.#.#.#...
.#######.#.g.#.#.
.#...#!V.#.#...#.
.e##.#.#.x.#####.
...#.#.#.#.e.....
##.#.#.#.#.#.#e#.
.....#...#...#...
