abcdefghijklmnopqrstuvwxyz-=[];/
ABCDEFGHIJKLMNOPQRSTUVWXYZ_+{}:?
OOOOOOOOOOOOOOOOCCCCCCCCCCCCCCCC
7
29 29
.....#.....#...#.............
.#.###.#.###.#.#######.#####.
.#.#...#.#...#.#.....#.C.....
.#.#.###.#.###.#.###.###.###.
.#.#...#.#!#.#.#...#.....#...
##.###.#.###.#.#.#.#######.##
.....#.#.....#.#.#.#.....#.#.
.#####.#.###.#.#.#.#.#####.#.
...#...#...#.#.#.#.#.#...#...
##.#.#####.#.#.#.#.#.#.#.###r
...#.....#.#.#.#.#.#.#.#.....
.#####.###.#.#.B##.#.#.######
.......#...#.#.....r.#.....#.
.###S###.#.#########.#####.#.
.B.....#.#.#............@#...
####.###.#.#.#.#############.
.....#...#.#.#.....#S......#.
.#####.b##.#.#####.#.###.###.
...#.#...#.#.#...#...#.#...#.
##.#.###.###.#.#######.###.#.
.#.#...#....r#.........#...#.
.#.#r#.#######.###b###.#.###.
.#.#.#.......#.#.#...#.c...#.
.#.###.#####.#Q#.###.#.###.#.
.#.#...#.....#.....#.#...#.#.
.#a#.#####.##T######c###.#.#.
...#.....#.S.........#.#.#...
.#######.#############.#.####
.........#........T..........
29 29
...........#.........#...#...
########.###.###.###.#.#.#.#.
.........#...#.#...#...#...#.
.#######.#.###.###.####T####.
...#.....#...#.#...#.#.....#.
##.#########.#.#.###.#.#.###.
...R.......#.#.#...#.R.#.....
.#.#.B####.#.#.###.#.#######.
.#.#...#...#.#...#.#.#..q..#.
.#.C##.#.###.#.#.#.###.###.#.
.#.#...#.C...#.#.#.....#...#.
.###.###.a.#####.#######.####
....r#...#.#.....#.....#.....
######.#.#.#.###.#.###.#####.
.......#.q...#.#.#.#!#.#...#.
.#######.#####.#.#.#.A##.#.#.
.#@.........a..s.#.#...#.#.#.
.###########.###.#.###.#.#.#.
.........#...#...#...#...#...
.#######.##S##.###.#.########
.#.....#.......#...#.#.......
.#.###.#########.###.#.#r#r##
.#.A.........C.#.#...#.#.....
.#.#.#########.#.#.#####b###.
.#.#..T.t..#.#...#.#...#.....
.#######.#.#.#####.#.#.#.###.
.#.....#.#.#.#.....#.#...#...
.#.###.###.#.#.#####.#####.##
a..#.......#.........#.......
29 29
.........#.#...#.......#.....
.###.###.#.#.#.#.###.#.###.#.
.#...#...#...#.....#.#.....#.
.#.###.###.#######.#.#######.
.#.#.#.#.....#...#.#...#.....
##.#.#.#.##S##.#.#.###.#.####
...#...#S..#...#.#@#...#.....
.A##.####A.#.###.###.########
...s.#.#...#...#.#...#...#...
.#.Q.#.#.#####.#.#.#.#.#.#.#.
.#.#.#...#...#.#...#.#.#...#.
.#.#.###.#.#.#.#####.#.#####.
.#.#...#.#.#...#...#.#...#!#.
.r.###.###.#####.###.#.###.#.
.#...#...#...#.#R....#.#...#.
####.###.#.#.#.a.###T#.#.###.
...#...#.#.#.#.....#...#.#...
.#.###.#.###.#####S#.t##.#.##
.#.....#.....#.......#.#.#...
.###########.#.#######.#.###.
...#.........#.#...#...#.....
.#.#.Q########.#.#.#.#.######
.#.#.......#.#.#.#.Q.#.......
.#.######T.#.c.#.S#q.#######.
A#...#...#.#.#.#.....#...#...
.###Q###.#.#.#.#######.#.#.#.
...#...#.....#.........#.#.#.
##.###.##C########q#####.#.#.
.....#.....................#.
29 29
..b..#.....#.....#...#.......
##.#.#.#.###.###.#.c##.#####.
...#...#.#.....#.#.....#...#.
.#####.###.#####.#######.#.#.
.#.....#.a.#.#!..#.......#...
.#######.###.#####.#########.
.........#.......#...#@......
.########s##.###.###.########
.#.#.........#.#...#.........
.#.#.#A###.###.###.#########.
.#.......#.#.....#.....#...#.
c#.#######.###.#######.#.#.S.
.#.#.....#...#.......#...#.#.
.c.#.###.###.#.#t#.#R#####.#.
.#.#...#.....#.#.#.#...#...#.
.###.#.#######.#.#.B.#.#.t##.
...#.#...#...#.#.#...#.#...#.
##.#.#t#.#.#.C.#.#####.###.#.
.#.#.#...#.#.....#.....#...#.
.#.###.###########.#####.###.
.#...#.......#...#.....#.....
.###.###.###.#.#.###c#.#####.
A..#...#.#.#...#.#.....#.#...
##.###.#.#.#####.#.B##.#.#.#s
.....#.#.......#.#.#.....#.#.
.#####.#####.###.#.#a#####.#.
...#...#...#.#...#...#.....#.
.#.#.###.#.###.###.#.#.#####.
.t.......#.....#...#.........
29 29
.............#.....#.....c...
####.#######.###.#.#.#.#####.
.....#...........#.#.#...#...
.#.###############.####Q.#.#A
.#.#.....#...#...........#...
.###.###.#.#.#.#########r###.
...#.#.#.#.#.#@#...........#.
##.c.#.#.#.#.###.#########.#.
t..#...#...#.#...#.........#.
.#.###.#t###.#.###.##########
.#...#...#.#.#...#.....#.....
.#######.#.#.###.#####.###.#.
.#.......#.#...#.#.........#.
.#.#######.#.###.########T##.
...#...#...#...#.....#.....#.
.###.#.#.#.###.####r.###.#.#.
.....#...r.#.....#.#...#.#.#.
##########.#.##C.#.###.#.###.
...........#.#.....#!..#.....
.###########.#####.S####.####
.#.........#...#...#...#.....
.#.#######.#C#.###.#.#.#####.
.#.#.S...#...#...#.#.#.....#.
##.#.#.#####.###.###.#####.#.
...#r#.........#.#.....#...#.
.#############.#.#.#####.###.
...#.........#B..#.#.#...#...
.#.#.#Q#####.#####.#.#.###.##
.#.........#.........#.......
29 29
.#.........a...#.......#.....
.#.#####.#.#.#.#.#####.#.#.#.
...#.....#.#.#.......#...#.#.
.###.#######.#########.###.##
.#.#.#.......r...#...#...#...
.#.#.#.#B#######.#.#.#######.
...#.....#.....#.s.#.......R.
##########.###.###.#####RQ##.
...........#.#.#...#.....#...
.###########.#.#.###.#.##r.##
.#...#.......TC#.#...#.......
.###.#.#######.#.#.#########.
s..#...#.....#...#.....#...#.
.#.###.#.###.#####.#####.#.##
.#...#.#...#...#...#.....#...
.###.#####.###.#c###.####T##.
..@#.....#.#.#...#...#...#...
##r###.###.#.###.#.###.#.#.##
...#...#...#...#!#...#.#...#.
.#.#.#.#.###.#.#q#.#.#.#####.
.#.#.#.#.....#...#.#.#.#.....
.#.#.#.#########.###.#.#.###.
.#.#.#.#.......#.....#...C...
.#.#.#.#.r##.#############.##
.#...a...#...#.....#.....#.#.
.#.#######.###.###.#.###.#.#.
.#.#.....#...#...#...#.#.r...
.###.###.#######.#####.#.###.
.......#...............#.....
29 29
........................R....
.###############.#####.######
.#.......#....Q..#.....b.....
##.#####.#.#######.#####.###.
...#.......#.B.#...#.#...#.#!
.###########.###.###.#.###.##
.#.......#.#.......B.#.#.....
.#.##Q##.#.#.#########.#T###.
.#.#...#.#.....#.#...#.#.#...
.#.###.#.#####.A.#.#.#.#.#.##
.#...#.#.....#...#.#...#C#...
.###.#.#####.###.#.#########.
.....#.....#.#...#.#.........
.#########.#.#####.##r.#C###.
.......#...#.....#...#.#...#.
######.#.#######.###.#.###.#.
...#...#.....#...#...#...#...
.#.#.#####.###.#.#.###.#.####
.#@#.......#...#.#.#...#.....
.#####.####B.###.#.###.##A##.
.....#.#.....#...#...#.#.....
.#.#.#.#.#####t#####.#.#.###.
.#.#.#.#...#....R#...#Q#.#...
.#.#.#.###.#####.#.####a.R.##
.#.#.#.#.#.....#q#.......#...
.#.###.#.#####.####a########.
.#...#.......#...............
q###.#######.################
...b.........................
