abcdefghijklmnopqrstuvwxyz-=[];/
ABCDEFGHIJKLMNOPQRSTUVWXYZ_+{}:?
OOOOOOOOOOOOOOOOCCCCCCCCCCCCCCCC
11
17 17
.#!......#.....#@
.#######.#.###.#.
.......#.#..S#.#.
.#######.#.#.#.#.
.........#.#.#...
.##b######.#.####
.#.......#.#.....
a#.###A#.#######.
.#.....b...#...#.
.###.#.###.#.#.#.
...#.#.#.#.#.#.#.
##.###.#.#.#.#.#.
.#.....#.#.#.#.#.
.#######.#.#.#.#.
.....#.....#.#...
.#.###.#####.###.
.#...........#...
17 17
@#.....#.......#.
.#.###.###.###.#.
.#...#.C...#.#...
.###.#.#.##r.###.
.#...#!#.#.....#.
.#.#####.#.###.#.
...#.....#.#...#.
.###.###.#.#.T##.
...#...#.#.#.#...
##.#C#.#.S.#.#.##
.#...#.#.#.#.#.#.
.###.###.#.##s.#.
...#.....#.#...#.
.#########.#.c##.
t..#T......#...#.
.#.#.#.#######.#.
.#...#...........
17 17
@....#!#...#.....
####.#.#.#.#.#S#.
...#.t.#.#...#...
.#.#.#.#.###Q#.##
.#...#...#...b...
.#########.#.###.
.#.....#...#...#.
.#.###.#.#####.#.
.#...#...#...#...
.###.#####.######
.....#...........
.#######.#######.
...a...#.......#.
######.#########.
.#b..#.......#...
.#.#.#######.#.#.
...#...........#.
17 17
....qr...........
########.#####.#.
......!#.#.#...#.
.#######.#.Q.###.
.....#...#.#Q..#.
####.#.###.###.##
...#.#...#...#...
#q.#.###.#.#####.
...#.#.....#.....
.###.######Q.###.
.....#R....#.#..T
.#####.###c#.###.
.#.....#.#.#t..#.
.###.r##.#.#.#.#.
.#...#...#.#.#.#.
.#.###.#.#.###.#.
...#...#.......#@
17 17
.......#.......#.
####.#.#####.#.#.
.....#.......#.#.
.#############.#.
.#.....#...Q..Q#.
.#.###.#.#.#.###.
!#...#.#.#.#.....
####.#.#.#.#####.
.....#@#.#...#...
.#######.#.###.##
...#.....#.#...#.
.#.#.c####.#.###.
.#.....#...#...#.
.#######.#.###.#.
.....#...#...#.#s
####.#.#######.#.
....R#...........
17 17
.#.....#...#.....
.#.#.###.#.#.t.R.
.#.#...#.#...#.#.
.#.###.#.#####.##
.#...#.#.#...#...
.#.###.#.q.#.###.
.#.#...#.#.#...#.
.#.#.###.#.###.#.
...#b....#...#!#.
.#####s####r.###.
.#.#.....#.#.#...
.#.#.#.#.#.#.#.##
.#...#.#.#.#...#.
.#.#a#.#.#.#####.
.#...#.#.#...#...
.#####.#.#.#.#.#.
.......#...#...#@
17 17
...#.......#...C.
.#.#####.#.#.###.
.#.....#.#.....#.
.###.#.A.#######.
.#!#.#.#.#...#...
.S.###.#.#.#.#.##
.#.....#.#.#.#...
.#######.#.#.###.
.#.#...#.#.#...#.
.#.#.#.#.###.#.#.
.#...#.....#.R.#.
.#.######R.#.#.#.
.#.#.....#...#.#.
.###.###.#####.#.
.....#...#@....#.
######.#########.
...........B.....
17 17
.........#.......
.#######.###.###.
...#...#...#...S.
.#.#.#####.###.#.
.#.#A......#...#.
.#.###.#####.###.
.#...#...#.....#.
##.#.###.#####.#.
!#.#.#.#.b.....#@
.###.#.#.#.######
.#..q#...#...#...
.#.###.###.#.#.#.
...#.#...#.#.#.#.
####.##B.#.#.#.#.
...#.....#.#...#.
.#.#.###a#######.
.#...............
17 17
...........#.....
.#####.###.###.##
.....#.#.#...#...
##.###.#.###.###.
...#...#.........
.###.####t######.
...#.........#@#.
#####c.#####.#.T.
.....#.#...#.#...
.###.#.#.###.#.##
.#.Q.#.#.#...#.#.
.###.#.#.#.#S#.#.
...#.#...#.#...Q.
##.#.###.t.#.###.
...#...#.#.#.#...
.#####.###.#.#.C.
..!#.......#...#.
17 17
@#.....q!....#...
.#.###.#####.#.#.
...#.......#.C.#.
####.#######.#.#.
.....#.....#...#.
.##R##.###.#####.
.#.......#...#...
.#.#########.#.##
...#...#...#.#...
.#B#.#.#.#.#.###.
.#...#.#.#...#.#.
.#.###.#.###.#.#.
.#.#.....#.....#.
##.#.#####.#####.
...#.#...#.#...#.
.#####.#.###.#.#.
.......#.....#...
17 17
....@#...........
.#####.#######.#.
.#....sQ.#.....#.
.#.#####.#.#####.
.#.#.....#.#.#...
.#.#.#####.#.#.##
.#...#.....#.#.#.
.###.#.#####.#.R.
...#.#.#.......#.
.###.#.#####.###.
...#.#.T...c.#...
.#.#.#.#.#.#.#.#.
.#...#...#.#...#.
.#########.#####.
.#.......#...#...
##.#####.###.#.S#
!..#........r#...
