abcdefghijklmnopqrstuvwxyz-=[];/
ABCDEFGHIJKLMNOPQRSTUVWXYZ_+{}:?
OOOOOOOOOOOOOOOOCCCCCCCCCCCCCCCC
7
33 33
.#.............#....T....#...#...
.#.##s##.#####.#######.#.#.#.###.
.#.....#.#............Q#...#.....
.#b#.###.#.####T#s######.#######.
...#t#...#.....#.....#...#A....#.
.#.#.#.##B####.#.###.#####.###.#.
.#.#.#.#.....#.#.#.#.#.....#.#.#.
.#.#.#.#.###.AT#.#.#.#.#####.#.##
.#.#.#.#...#.#...#.#.#.#.....#...
.###.#.###.#.#.###.#.#.#.###.###.
.#...#....t#...#...#.....#.....#.
.#.##b######.###.#.#########q###.
.s.....#...#...#.#.#.......A...#.
.#.#####.#.###.#.#.#.#####.#.#.#.
...#.....#...#...T.#.#.#r..#.#...
.###.#######.#######.#.#.###.###.
...#.....#.....#..A#.#.......#...
##.#####.##aA#.#.q.#.#########.##
.......#.....#...#.#.#.....Q.#.#.
.###########.#####.#.#.###.#.#.#.
...#.......#.#.....#.#.#...#.#.#.
.###.#####.#.#.#####.#.#.###.#.#.
.#...#.....#.#.#...#.#.#.#.#...#.
##.###.#####.#.#.#.#.#.#.#.#.###.
!#.#.#.....#.#.#.#.#...#.rB#...#.
.#.#.#####.#.#.#.#.#.###.#.##T.#.
.#.#....@#...#...#.#.#...#...C...
.#.#.#############.###.###.#.###.
.#.#........T#...#.....#...#...#.
.#.#####.###.#.#.#######.#######.
.#.....#.#...#.#.#.....#...A...#.
.#####.#.#.###.#.#.#Q#.#.#.#.#.#.
.......#.#.....#.....#...#...#...
33 33
...#...#...#.......#.............
.#.t.#.#.#.#.###.#.#######.#####.
.#...#.#.#...#...#.........#...#.
.#####.#.#####.#.#############.r.
.#...#.#.#.....#.A.......#.....#.
.#.###.#.#.#####.#.#####.#.#.#r#.
.#.#...#.#.#.....#.#...#.#.#.#...
.#.#.#c#.#.#######.b.#.#.#.###.##
...#.....#.#...#...#.s.#.#.......
##.##B####.#.c.#.###.#.#.#.######
...#.....#.#.#...#..B#.#.#.#.....
####.###.#.#.s########.#.#.#.###.
.....#...#.s.#.......#.#.#.#.#...
.#####.###.#.###.###.#.#.###.#.#.
.#...#...#...#...#.....#...#.#.#.
.#.#####.#.###.#######B###.#.#.#.
.#.#.....#.....#...#.....#...#.#.
.r.#.#####.#####.#.#.##A###B##.#.
...#.#.....#.....#.#...#...#...#.
##.#.#.#####.#c###.#####.#.#.###.
...#.#.....#.#.....#...#.#.#...s.
.###.#####.#.#.#t###.#.#.#.###.##
.#!..#.#...#.#.......#.#.#...#..B
.#####.#.###.#####R###.#.###.#.#.
.#.........#...#.....#.#.#...#.#.
.#############.#.###.#.#.#.#####.
...........#...#...#@#...#.#.....
##########.#.###.#.#######.#.###.
.........#...#...#.....#...#...#.
.###.#########.#####.###.#####.##
...#B...a#...#.#...#...#.....#...
##.#####.#.#.#.###.###.#####.###.
.......#...#.........#...........
33 33
.......#...#.......#...........#.
.#.#####.#.#.#####.#.#######.#.#.
.#.#..s#.#...#.#...#.....#...#...
.###.#.#.#####.#.###.#####.#C###.
.....#.#...#...#...#.#.....#.#...
######.###.#.#.###.#.#.#####.#.##
.........#.#.#...#...#.#.....#S#.
.###.#####.#####.#####.#.#####.#.
.#...#..c..#...#..a#...#.#.....#.
.####A.#####.#.###.#.###.#.#####.
.......#.....#...#.#...#...#.....
.#######.###.###.#.###.#.#######.
.#.#...#.#...#...#.#...#.........
.#.#.#.#.#.###.###.#.###.#######.
.#...#...#...#.#...#...#.#.....#.
.###########.#.#.#.###.###.###.##
...#...#.....#.#R#...#...#...#...
S#.#.#.#.#####.###.#.###.#.#####.
.#...#...#.#..C#...#...#...#!....
.#########.#.###.#####.#t########
.#.......#...#...#...#...#...#...
.#.##A.###.###.###.B.###.#.#.#.#.
.Q.#.#.#...#...#...#.....#@#...#.
.###.#.#.###.###t###########.###.
.....#...#...#...#.........#.#.#.
####.#c###.###.#####.#####.#.#.#.
.....#.....#.t.#.....#.....#.#.#.
.#t###.###.#.#.###.###.####B.#.#.
.....#.#...#.#.#...#.#.....#..a#.
####.#.#.###.#.#.###.#####.####t.
.#...#.#.#...#...#.#.....#.......
.#.##q##.#.#######.#.###.#######.
.........#.............#.........
33 33
.....#.#.....#........C....#.#...
.###.#.#.#.#.#######.s####.#.#.#.
.#...#...q.#.......#.#...#...#.#.
.#.#######.#######.#.#.#.#Q#C#.#.
.#.#.......#.....#.#...#.#..S..#.
.#.#.#######T###.#.#####.#.#####.
.#.#.........#...#...#...#.#.....
.#.###.#####.T.#####.#.#T#.#.####
.#...#...#...#.......#.....#.....
.#a#.#####.###.#######.#########.
.#.........#.#...#.............#.
.###########.###.###.#######A#.#.
.#.....#...#...#...#...#.....#.#.
.#.###.#.#.#.#.###.#.###.###.#.#.
.#.#.#.#.#b#.#.....#.#...#.#.#.#.
.#.#.#.#.#.#######.###.###.#.##a.
.#...Q...#.#.....#.....#.....#...
.###.#####.#.###.#s#####.#####.##
...#.#...#.....#.#s......#.......
.#a#.#.#.#######.#.#######.s##c#.
.....#.#...#.....#...#...#...#...
.#####.###.#.#######.#.#.#####.#.
...#.#...#...#...#.Q...#.....#.#.
##.#.###.#####.#.#.##B######.#.#.
...#...#.....#.#.#...........#.#.
.###.#.#####.#.#.#.#####.#####.#.
.#...#.....#.#.#.#.#...#.....#.#.
.#.#####.###.#.#.###.#.#####.#.#.
...#...#.#...#.#.....#.#...#...#.
####.#s#.#.###.#######.#.#.#####.
.......#.C...#.#.....#.#.#..!#...
.#####.#.###.#.#.###.#.#.#####.##
.....#.....#.....#...#...#@......
33 33
.#....a#.....#.....#.....#.......
.#.#.###.#.#.#.#####.#.#.#.#.###.
R#.#...#.#.#...#.....#.#.#.#.#...
.#.###.#.#.#.###.#####.#.#.#.#.##
.....#...#.#.#...t.#...#.#.#.#...
.########a.###.##C.#.###.###.####
.#.......#...#.#...#...#...#.....
.#.#####.###.#.#.#.###.###.#####.
.#.#...#...#...#.#.#...#.#.....#.
.#.#.#####.#.###.s##.A##.###q#.#.
.#.#....q..#.#...#...#.#.....#...
.#.#.#######.#.#.#.###.#.#.#####.
.#.#.......#...#.#.#.#...#.....#.
#r.#######.#######.#.#.#######.#.
...#.....#.........#.#.......#...
.r##.###############.###c###.####
.#.....#...........#.......#.#...
.##b##.#.#####.#R#.#.#s#.#.#.###.
.#.....#.#.#...#...#...t.#.#.#...
.#.#####.#.#.#.#####.#c#.#.#.#.#.
.#.......#.#.#.#...#.S...#.#...#.
.###r#.##t.#.#t#.#.#.#.#.#######.
.....#.....#.....#...#.#.#.......
.###.#####.###########.q.#.######
.#...#@..#.#.....#...#.#.#...B...
.#.#####.#.###.#.###.#.#.###.tb#.
.#.#.....#.#...#.....#.#.#.#.....
##.#.#####.#.#####.###.#.#.##B##.
...#.....#...#.....#...#.....q.#.
.#######.#####.#####.#t###.#####.
.#.....#.#...#...#.#.....#.#.....
.#.###.#.#.#.###.#.#####.###.####
...#!..#...#...........#.........
33 33
.......#.....#.....#...#.#.......
.#####.#.###.#.###.#.#.#.#.#####.
...#...#...#.#...#.#.#.#.....#.r.
.#.#######.#.###.#.#.#.#####.#r##
.#.....#...#...#.#.#.#.....#.#...
.#####.#.####s.#.#.#.#####.#####.
.#.A.#.#.....#...#.#...#...#...#.
.#.#.c.#####.#####.###.#.###.#.#.
.#.#...#.R...#...#.....#.....#.#s
##.###.#.#.#####.A############.#.
.R.#.#.T.#.....#...........#...#.
.###.#.#######.#########.###.###.
.#.....#.....#...#.....#.....#...
c###.###.###.t##.#.###.#.#######.
...#.#...#.#...#...#.#!#.#.......
.#.###.###.###.#####.###.#.#.###.
.#...#.#.....#.........#.#.#...#.
.#Q#.#.###Tq.#.#######.#.#####.#.
..A#.#...#...#...b...#.#.......#.
.###.###.C.#####.#.#.#.######c##.
.#...#.....#.....#@#.#...#.......
.#.###.#####.#######.###.#.##r###
.#.....#.#...#.........#.#.#....S
.#b#####.#.#######.#.###.#.#.#r#.
.#.....#.#.#.......#.#...#.#...#.
.#.###.#.#.#.#########.###.#####.
...#...#.#.#.............#...#...
####.###.#.#####.###########.#.#.
...#.#...#.....#...#.....#...#.#.
.#.#.###.#####.#.###.###.#.###.#.
.#.#.....#...#.#.#...#.#.#.....#.
.#######.#.#.#.###.###.#.#######.
........R..#.#.........#.........
33 33
a......#.#.....#.....#.....#.....
.#####.#.#.#.###.#.###.#.#.#.###.
.#.......#.#....s#.....#.#.#...T.
.#####.###.#############.#.#####.
.#...#.Q...#...........T.#...#...
.#.#.###.###.###.#####.#.###.#.##
.#.#...#.#.....#...#...#.#...#...
.#.###.#.#.#######A#.###.#.#s###.
.#.#.#.#.#...#.....#.#...#.T.....
.#.#.#.#.#####.#####.#.###B#####.
.#...#...#.....#.#...#....a....#.
.###.#####.#####.#.###########.##
...#.#.....#.......#.........#...
.#.#.###.#.#.#####.#.###########.
.#.#...#.#.#.#...#...#.........#.
##.###.###.###.#.#####.#######.#.
...#...#...#...#...#...#...#...#.
.###.###.###.#####.#.###.###.###.
...a.#...#...Rr..#.#...#.#...#...
.#####.###.###.###.###.#.#.#r#.#.
.#.#.....#...#...#.#...#...#...#.
b#.#.###.###.#.#.#.#.###.#####.#.
.#.....#.#...#.#...#.#...#...#.#.
.#######.#.#######.#.#.###.#.#.#.
.#.......#.#.....#...#.#@..#.#.#.
.#s#####.#.#.###.#####.###.#.###.
.#...#...#...#...#.....#...#...#.
.###.#.#######.#####.###.#####.#.
.....#...#.....#a..#.#...#..q..#.
b#######.#.#####.#.#.#.#.###.###t
.#.....#.#.......#.#.#.#...#.#...
.#.###.#.##sT#####.#.#####.#.T.#.
.....#.......#!....#.......#...#.
