abcdefghijklmnopqrstuvwxyz-=[];/
ABCDEFGHIJKLMNOPQRSTUVWXYZ_+{}:?
OOOOOOOOOOOOOOOOCCCCCCCCCCCCCCCC
1
17 17
.#!........#.....
.#########q#.###t
.....#.....#.#...
.#.###.#####.#.##
.#.a...#...s.#.#.
r#########.###.#.
.#....S....#...#Q
.#######.###A###.
.......b.#...#...
##########.#####.
T........#.#.....
.#######.#.#.###.
.#.....#@#..B#...
.#.###.#######.#S
..S#C..#..R..#.#.
.###.###.###.#.r.
...#.......#..c..
