abcdefghijklmnopqrstuvwxyz-=[];/
ABCDEFGHIJKLMNOPQRSTUVWXYZ_+{}:?
OOOOOOOOOOOOOOOOCCCCCCCCCCCCCCCC
7
13 13
.......#!#...
.#####S#.###.
.#...#.#...#.
.#.#.#T###.#.
.#.#.....#...
.#.#####.###.
.#...#...#...
.###.#.###.##
...#.#.....#.
.#.#.#######.
.#@#.#.....#.
.###.#.###.#.
.....C.#.....
13 13
...#.......#.
.#.#.#.###.#.
.#S..#...#.C.
.#######.####
.#....@#.....
.#.#########Q
..T#.........
####.#######.
.....#.....#.
.#####.###.##
.#...#.#!#...
.#.#.#.#.###.
..B#...#.....
13 13
........b#...
######.#.#.S.
.......#.#.#@
.#######.#.##
!#...#...#...
##.#.#.#####.
.#.#...#.....
.#.#####.###.
.q.#...#.#...
.##r.#.#.#.##
.....#...#...
############.
.............
13 13
.....q...#...
.###.###.#.r.
...#...#...#.
##.###.#####.
..A#...#.....
.#####.#.##t.
....!#...#...
#######q##.##
.#...#.....#.
.#.#.#.#####.
...#.#.#.R...
.###.#.#####.
..@#.........
13 13
.............
.########A##.
.#.......#@..
.#.#####.####
.#.#...#a...!
.#.###.##t###
.#.....#.....
.#####.#####.
.R...#...#...
##.#.###.#.##
...#...#.#..A
.#######.###.
..C........c.
13 13
.............
.#.######A##.
.a.#.......#.
c###.#####.#.
.#...#...#!#.
.#.###.C####.
...#.......#.
####.###.#.#.
...#t#.#.#t#.
.#.#.#.#.###.
.#.#...#...#.
.#.###.###.C.
.#......@#...
13 13
..!#.......#.
.###.####R.#.
.....#...#.#.
######.#.#.#.
...#.r.#.#.#.
.#.#.###.#.#.
.#.#...#.#.#.
.#.###.#.#.#.
@#.#...#...#.
##.#.#######.
...#.#...#...
.##B.#.#.#t#.
...s...#T....
