abcdefghijklmnopqrstuvwxyz-=[];/
ABCDEFGHIJKLMNOPQRSTUVWXYZ_+{}:?
OOOOOOOOOOOOOOOOCCCCCCCCCCCCCCCC
7
17 17
....V..#...#.....
######.#.#.#.##S.
.......#.#...#...
.u#Vs#.#.#####.##
.#U..#@#.#...#...
.#.#.#B#.#.#####.
...#..vB...#...#.
.#####.###.#.#.#.
.#.......#.#.r...
##.#.#####.#.##d.
...#.#.....#.#...
.#####.#####.#.##
.......c...#.#..U
.#######.#A#.###.
.....#...#.#.#.#.
####R#.###.#.#.#.
.....#..!U...#...
17 17
...#...........V.
.#.C########.#.##
.#......e..#.#...
.#########.#.###.
.#.........#...#.
.######B##.#U###.
.....#...#.#...r.
.###.A.#.#.#.#.#.
...#...#.#...#...
.#######.#######.
.#.......#...#...
.#.#######.#.#.##
c#.#@......s.#.#.
.#.#########.#.#.
A#.....a...#...#.
.##VT#####.#.###.
.........#!#.....
17 17
...#.....#.......
.###.#.##V.#####.
.v...#...#...#.#!
.#.#####.###.#.V#
...#.#.....#.#...
.###.#B#.###.###.
...#.#.#.#...#...
##.#.#.###.###.#.
@#.#q#...q.#...#.
.#.#.#######.#.#.
.#.#.......#.#.#.
.#.#D#####.#.#.#.
.#.#.....#...#.#.
.#t#######.###.#u
.#...#...#.#...#.
.###.#.#.###.###.
.......#.....#...
17 17
.......q.........
.#s###.#u###.###.
.....#.#.....#.#.
.###.#.#.#####.#.
.#.#.#...#@......
.#.#.###########t
...#.......#!....
##.#######.c####.
.#.#.....#...#...
.#.#.###.#u#.#.##
.#...#.....#.#...
.#####.c##T#.###.
.....#C#.......#.
.#.###.#.#######.
.#.#...#.........
.#.e.######c#####
.#..uV....Q......
17 17
.....#.....#@#...
##.#.###.#.#.#.#.
...#...#.#.#...#E
.#####.#.#.###.#.
.#.....S.#...#.#.
.#E#########.###.
.#.........#.....
.#.#######.#####.
...#c....#.#!..#.
.###.#b#.#.###.#.
.#.#.#.#.#..t#.#.
.r.#.#.#.#.#.#.##
...#.#.#...#.#...
####.#.#V###.###.
....r#.........#.
.######A########.
.................
17 17
.#.....#...#.....
.#.#.#.#.#.#.####
.a.#.#...#.#..v.v
.e.#.##tE#.#V###.
...#.....#.#.#...
#t####.#.#.C##.##
.....#.#.#...#...
b###.###.###.v##.
...#.#...#.#.#..T
.###.#.##v.#.#.#.
.#!#.#.#...#...#.
.#.#.#.###.#####.
.#...#...#...#...
.#######.#.#.#.##
.....#...#.#...#@
####.#.###.#####.
.......#.........
17 17
.....R.....#.....
####.#.###.#.###.
.....#!#.#.#.#...
.#B#.###.#.#.####
...#.....#.D.....
##.#####.#.#####.
...#...#.#.....#.
.a#T.#.#.#####.#.
.#...#.#...#.#...
.#.###.###.#.###.
...#...#@#.#.#...
.###.###.#.#.#.##
...#...#...A.#..d
##.##R.#######T#.
.#.#...b.....#...
.#.#.s#e.###.#.##
...#....Q..#..s..
