abcdefghijklmnopqrstuvwxyz-=[];/
ABCDEFGHIJKLMNOPQRSTUVWXYZ_+{}:?
OOOOOOOOOOOOOOOOCCCCCCCCCCCCCCCC
7
29 29
.............#.....#.........
.#######C###.#.#.###.#######.
.......#...#.#.#.....#.#!....
.#####.#.#.t##.#######.######
.#...#...#...#.#.............
.#.########T.#.#.#.#####.#b##
...#.........#.#@#...#...#...
##.#.#######.#.#####.#####.#.
.#.#.#.....#.#.....#.#.....#.
.#.#.#.###.#.#####.#.#.#####.
.#.#..s#.#.#.....#.#.#.....#.
.#.#####.#.#######.#.#.####C.
...#.....#...#.....#...#...#.
.#####.#.#c#.#.#####.###.#.#.
.......#...#.#.#...#.#...#...
#####s####.#.#.###.#.#.#####.
.....#...#.#.#...#...#.#...#.
.#.q.#.#.#.#.###.#.###.#.#.##
.a.#...#.#.#...#.#.#...#.#...
.#.#####.#.###.#.###.###.###.
.#.#.#...#...#r#...#.#.....#.
B#.#.#.#####.#.###.#.#.#q###.
.#.#.#.#...#.#.....#.....#...
##.#.#.#.#.s.#######.#####.##
.S.#...#.#.#...#.....#...#...
.#####a#.#c###.#####.#.#.###.
.#.....#.#...#.#...#.#.#.#...
.#.###.#.#.###.#.#.###.#.#.#.
..a..#...#.......#.....#...#.
29 29
.#.....#.....#...#...#.......
.#.###.#.#.#.#.###.#.#.###.#.
.#.#.#...#.Q.#.#...#.....#.#.
.#.#.#####.#.#.#.#######Q#.R.
.#.#.....#.#...#.#b....#...#.
.#.#####.#.###b#.###.#.#.####
...#.....#...r.......#.#.....
.###.###.###.#.#############.
.#...#.#.#.#.#.#.............
.###.#.#.#.#.#.#.###########.
.....#.#.#.#...Q...#.......#.
######.#.#.#######.###.#####.
...#...#.#...#.#...#...#...#.
##.#.#.#.#.#.#.#.###.###.#.a.
...#.#...#.#...#...#.....#...
.###.#####.#######.#.########
...#.......#...#...#.........
##.#######.#.#.#.###.#######.
.......#...#.#...#.#.#!....#.
.#.#C###.###.#####.#.####a.##
.#.#...#...#.#.T...#.#...#...
.###.#.###.#.##a.#.#.###.###.
.....#.#...#...#.#.......#...
.r####.#.#####.###s#######.##
...#.#...#...#.....#.....#.#.
##.#.##q##.#.C####.#.###.#.R.
.#...#...#@#...#.#...#...#...
.###.#.#.###.#.#.#####.#####.
.......c.C...#.......#.......
29 29
.........#.....#...#.........
.#######.#.#.#.###.#.##b##.#.
...#...#...#.#.A.#.#.#...#.#.
##.r.#.#####.###.#.#.#.#.#.##
.#...#.....#.#.....#.#.#.#...
.#####.#####.#####.#.###.#t#.
...#...#...#...#...#...#...#.
.#.#.###.#.#.#.#######.#.#.#.
.#...#...#.#.c.........#.#.#.
.#####.###.###.#########.#.#.
...#.#.#@#...#...........#.#.
##.#.#.#.###.#R###########.#.
.#.#.#.#...#.#.#.......#...#.
.#.#.#.###.#.###.#####.#####q
.#...#...#.......#...#.....#.
.###.###.##t######.#.#####.#.
...#.#.#...#.......#.#...#.#.
.#.#.#.###.#.####b.#.#.#.#.#.
.#.#.#...#.#.....#.B.t.#.#...
.###.#.#.#.#####.#.#####.###.
.....#.#R#.#...#.#.#...#...#.
.#######.#.#.###.#.#.#.#.###.
s........#.#.....#...#.#.#...
##########.#.#########.#.#.##
!..#...#...#...#.......#.#.#.
##.#.#.#.###.###.#.####T##.#.
..q#.#.#.#...#...#.#.......#.
.###.#.#.#.###.#####.#######.
.Q...#..a#...#...............
29 29
.#.........#.Cr..............
.#.#######.#.###.###########S
.#.#.....#...#...#.#.....Q...
.#.#####B#####.###.#.###.T.##
.#.#...R...#...#.....#.#.#.#.
.#.#.#######.#.###C#.#.#.#.#.
...#.#...#...#.#...#B..#.#...
.###.#.#.#.#####.#.###.#.###.
...#...#.#.......#.#...#.....
##.#.###.#########.#######.##
.#.#...#.........#.......#...
.#.###c#######.#.#R#####.##C.
.rb..#.........#...#...#...#.
.#a#.#.###########.###.###.#.
...#...#.S.....#...#.....#.#.
.#.#####.#.###.#.###.#.###.#.
.#.....#.#...#.#B#...#.#...#.
.###.###.###.###.###.#.#.###.
...#.....#.#...#.#.S.#.#...#@
##.#######.#S#.#.#.#t#####.##
.#...#...#...#...s...#s..#...
.###.#.#.###.#######.#.#.###.
...#...#...........#...#s..#!
.#.###############.#######.##
.#...........#.....#.......#.
.###########.#.#####.#####.#.
.#.......#r..#...#S..#.#...#.
tA####.#.#.#####.###.#.#.###.
.......#.#...........#.r.....
29 29
.....#.................#.....
.###.###########.#.###.#.###.
...#...#...#...#A#...#...#...
##.###.#.#.#.#.#####.#####.##
.#.#...#.#...#.......#.B.#.B.
.#.#.###.###.#########.#.#.#.
...#.#...#...#.....#.#.#...C.
.###.#.#.#####.###.#.#r######
...#.#.#.......#...At..#.....
##.#.#.#########.#######.###.
...#.#......@#!#.......#.#...
.###.#########.#.###T#.#.#.#.
...#...........#.....#...#.#.
##.###################.###.#.
...#.#.........#.....#...#.#.
.###.#.#.#####.#.###.#####.#.
...#...c.#...#.#.#.#.#.....#.
##.#.###.###.#.#.#.#.#.######
.#.#.#...#...#.#.#...#.......
r#.#.#.###.###.#.#.###TS####.
.#.#.#...#...#.t.#.#.........
.#.#####.###.#####.#.#####b#.
.#.#...#.#...#..R..#.....#.#.
.#.#.#.#.#.#B#.#########.#.#.
.#...#.#.#...#.#.........#.#.
.#####.#.b##.#.#.#.#######.a.
s..#...#...#...#.#.#...#...#.
.###.#####.#.#####.#.#.#.#.#.
...........#.......#.#...#...
29 29
...#.......#......@#.........
.#.#.#.###.#.#.#.###.####A##.
.#R#.#.#...#.#.#.#...#.#.....
.###.#.#.#####.#.#.###.#.####
.....#.#...#...#s#.#.....#...
.#####.###.#.#####.#####.###.
.#.#...s.....#...#.....#.....
.#.#.#.#QB####.#.#Q###.#####.
.#.#.#.#!....#.#.....#...#...
.#.#.#.#####.#.#####.###.#.##
.#.#.#.#.....#...#.#.....#.#.
.#.#.###.#####.#.B.#####R#.#.
...#.#...#.#...#.T.......#.#.
####.#.###.#.###.#.#####.#.#.
.....#...#...#.#.#...#.#...#.
.#######.###.#.#.###.#.#####.
.......#...#...#.#.#...#.....
.###.#####.#.###.#.###.#.#.##
...#...#...#.#...#...#.#.#...
.#####.#.#####.###.#.#.S.###.
.#..c#.#.#.....#...#...#...#.
##.#.#.#.#.#####.###ct####.#.
...#...#...#...#...#.......#.
.###.R######.#.###.#########.
.#...#...A.#.#...#.#.......#.
.#####.###.#.###.#.#.#####.#.
.....#.#...#.#..T#.#.#...#.#.
.#r#.#.#.##A.#.###.#.#.#.#.#.
...#...#.....#.......#.#.....
29 29
.............#...#.....#.....
####.###r#.###.#.#.#.###.#.#.
.....#..@#.#b..C.#.#.#...#.#.
.##T##.###.#.###.#.#.#.###.##
...#...S...#...#.#.#.....#...
.#.###.#.a####.#.###########.
.#...#.#.#.....#.#...#.....#.
c###.#.#.#.#####.#.#.#.C##.#.
.#...#...#.#...#...#...#...#.
.#.#######.###.#########.###.
.#.............#.......#...#.
.#############.#.####q.###.#.
.#a......#...#...#.....#...#.
.###.#####.#.###########.###.
...#.#...#.#...#...#.....#...
##.#.#.#.#.###.#.#.#.#######.
.#.#.#.#...#.....#...#.......
.#.#.#.###############.#####.
.#...#.....#...#.......#...#.
.###.#####.#.#.#####.###.###.
...#.#.#...#.#.....#...#.....
##.#.#.#.###.#####.###.#t####
...#...#.....#...#..!#.#.....
.###A#.#####C#.#######.#####.
.#...#.......#.............#.
.#.#.#c#####.#.#########c#.##
...#.......#.#...#.....A.#...
.#####.#####.#####.#####.###.
.a...#.............#.........
