abcdefghijklmnopqrstuvwxyz-=[];/
ABCDEFGHIJKLMNOPQRSTUVWXYZ_+{}:?
OOOOOOOOOOOOOOOOCCCCCCCCCCCCCCCC
7
9 9
Q..#@#...
.#.#.#.#B
.#.T...#.
.#.###.#.
.#..!#.#.
.#######.
.#.......
.###.###.
.....#...
9 9
.....#!..
.###.###.
.#.....#.
.###B#.#.
.....#@#.
.###.R##.
.#.#r....
.#t######
........S
9 9
.........
.B######.
.#..q..#.
.#.###.#.
A#..!#...
.########
.#@......
.######S.
.........
9 9
.....C..@
.#.######
.#....c..
.#######.
.#.b.....
a#.###q#.
...#...#.
.###.#.##
.....#..!
9 9
.....#...
.s.###.#.
@#.....#.
######.#.
..a.!#.#.
.##A##.#.
.#...#.#.
.#.#.###.
...#.....
9 9
@#...#...
.#.#.#.#.
...#...#.
########.
.....#...
.###.#.#.
...#..sA.
##.#####.
!..#.....
9 9
.........
##.#####.
...#...#.
.#.#.#.#T
.#.#!#.#.
.B.###.##
.#..@#...
.#######.
.R.......
