abcdefghijklmnopqrstuvwxyz-=[];/
ABCDEFGHIJKLMNOPQRSTUVWXYZ_+{}:?
OOOOOOOOOOOOOOOOCCCCCCCCCCCCCCCC
7
13 13
T......#.....
b#.###.#####.
.b.#.........
.###.#######.
.#.r...#...#@
.#######.#r##
.#.......#...
.#.#########.
.#.........#.
.B####.#####q
.#.....#!....
.#.##########
.............
13 13
B#.B...#.....
.#.#.###.###.
...#.......#.
.#######.###.
...#...#.#...
####.#.###a#.
!....#.....#.
############.
..@#.....#...
.###.#.###.##
.#...#..T#...
.#.#####.r##.
.......#.....
13 13
.......#.....
.#####.###.#.
.#.#.......s.
.#.#.#######.
.#...#..!#...
.#####.######
.....#...#...
.q##.###.#.#.
.#@#...#...#.
.#.###.#####.
...#.......#.
##.#.#######.
...#.......A.
13 13
.t.........#.
.#.#######.#.
...#...#...#.
.###.B##.###.
.#...#!#.#...
.s##.#.#.#.#.
.....#...#.#.
##R#.#####.#.
..@#...#.#.#.
.#####.#.#.#.
.#...#.#...#.
.#.#.#.#####.
...#.........
13 13
.....#.......
.#####.#####.
..c......#...
###b######.##
.........#...
.#######.###.
...#@..#.....
.#.###.#.####
.#s..#...#!..
.###.#######.
.#.#.......#.
.b.#######.#.
.......B.#...
13 13
.....#R..#...
.###.#.#.#.#.
.#!a.#.#...#.
.#.#.#.#####.
...#.#.Q@#...
####.#.#.#.##
...#.#.#.#.#.
.###.#Q#.#.#.
.....#.#.#...
.#####.#.###.
.t.#...#.#...
##.#.###.#.##
.....#.....B.
13 13
...#.......#.
.t.#.#####S#.
.#...#...#...
.#####.#.###.
.......#.#...
##.#t###.#.##
!#...#...#...
.#####.##C##.
.......#...#.
#####T##.#.#.
.......#C#...
A#######.####
............@
