abcdefghijklmnopqrstuvwxyz-=[];/
ABCDEFGHIJKLMNOPQRSTUVWXYZ_+{}:?
OOOOOOOOOOOOOOOOCCCCCCCCCCCCCCCC
7
17 17
.#!....#.........
.#####.#####.####
.....#.....#.#...
.#.#######.#.#.#.
.#.#.......#...#.
.#.#.#######.###.
.#.#.#.........#.
.#.#.#.a########.
.#.#.#.#.........
.#.#.#.#.#######.
.#.#.#.#...#.....
.#.#.###.#.###.##
@#.#...#.#...#...
##.###.#####.###.
...#...#a..#...#.
.###.###.#.###.#.
.........#.....#.
17 17
.....#...#@......
##.#.#.#.#######.
...#.#.#...#...#.
.###.#.###.#.#.#.
...#.#.#.....#...
.#.#.#.##########
.#.#.#.#.........
.#.#.#.#.#######.
.#.#...#.......#.
##.#########r#.#.
...#.......#!..#.
.#.#.#####.#####.
.#.#...#.....#...
.#.###.#.#####.##
.#.#...#.....#...
.###.#######.###.
...........#.....
17 17
.#.....#...#.....
.q.#.###.#.#.###.
...#.....#.#.#...
.##R######.#.#.#.
.#.....A...#.#.#.
.#.#########.#.#.
.#........r..#.#.
.#############.##
.......#.....#...
######.#.#.#####.
.....#...#@#.....
.#a#####.###.###.
.......#.#...#...
.###.###.#.######
...#.#...#.#....!
##.#.#.###.#.####
A..#.....#.......
17 17
.................
.#####.#########.
.....#.#.....#.#.
###a.#.#.#.Q.#.#.
.....#.#.#.#...#.
.#####.#.#.#####.
.#.....#.#.#.....
.#.#######.#.####
.#.......#...#...
.#######.###.#.#.
.#.....#...#.#.#.
.###.#.###.#.#.#.
.....#...#.#...#.
######.###.#####.
.#.....#...#...#@
.#.#####.###.#.##
.......#.....#..!
17 17
.................
####.###########.
.....#!#.......#.
.###.#.###.#.###.
.#...#...#.#.#...
.#######.#.#.#.##
...#.....#.#.#.#.
##.#.#####.#.#.#.
...#.#...#.#@#...
.###.#.#.#.#####.
...#.q.#.#...#...
##.#####.A.#.#.##
.#.......#.#...#.
.#########.#####.
.#.......#.#.....
.#.#####.#.#.###.
.......#.....#...
17 17
.........#.......
.#########.#####.
.#...........#...
.#.###########.a.
.#........Q#...#.
.#######.##R.###.
.#....Q..#!#.#...
.#.#######.#.####
.#...#@#...#.#...
.###.#.#.###.#.#.
.#...#.#.#.....#.
.#.###.#.#######.
.#.#...#...#...#.
.#.#.#.###.#.#.#.
.R.#.#.#...#.#...
.###.#.#.###.###.
.....#.#.....#.a.
17 17
.....#.........#.
.#####.#.#####.#.
.#.....#...#.....
.#.######r.######
.........#.......
########.#######.
..!#...#...#.....
.###.#.##Q.#.###.
.#...#...#.#.#...
.#####.#.#.#.#.##
.....#.#...#.#.#.
####.#.#####.#.#.
.....#.#.....#...
.###r###.#######.
.#.......#.....#.
.#####.###.###.#.
.......#....@#...
