abcdefghijklmnopqrstuvwxyz-=[];/
ABCDEFGHIJKLMNOPQRSTUVWXYZ_+{}:?
OOOOOOOOOOOOOOOOCCCCCCCCCCCCCCCC
1
17 17
...#...#.........
.###.#.#c#######C
.#...#!#.#.....#.
.#.###c#.#.###T##
..q#.B...#.#@#...
.###.###.#.#.###.
a#.....#.#.#...#.
.#######.#b###.#.
.......#.......#.
######.#####.###.
.....#Q..#...#.t.
.#.#####.#####.##
.#s....A.....#...
.#####.#####.###.
R....#.....#A..#.
####.#.#######.#.
.....#..r......S.
