abcdefghijklmnopqrstuvwxyz-=[];/
ABCDEFGHIJKLMNOPQRSTUVWXYZ_+{}:?
OOOOOOOOOOOOOOOOCCCCCCCCCCCCCCCC
7
13 13
.#...........
.#.#.######r#
...#.....#...
########.#.#.
.........#.#.
.#########.#.
.........#.#.
.#######.#.#.
.....#.#.#!r.
####.#.#.###.
...#...#.#...
.#.###.#.#.##
@#.....#.....
13 13
.c.....b.#...
####.#.#.#.#.
!..#.#.#...#.
##.Q.#.######
...#.#.......
.###.#######.
...#.#...#...
##.#.#.#.#.##
.#.#.T.#.#R..
.#.###.#####.
.#.#@..#..s#.
.#.#####.#.#.
......A..#...
13 13
....t......#@
.#.#######.#.
.#.#.........
.#.C####.####
.#.....#.#...
######.r##.#.
.....B.#...#.
.#######.s##.
.......#.#!#.
.#####.#.#.#.
.....#.#.#.#.
##S#.#.#.#.#.
.....#...#..q
13 13
.......#.....
.#####.#.#.##
.....#...#...
###t.#######.
.q...#...#@#.
.#.B##.#.#.#.
.#.#...#...#.
.#.#.#######.
.S.T.#.....#.
.###.#.###.#.
.#...#.#.#!#.
.###.#.#.##b.
.....#..r....
13 13
b..#...Q.....
.#.#.#####.Q#
.#...#...#...
.#######.###.
.#.........#.
.###.#######.
.#...#.......
.a.#.#.######
...#.#.....#!
####.#####.#.
@#...#...#.#.
.#.#####.#.#.
......r..b...
13 13
...........#.
.b####.###.#.
...#.#.#@#...
##.#.#.Q.###.
.....#.#...#.
.#####.#.###.
.#.#...#..C..
.#.#.########
.#.R.........
.#.#########.
.........#...
########.#.##
.........#..!
13 13
............@
.#####.######
...#.#.#.....
.#.#.#.#.###.
.#.#...#.#...
##.#####.#.#.
...#.....r.#.
.###.#####a#.
.....#.....#.
####.#.#b###.
..!s.#.#.....
.#####.c.####
.......#.....
