abcdefghijklmnopqrstuvwxyz-=[];/
ABCDEFGHIJKLMNOPQRSTUVWXYZ_+{}:?
OOOOOOOOOOOOOOOOCCCCCCCCCCCCCCCC
7
33 33
.......#.......b...#.......#.....
.###.#.#.#####.#.#.#.#####.###.#.
...#.#.#.....#...#@#...#.#...#.#.
####.#.#####.#########.#.###.##S.
...#.#.#...#.......#...#...#.#...
.#.#.#.#.#.###.###.#.###.r##.#.#.
.#...#.#.#...#.#...#.#.......#.#.
.#####.#.###.#.#.#.#.#.#######.#.
.#.......#...#.#.#.#.#.#......r#.
.#####t#####.###.s.A.t.#.#####.#.
...........#.....#.#.#.#.#.....#.
######.###.#.#####.#.#.###.#####.
.....#c#.#.#.#...#.#.#.....#...#.
.#T#.#.#.#.###.#.##S.#####T#.##Q.
.#...#...#.#...R.....#.......#...
.###.#####.B.#S#######.#.#.###.##
...#.....#.#.......#...#.#.#...#.
##.#####.#.#######.#.###.#.#.###.
...#.....#.....#...#.#...#.#.#...
.###.#####.#####.#####.#.###.#.#.
.#.........#.....#.....#.#...#.#.
.#.#########.#####.#.#####.###r#.
.#...#!......#...#.#.....#.......
.a#####t######.#.###a###.####a##.
...........#...b.....#.....#.....
.#######.#.###.#####.#.#S#.#.####
.#.......#.#...s...#...#...#.....
.#.#######.#.###.#.#############.
.#.#.....#...#...#.#...#.......#.
.#.#.###.#####.###.#.#.#.#####.#.
.#...#.#.....#...#...#...#...#...
.#####.#####.###.q########.#.####
...........#...............#.....
33 33
.......#...........#.......#.....
.###.#r#.#.#######.#####.###.###.
.#.#.#.#.#.#..t#.......#.....#...
.#.#.#a#.#.#.#.#######.#.#####.#.
...#.#.#.#...#...#...#.#.....#.#.
##.#.###.#######.#.#.#.#######.#.
t#.#.#.........#.#.#.#.......#.A.
.#.#.#.#########.t.#.##B####.#.##
...#b..#...#.....#.#.......#.#...
.#######.#.#.#######.#######.###.
.c...#...#...#r....#.#...#...#...
####.#.#######.#.#.#.#.#.#.###.##
.#...#.....#.#.#.#...#.#.#.#.....
.#.#######.#.#.#.#####.#.#.#####.
...#....Q#.#...#.#.....#...#.....
.###.#.###.#.###.#.####S##.#.###.
.#...#.#...#.#...#.#...#!#...#...
.###.#.#.#####.###.#.#.#.###T####
...#.#.#.....#...t.S.#.#.....#...
##.###.#####.#.#.#.#.#.#T###.#.#.
.#.....#.#...#.#...#@#.....#...#.
.####r.#.#.###.######b##.#.#####.
.........#.q.#.....#...#.#...#...
.#######.#.#.#####.#.#.###.#.#.##
.#...#...#.#.#.......#.....Q.#.#.
.#.#.###.#.#.#.########T######.#.
.#.B...#.#.#.#...#.#.........#...
.#.###.###.#.###.#.#.###Q###.###.
.#...#.....#.....c.#.......#.....
.###.#####################.######
...#.#...#.....#.........#...#...
##.#.#.#.#.###.#.#####.#####.###.
...#...#.....#.......#...........
33 33
.......#...#.S...a...............
.#####.#.#.#.###.#.#####r#####.#.
...#!#...#.#...#.#.#.........#.#.
##.#.#####.#.#.###.#.t#B####.#.#.
...#.#.....#.#.....#...#...#.#.#.
.###.#.###############.#.#.#.#.#.
...#.#.....#.........#...#.#...#.
.#.#.#####.#.#######.#.###.#####.
.#.#.....#...#.#.....#.#...#.#...
##.#####.#####.#.#######.###.#.##
...#...#...#...#.#.......#...#...
.#.#.#.##S.R.###.#.#########.###.
.#.#.#...#.#...#.#...#@........#.
.#.#####.#.#.#.#.#.#.###S#.#####.
.#.....#.#.#.#...#.#.....#.#...#.
.####r.#.#.###.#########.#.#.#.#.
...#.#...#...#...........#.#.#...
.#.#.###.###.###A#########.#.####
.#.#.....#.#...#.......#...#.....
.#.###.###.###.#.##R##.#.#.#####.
.#...#...#...#...#.....#.#.....#.
####.###.#.#.#####.#######s###.#.
.....#.....c.....#.#.........#...
.#####s###########.#.#######.###.
.#...........#...#...#.....#...#.
.#.####s####.#.#.S####c###.B##.##
.#...#...#.#...#.#.....#.#.#.#...
.##B.#.#.#.#####.#.#.###.#.#.###.
...#.#.#.....#...#.#.#.......#.#.
##.#.#.#####.#.###.#.#.#####.#.#.
...#...#...#.#.#...s.#.#...A...#.
.#######.###.#.#.###.###.#.###r#.
.............A.....#.....#.......
33 33
.......c...#.......Q...#.#.......
##.#.#S#.#.#.#.####C##.#.#.#.####
...#.#...#.#.#.#.#.....#...#.....
.#####.###.#.#.T.#.#####.###T###.
.#.....#...#.#.#...#...#...#...#.
.#.#####.###.#.#.###.#.###.#.#.#.
.#.....#.....#.#.....#...#.#.#...
.#.#######.###.########r.###.###.
...#.....#...#.#...#.........#...
####.###.###.#.#.#.##Q.#########.
.....#.....#.#.#.#...#.#...#...#.
.#######b#.###.#.###.###.#.#.#.#.
.#.......#.....#...#...#.#...#.#.
.#.s####.#####.###.###.#.#####.##
.#...#...#...#...#...#.a.#...#...
.#.###.###.#####.###.#.#.#.#.R##.
...#...#.........#...#.#.#.#...C.
.###.#.#####.#C###.###.#.#.#####.
...#.#.#...#.....#...#.....#...#.
##.#.###.#.#########.#r#####.#.#.
...#.....#...#.....#.#.#!....#.#.
.###########.#.##s.#.#.#######.#.
...#.....#.#.#.#.#...#.......#.q.
##.#.###.#.#.#.#.#####.#######.#.
@#...#.#.#.#...#...#...#.....#.#.
.#####.#.#.#####Q###.#.#q###.#.#.
.......#.#.#.........#.#.#.#.#.#.
######.#.#.#.#######c#.#.#.#.#.#.
.......A.#...B...#..c..#...#...#.
.#######.#########.###.b##.####r.
...#.....#...S.....#.#.#.#.#.....
.#.#.#####.#########.#.#.#.###.#.
.#......r..#..........a.S#.....#.
33 33
...............#...#.....A.......
.###A#####.###.#.t.#######.#.###Q
.#.....#...#.....#.......#.#...#.
##.###.#.###############.#.###.##
...#...#.......#...#.....#.#.#...
.#####.#####.#.#.#.#.#####.#.###.
.....#.....#.#.#.#.#...#.#.#.#C..
####.#####.###.#.#.###.#.#.#.#.##
...#s#R..#.....#.#...#B#.....#...
.#.#.#.####A####.S####.#########.
.#...#.s.........#.....#TA.......
.b####.#.#######.#.#####.#######.
...#.#...#...#...#.#c........#...
.#.#.#.###.#.#.#.#.#######.#.###.
.#.#.#.#q..#@#.#.#...#...#.#...#.
##.#.#.###.##r.#####.#.#.#####.#.
...#.....#...#.....#.#.#.....#.#.
.#######.###.###.#.#.#.#####.#.#.
...#...#.....#.#.#.#.#..a.t#...#.
##.#.b.##B##.#.#.a.#.#.###.###ss.
...#a#.#.......#.#.#C#.#...#...#.
.###.#.#########.#.#.#.#.#####.#.
.....#...#.....#.#.#.#.#..r..#.#.
#####A##.#.###.#.###.#.#####.#.#.
...#...#.#.#!..#.#...#.#...#.#...
.#.#.#r#.#.#####.#.#####.#.#.#.##
.#.#.#.#.#.r.....#.#...#.#...#...
.##r.#.#.#.#.#####.#.#.c.########
s#...b.#.#.#.......#.#.#.#.......
.#.###.#.#.#.#####B#.#.#AC.#####.
...#.#.#...#.#.......#.#...#.....
.###.#.#####.#.#######.#####.s##.
.....#.........#....q........#...
33 33
.............R.............#.#...
.#####.#####.#.#.#A#######.#.#.#.
.#...#.#.....#.c.#.....#...#...#.
##.#.#.#.#T###.#.a.###.###.###.#.
...#.#.#.#.....#.#.#.#...#...#.#.
.###.#.#.#.###.#.#.#.###.#a#.###.
.#.....#A#@#...#.#...#...#.#...#.
.#######.###.#####.###.###.###.#.
...#.........#.....#...#...#...#.
##.#########q#.#####.#####.#.###.
...#...#.c...#.....#.#!#...#.#...
.###.#.#.#########.#.#.#.###.###.
...#.#.#...#.......#.#.#.#...A...
##.#.#.###.#.##r####.#.#.#.###.##
.#...#...#.#.#.....#...#...#.....
.#######.###.###.#.#####.#######.
.......#...#...#.#.....#.#.....#.
.###.#####.C##.#.#####.#.#.###.#.
...#.....#.....#...#...#.#.#...#.
##.S##.C##########.#.###.#.#.###.
.#.#.#...........#.C.....#.#.#...
.#.#.####a.#.#####.#######.#.#.#.
.#.#...#...#.#...#.#.....A.#.#.#.
S#.#.#.#.#####.#.#.###.#.#.#.#.#.
...#.#.#.#.....#.#.....#...#.#.#.
.###.###.#.#####.###########.#.#.
.#...#...#.#...#...#.......#.S.#.
.#.###.#A#.#.#.###.#.#.####t.#.#t
.#...#.....#.#...#...#.....#.#...
T#.#.#######.###.#b#######.#.###.
.#.#.......#.#.....#S....#.#...#.
.#######.#.###.###Q###.#.#.###.#.
.........#.....#....r..#.#.......
33 33
...................#.............
.#################.#.#.#########.
.#...............#.#.#.#...#.#...
.#######.#########.#.#.#.#.#.#.##
.......#.#.........#.#.#.#.#...#.
.#####.#b#.#####.###.#.#.#.#.###.
.#...#.#...#...#.#...#.#.#.#.#...
.#.###.#####.#.#.C.###.#.#.a.###.
.#...#.......#.#.#.#.#.#.b.#.....
.#.#.#########.#.#.#.#.#.#.#####.
.#.#...#.....#.#.#...#...#.#...#.
.###.#.###.#.#.###.#######.#.###.
.....#.....#.#.....#...#...#.#...
############.C######.#.#.###.#.##
...#.......#.#...#...#.#.#T#...#.
.###.###.#.#.###.#.###.#.A.#.###.
...#R#...#.#.....#.#...#.#.#.#...
.#.#.#.###.#####.#.#.###.#.#.#.##
.#.#.#...#.#.....#.#.#...#...#...
.#.#.###.###.#####.#.#.###.#####.
.#.#.#.#.....#@#...#.s.#.....#...
##.#.#.#####.#.#.###.#.#####.#.#.
...#.#.#...#...#.#...#...#.#.#.#.
.###.#.#.#.###b#.###.###.#.#.#.#.
...#.#.#!#.....#...#.#...#.....#.
.#.#.#.###r###.###.#.#.##########
.#T#.....#...#.#...#.#...........
.#.#####.#.#.#.#.##C.###.#######.
.#.....#.#.#.#.#.#.#...#.#.....Q.
B#.#####.#.#.#.#.#.###.###.###.#.
...R...#...#S#...#...#...#.#.#...
.###.#.##q##.R######.###.#.#.###.
.....#.............a...#...#....C
