abcdefghijklmnopqrstuvwxyz-=[];/
ABCDEFGHIJKLMNOPQRSTUVWXYZ_+{}:?
OOOOOOOOOOOOOOOOCCCCCCCCCCCCCCCC
7
13 13
.#.....#.....
.#.#.#B###.#.
...#r#.....#.
.###.#######.
...#.....#...
##.#####.####
@#...#.#.....
.b##.#Q####T.
...#.#.#...#.
.###.#.#.#.#.
.#...#.#.#...
.#.###.#.###.
.......#!#...
13 13
...R.#.......
##.###.#####.
...#...#...#a
.#.#.###.#q#.
.#.#...#.#.#.
.#####.#.###.
c......#...#!
.##A####.#.##
...#.....#.r.
##.#####.#.#.
@#.C...#.#.#.
.#####.###.#.
...........#.
13 13
......@#.....
##.#####.###.
...#.....#...
.#.#.#####.##
.#.#...#.#...
.#.###.#.#s#.
.#.#.....#...
.###.###.#.#.
.#...#!#.#.#.
.#.###.###.##
.#.#.#...#...
.#.#.###.###.
.......#.....
13 13
.#...#.......
.#.#.#.#.t#A#
b..#.#.#.....
.###.###.###.
...#..!#.#.#.
##.#####.#.#.
@#.....#...a.
.#####.#####.
.#...#.....#.
.#S#.#####.#.
...#.......#.
.###########.
........C....
13 13
...T.........
####.########
.....#.......
.#####.#####.
.t...#.#.#...
####.#.#.#.##
...s.#.#.#!#.
.###.#.#.###.
.#@..#...#...
.#######.#.##
.....#...#...
.###.#.#####.
...#.........
13 13
...#!..#.q.#.
.###T#.#.#.#.
....Q#...S.#.
.###.#####.#.
.#.#.....#A#.
.#.#.#####.#.
...#.....#.#.
##.#####.#.#.
.#...#.#.#.#.
.###.#.R.#.#.
..@#...#.#.#.
.####t.#.#.#.
.......#.....
13 13
.....#.......
.###.#######.
.S.........#.
.#######q#.#.
.........#...
.#######.###.
...#.....#.#.
##.#.#####.#.
...#...Q..b..
.#####.#.####
.....#.#r#...
####.#.#.###.
@....#!#.....
