abcdefghijklmnopqrstuvwxyz-=[];/
ABCDEFGHIJKLMNOPQRSTUVWXYZ_+{}:?
OOOOOOOOOOOOOOOOCCCCCCCCCCCCCCCC
7
17 17
...#.......#..!#.
.#.#.#.###.#.###.
.#...#...#.#.....
.#######.#######.
@#.......#.....#.
##.###.###.#.#.#.
...#...#...#.#.#.
.#######.###.#.#.
.........#...#.#.
.#########.#####.
...#.....#.....#.
##.#.###.#####.#.
.#.#.#...#...#...
.#.#.###.#.######
.#.#...#.#.......
.#.###.#.#######.
.......#.........
17 17
.......#..!#.....
.#####.#.#######.
.#...#.#.........
.#.#.#.#########.
.#.#.......#.#...
.#.#######.#.#.##
.#...#...#.Q.#.#.
.###.#.###.#.#.#.
...#.#.......#...
##.#.###########.
.#.#...#.......#.
.#.###.#.#####.#.
.#.#.#...#...#...
.#.#.#####.######
.#...#...#.....#@
.###.#.#.###.#.#.
.......#.....#...
17 17
.....#...#.#.....
.###.#.#.#.#.###.
.#.#...#.#.....#.
.#.#####.#####.#.
...#...#!#...#.#.
##.###.###.#.###.
.#...#...q.#.....
.###.q##.#######.
...#.#...#.#...#.
.#.#.#.###.#.#.#.
.#.#...#...#.#...
.#######.###.####
.#.......#...#...
.#.#####.#.###.#.
...#...#...#@..#.
.#####.#########.
.................
17 17
.............#...
.#.#########.#.#.
.#.#...#...#...#.
.###.#.###.#####.
.....#...#.......
########.###.####
.......#...#.....
.#####.###.######
...#.#.....#.....
.#.#.#####.#.###.
@#.#.....#.#...#!
##.#.#####.###.##
...#.....#.#.#...
.###.###.#.#.###.
...#...#.....#...
.#.###########.##
.#Q..............
17 17
.#.......#...#...
.#.#####.#.#.#.##
.#...#...#.#.#...
.###.#.###.#.###.
...#.#...#.#...#.
##.#.###.#.###.#.
...#.#.#.....#.#.
.###.#.#######.#.
...#.#.....#!#.#.
.#.#.#.###.#.#.#.
.#.#.#...#.#...#.
##.#.###.#.#####.
...#.#...#.......
.###.#.###.######
.#...#..@#.......
.#.#############.
.................
17 17
.........#.......
######.#.#.###.##
.....#.#...#@#...
.###.###.###.###.
...#...#.......#.
.#.###.#########.
.#.#.#.#.......#.
##.#.#.#.#####.#.
...#...#.#.#...#.
.###.###.#.#.###.
.#.#...#.#...#...
.#.###.#.#.#####.
.#.#.....#.......
.#.#.###########.
.#.....#!#.#.....
.#######.#.#.####
.........#.......
17 17
...........#.....
##.#########.###.
...#...........#.
.#.#.###########.
.#.#.#.#...#.....
.###.#.#.#.#.####
.#...#.#.#.#.....
.#.###.#.#.#####.
...#.....#...#!#.
.###.#######.#.#.
.#@....#.....#...
.#####.#.###.####
.#...#.#...#...#.
.#.#.#####.###.#.
.#.#.......#.#.#.
.#.#########.#.#.
...#.............
