abcdefghijklmnopqrstuvwxyz-=[];/
ABCDEFGHIJKLMNOPQRSTUVWXYZ_+{}:?
OOOOOOOOOOOOOOOOCCCCCCCCCCCCCCCC
15
17 17
...........#.....
####.#####.#.###.
...#...#...#...#.
.#.#.#.#.#####c#.
.#.#.#.#.r@...t..
.#.###.#.###.###.
.#.#...#.....#...
.#.#.#######.####
.R.A.....#...#...
.#.q##.#.#S###.#.
.A...#.#.......#.
.###.#.s########.
.#!..#.#...#...#.
.#######.#.#.#.#.
...#...#.#...#...
##.#.#.#.###a###.
.....#...#.......
17 17
.#a..#...#.......
.#.#.###.#.#.####
.#.#...#.#.#.#...
.#.###.#.#.#.#.#.
.#.#...#...#.R.#.
.#.###.#.#######.
.#..!#.#.#...#...
.#####.#.#.#.#.#.
.......#...T@#.bq
.##########a##.#.
.....#.........#.
####.#.#########.
...#.#.......#...
##.#.#######.#.##
...#.#C....#.#.#.
.###.#.###.#.#.#.
.......#.....#...
17 17
.......#@..#.....
.#r###.###.#.###.
...#!..Q...#.b.#.
##.#####.###.#.#.
...#...#.......#.
.###.#.#S#####.#.
.....#.#.#...#.#.
######.###.#.#.#.
...#.#.#...#.#.#.
.#.#.#.#.###.###.
.#...#...#.#...#.
.###.#####.#C#.#.
s..#.#...#.....#.
##.#.#.C.#.####S.
...#.#.#.#.#.....
.#####.#.#.#.###.
.......#.....#...
17 17
@#.....#.....#...
.#.###.#.###q#.#.
.#...#.#...#.R.#.
.###.#.###.#####.
T....#...#.#.....
.#######.#.######
.#.......#.......
.#.###.#######.#.
.#.#...#.....#.#.
.#.#####.###.#.#.
.#...#...#.#.#.#.
.###.#.###.#.###.
...#...#...#!#...
##.#######.###.##
...#.....#...#.A.
.###.##A.#.#.###.
.....#.....#.....
17 17
.#.....#...#.....
.#.#.#.#.#.###.#.
...#.#...#...#.#.
####.#######.###.
.....#...#...#...
.#######.#.###.#.
...#.....S.....#.
##.#.#.#########.
...#@#.........#.
.#####.#.###.###.
.#...#.#...#.#...
.#.#.#####.###.##
...#.....#.#...#.
.##c####.#.#.###.
.....#...#.#.....
######.###.#####.
!......#.........
17 17
.....#!......#b..
.###.#######.###.
.#.........#.....
.#######.#######.
.#...#...#.....#.
.#.#.#####.#.###.
.#.#...#...#.....
.#.###Q#.#r###c##
....@#.#.#.......
.#####.#.###.#.##
.#.....#...s.s...
.#.###.###.#####.
.#.#.....#c....#.
.#.#.#########.#.
.#.#...#...#...#.
.#r#####.#.#.###.
.#.......#.......
17 17
.............#...
####.#.#.###.###.
...#.#.#.#!#.....
.#.###.#.#.######
.#.#...#.#.a.....
.#.#.###.#.#.###.
.#...#...#...#.#.
.####r##.#####.#.
.#.....#...#.....
.#.###.#c#.#.####
.#.#@#...#.#.#...
.#.#.###.#.#.#.##
.#.#.#...#.#.#...
.#.#.#.##q##.###.
.#...#.#...#...#.
.###.#.#.#.###.#.
.....#...#.......
17 17
.......#...#...tC
####.#.#.#.###.##
.....#..q#...#...
.#.Q########.###.
.#.#.....#.#.....
.#.#.###.#.r####.
.#.#.#@#.#.....#.
.#.#.#.#.#.#.###.
.#.#.#.#.#.#...#.
.###.#.#.#####.#.
.#...#.#.#...#...
.#.###.#.t.#.#.##
.#.#...#...#!#...
.#.#.###########.
.#.#.#.....#...#.
.#.#.#.##Q.#.#.#.
.B.#.....#...#...
17 17
.......#.........
##.#####.######s.
...#.......#...#.
.r##.#######.#.#.
.....#...#...#.#.
.#####.###.##t.#.
.....#.#...#...#.
###C.#.#.###.###.
...#.#.#...#...#.
.###.#.###.###.#.
.........#..A#...
########.###.###.
...#@......#.#.#.
.#.#########.#.#.
!#.#.........#...
##.#.#S#######.##
.....#...........
17 17
.....#.S.........
.#####.##Q##.###S
.#.....#...Q...#.
.#.#####.#.#.#.#a
.......#.#.#.#.#.
.b###r##.#.###.#.
.#.....#!#...#.#.
.#.##b.#####.#.#.
@#...T...C...#.#A
####.###.#.###.#R
.....#.#...#.....
.#####.#########.
.#...........#...
.R.#########.#.#.
.#...#...#...#.#.
.###.#.##Q.###.#.
.....#.........#.
17 17
....!#...t.....#.
.#########.###.#.
...#.......#.#...
##.###.#####.###.
@#.....#...#...#.
.#######.#.#.#.#.
...#.....#...#...
##.#.###a#######C
...#...#...#...#.
.#.##q.#.#.#.#.#.
.#...#...#...#...
.############a##.
.........#.......
.#####.#.#.####R#
C#.#...#.#.#.....
.#.#.###t#.#.###.
...#.........#...
17 17
.............#...
.####S.#.####r.#.
.#...#.#.#!....C.
##.#.###.#######.
...#.#.....#...#.
.###.#.###.#.#.#.
.#...#...#...#.S.
.###.#.#.#####.#.
...a.#.#.#...#.#.
.#.#.###.#.###.#.
.#.#.t...#.#...#.
.#.#######.#.##C.
.#.....#a....#...
.#####.#######.##
.#...#.#.....#...
.#.#.#.#.###.###.
...#@#.....#.....
17 17
.S.....#@#...#...
##.###.#.#.#.#.#.
...#...#...#...#.
.###.###########.
.#.#...#.........
.#.###.#.#######.
.#.t.#.#.....#.#.
.#.#.#.#####.C.#.
.#.#.A.......#...
.#.###########.##
.#a..#.......#..q
.#####.#b###.###.
.#!....#...#.#...
.#########.#.###.
...#.......#...#.
.###.###.#####.#.
.......#.......S.
17 17
.......#.......#.
.A####.#.#.###.#.
.#.....#.#.#.....
.###.#####.#.####
...#.......#@#!..
.#.#############.
.#.#.......#.....
.#.#.#####.#.####
.#.#.#...#...#...
.#.#.###.#q#####.
.#.#.....#.....#.
##.#####.###.#.#.
......S#.....#...
.###.###########.
.#...#.........#.
.#####.#.##s####.
.......#.........
17 17
.......#.....#...
.##t##.#.#.#.#.##
...#...#.#.#.#...
.#.q####.#.#.#.#.
.#.......#.#.#.#.
.#########.#.B##.
.#...#.....#...#.
.###.S.#######.#.
.....#.......#.#.
####.#######.#.#.
B#...#...#...#...
.#.###.#.#.######
.......#.#.#.....
.####c####.#.###.
..@#.....#.....#.
.###.###.#######.
.#!..#...........
