abcdefghijklmnopqrstuvwxyz-=[];/
ABCDEFGHIJKLMNOPQRSTUVWXYZ_+{}:?
OOOOOOOOOOOOOOOOCCCCCCCCCCCCCCCC
7
13 13
.B...........
.#.##R######.
...#..@#...#.
.###.###.#.#.
.#...qc..#.#.
.###T#.###.#.
.....#...#...
.#######.###.
.#.......#...
.#.#######.##
.#.#..r....#.
.#.#.#######.
.#!#.......S.
13 13
.#...........
.#.###Qs####.
.#C#.#...#...
.#.#c###.#.##
.......#.#...
######.#.###.
...#...#.#.#.
.#.#.###.#.#.
.#!#@#...#...
.#####.###.##
..b....#...#.
########.###.
..R..........
13 13
.........#...
##.#####.#.##
...#...#.#...
.###.#.#.###.
.#...#.#.#...
.s.#####.#.#.
.#.........a.
.#.####C####.
.#.#......!#.
.#.#.####b##.
.#S#.#@#...#.
.###.#.#.#.#.
.....#...#t..
13 13
...S.......#.
.#.#####.#.#.
.#!#...#.#.#.
.###.#.#.#.#.
.#...#...#...
.#.#########.
.#...#.....#.
A###.#.###.#.
...#q#...#.#.
##.#.###.#.#.
...#.#.#.#...
.##t.#.#.####
.....#......@
13 13
.#.....#.....
.#B###.#.###.
...#.#...#...
.###.#####.##
.....#...#...
####.###.###.
.#...#....@#.
.#.###.#.###.
.#...#.#.#...
.###.#.###.#.
.#...#.#...#.
.#.###.#a####
.......q....!
13 13
.............
.#########.#.
.#.........#.
##.#.#######.
...#.#..r#@..
.#####.#.####
.......#.#...
.#######.S.#.
.#.#!..#...#.
.#R###.R##.#.
.#...#...#.#.
.T.#.##b.###.
...#...#.....
13 13
S..#....R....
.#.#.###.####
.#..s..#.....
.###########.
.#..@#...s...
.#.###.#.#.#.
.#.#...#.#.#.
.#.#.###.#.#a
...#...#.#...
##.###.#.#.#.
.#...#.#!#.#.
.###.#.#####.
.....#.......
