abcdefghijklmnopqrstuvwxyz-=[];/
ABCDEFGHIJKLMNOPQRSTUVWXYZ_+{}:?
OOOOOOOOOOOOOOOOCCCCCCCCCCCCCCCC
7
25 25
.#...#@..........#.......
.#.#.#########.#.#######.
...#....!#.....#.......#.
.#####b##a.###########.#.
...#...#...#...#.....#.#.
T#.#q#.###.#.###.#B###.#.
.#...#...#.#.....#..t....
.##A####.#.#######.######
.T.....#.#.#.....#.#...s.
####.#.#.#.#.###.###.###.
...#t#.#.#...#.#.#.....#.
.#r###.#.###.#.#.#.C####.
.#.....#...#b..#.#.#.#...
.#####.###.#####.#.#.#.##
.....#.#.#...#...#..T#...
####.#.#.###.#.###C#####.
.....#...#.#.#.....#...#.
.#######.#.#.#####.#.#.#.
...#...#.#.#.....#.#.#...
.#.#.#.#.#.##AA#.###.###.
.#...#.#...#...#...#...#.
####r#.#####.#.###.###.#.
.......#.....q.....#...#.
sb#####S.###########.###b
.....................#...
25 25
.....#...........#...#...
.###.#####.#.###.#.#.###.
...#.....#.#...#...#.....
##.#####.#.##r.#########.
...#.#...#.#.#.........#.
.###.#.###.#.#########.##
.#...#...#.#.....#t..#...
.###.###.#.###r#.#.#.###.
.....#.a.#.S...#...#...#.
####.#.#####A#.#####.###.
.....#...#!..#.......#...
.#######.###.#####.###.#.
.....#.#.#...#.....#...#.
####.#.#.#.###.#####.###.
...#.#.#...#.....#...#...
.#.#.#.#####.#####.###Q#.
.#.#.#.....#...#...#...#.
##.#.#.###.###.#.t##.#.#.
...#.#.#...#.#.#.....#.Q.
.#C#.#.#.###.q.#######.#.
..Q..#.#.c..........@#.#.
.#####.#.#############.##
.#.....#.....#.......#...
.#.#########.#.#####.###.
...#...........#.........
25 25
.........................
####.#################.#.
...#...B...............#.
.#.###T#.###############.
.#.......#....!#.......#.
.#########.#####.r####.#.
.#.......#...#...#...#...
.#.#####.###.#.#####.####
...#...#...#.Q.#.....#...
######.###.#.#.#.###.###.
.........#.#.#...#...#...
##.#####.#.#.#####.###.#.
...#...#@#...#..Q#...#.#.
.###.#.####A##.#####.#.##
...#.#.......#...#...#...
.#.#.#####.###.#.#.#####.
.#.#.#...#...#.#.#.#.....
.#.#.#.#####.#.#.#.#.####
.#.....#.....#.a...#.....
.#######.##b.#.r########.
.#.......#...b.........#.
.#.#####.#############.a.
.#...r...#...#.......#...
.###.#####.#.#.#.#######.
C..#.......#...#.........
25 25
...#...........#.........
.#.#.#########.#######.#.
.#.#.......#.#.....#...#.
.#.#######.#.#####.#.####
.#...T.#!..#...#...#.....
####.#######.##a.###.###.
.....q...........#.....#.
.#####.#################.
.......#...#.............
.#######.#.###.#########.
.........#.....#@......#.
#t#################t.#.#.
.....#.....#.........#.#.
.#.#.#.###.###.###.#####.
.#.#...#.#.#...#...#.....
##.#####.#.#.###.###.####
...S...#.#...#.#...#...#.
.#.#.#.#.#####.#.#####.#.
.#.#.#.#.#.......#.....#.
.#.#.#.#.#.#######.#####.
.#.#.#.#..B......#.....#.
.#S#.#.###############.#.
.#...#....c..........#...
.#.##########s##.#######.
...............#.........
25 25
...........#..........B..
.###########.#########.#.
.....#...#...#...#.....#.
.###.#.#.#.###.#.#.#####.
.#.#...A...#...#.#...#.#.
.#.#############.###.#.#.
.#...........#.....#.#.#.
.###.#.#####.#.#####.#.#.
...#.#.#@#.....#.....#...
##.#.#.S.#.####c.#####.#r
.#.#.#.#...q.....#.......
.#.###.#####.B##########c
.#...#...#...#.....#!....
.##c.###.#.A##.###.#####.
...#.#...#.#...#.#.....#.
##.#.#.###.#.###.#####.#.
...#.#.#...#.#...#...#...
.###.#.#.###.#.#.###.###c
...#.#.#...#...#...#.....
.#.#.#.###.#######.r##.##
.#...#...#.......#...#...
.#######.#####.#.##t.###.
.#.....#.....#.t...#...#.
.#.###.#####.#.#######.#.
...#.........#...........
25 25
.....#...#@#T....#.......
##.#.#.#.#.#.#.#.#.###.##
...#...#.#.#.#.#.#.#.#...
.#######.#.#.#.###.#.###.
.....#.#.#.#.b.......#...
.###.#.#.#.#.#########.#.
.#...#.#.#.#.#.#.......#.
.#.###.#.#.#.#.#.#######.
.#.#...#.#.....#.......#.
.#.#.#.#.#############.#.
.#.#.#.#.#.......#.....#.
##.#.QC#.#.#####.#.######
...#.#.#.#.#...#.#.......
.###.###.#.#.#.#.#######.
.#.........#.#...#.....#.
.#.###########.###.###.#.
.#.#.#.......#.....#.#.#.
.#.#.#.####Q.#######.#.#.
.#.#.#.#...#...#.....#...
.#.#.#.b.#####.#.###.##S.
.#...#.#...b.#.#.#...#...
.#####.#####.#.##BS##Q.##
.....#.#...#.#...#.....#!
.###A#.#.#.#.###.##a####.
...#.....#.....#.........
25 25
.....#.#..b......#.......
##.#.#.#.#####.#.#.###.#.
...#...#.#.....#.#...#.#@
.#######.#.#####.###.#.##
.#.......#.#...#...#.#...
.#.#######.#.#.###.#.#r#.
...A...#...#.#.....T.#...
.B######.#.#########.#.#.
.#.#.....#.q.........#.#.
.#.#.#.#####.#########.#.
...#.#.#...T..a..#.....#.
##.#.###.#########.#####.
...#.......#....r#...#.#.
##########.#.###.###.#.#.
.......#...#.#...#.R.#...
.#####.#####.###.B.Q#C.##
.#...#!#...c...a...#...#.
.#.#.###.#.###.#####.##S.
...#.#...#...#...#.#.#...
####.#q#.###.#aq.#.#.#.#.
C..#...#.#.#.#...#.#...#.
.#####.#.#.C.#.###.S####.
.#.....#.#.#b..#.........
.#.#####.t.#####.########
.........#...............
