abcdefghijklmnopqrstuvwxyz-=[];/
ABCDEFGHIJKLMNOPQRSTUVWXYZ_+{}:?
OOOOOOOOOOOOOOOOCCCCCCCCCCCCCCCC
7
17 17
...#@........U.#.
.#.#######.###.#.
.#.......#.v.#...
.#####B#.###.###S
.#...#.E...#.#...
.#.#.#####.#.#.#.
.#.#.....#.#..u#.
.#.##c##.#.#####.
.#...#...#.....#.
.###.#.#.###q#.#.
.#...#.#.#...#...
.#.###.#.#.#.###.
...#.#.#.#.#!#...
.###.#.###.###.##
...#.#...#.#c..#.
##.#.###.#.#.###.
.......#...#.r...
17 17
.....#.....#.....
.T##.#t###.###.#.
.#.#.#...v...#.#.
.#.#.###.###.###.
.#.#..!#...#...#.
.#.####q##.###.#.
.....#...#...#.#.
####.#.#.###.#.#v
.....#CS.#...#...
.#####.#.#.#####.
.#.#...#...#.....
.#U#.#.#####.###A
.#...#.....#...#@
.#####.###.###.#.
.....#...#...#.#.
####.#######.#.#.
.............#...
17 17
.........#q......
.###.#.###.###.#.
.#.#.#.U...#.#.#.
.#.#.#.#d###.#.##
...#.#.B.#...#...
##.#.#.#.###.###.
.#.#.#.#...#.#...
.#.#.#.###r#.#A#.
...#.#...#.#.#.#.
.###.###.#.#.#.##
.#...s@..#.#Q#...
##.#######.#.###a
...#.....#.....#.
.###.###.#####.#.
.....#.#...#...#.
.R####.###.#.###.
.....Q...#.....#!
17 17
....sR.......#...
.###.#.##S###e.#.
.#R..#.#.......#.
.###.#.#.#######.
...#...#.....#..s
.#.###c#####.#.##
.#...#.......#...
.###.#.#########.
.#...#...#.....#.
.#.#.###.###.#.#.
.#.#.#!#...#.#.#.
.#.#.#.#.#.###.#.
.#.#.A.#.#.#...#.
.#.#.b.###.#.###.
.#.#.#.....#.....
.#.#########.####
@#...............
17 17
...#.......#.c...
.#.#.###.#v#ev.#.
.#...#...#.....#.
.#####.#####.####
.....#.....#.#...
####.####r.###.#.
.....#...S.....#.
.#####.#.R######.
...q...#@#.......
##.#.#####.#####.
.#.#.#...#...#...
.#.#.#.#.###.####
.#.#...#.#...#!..
vV.#.S##.#.#####.
.#.#...v.#.#...#.
.#.#####.#.#.#.#.
.........#...#...
17 17
.#B....#.....#@..
.C.##T.#.s.#.###.
...#.#...#.#...#.
.###.#####.###.#.
.Q.D.....#.#.S.#.
##.#E###.#.#.##Q.
.#.#.....#.E..T#.
.#.#.#####.###.V.
.....#...b.#.#.#.
###D##.#####.#.#.
.......#.....#.#.
.###########.#.#.
!#.#.........#...
##.#.#.######c#R.
.#...#...........
q#.##v###########
.........c.....Q.
17 17
....!#...........
.#########.#.###.
...#.....#.#...#.
##.###.t.#####.#.
...#...#...#...#.
.###.#####.#.####
.#...#.....#.D.C.
.#.##c.#####.###.
c..#@#.....#.#...
####.#####.###.##
.........#..D#...
.#V#####.###.###.
.#.#...#...#..R..
##.#.#.#########.
...#.#.......#..e
.###.#####.###.##
.........#.......
