abcdefghijklmnopqrstuvwxyz-=[];/
ABCDEFGHIJKLMNOPQRSTUVWXYZ_+{}:?
OOOOOOOOOOOOOOOOCCCCCCCCCCCCCCCC
7
17 17
!#...#.#.......#.
.#.#q#.#.#.###.#.
...#.#...#.#.R.#.
###Q.#####.#.#.#.
.....#.....#.#...
.#S###.#####.###.
.#.....#@......#.
.#.T########.###.
.#...#.....#.#...
.##q.###.#.#.#.##
...#...#.#...#...
##.#.#.#.###.###.
...#.#.#...#.#...
.#####.#.#.###.##
.#s....#.#...#...
.#.#####.###.###.
...#.......#.....
17 17
.....#@#.........
.###.#.#.#####.#.
.#...#.#.#.....#.
.#.###.#.#.##a##.
.#.#.....#...#.#.
.q.###.#####.#.#.
.#...#.#.....#...
.###.###.#####.##
...#.....#.....#.
.#.#######.#####.
.#.#.............
##.###########B#.
...#......!#...#.
.###.#######.###.
.#...b.#..S#...#.
.#.###.q.#.#.#.#.
...#.....#...#...
17 17
....B#.c...B.....
.###.#.#####.###.
.#...#.....#.A.#.
.#.#######.###.##
.#.......#.#@#...
.#####.###.#.##R.
.#...#.......#...
.#.#.#########.#.
.#.#...#......R#.
.###.#.#.#######.
.#..aS.#.#...#...
.#.#####.###.#.##
.#.#!..#.#...#.#.
.#.###.#.#.###.#.
.....#.#.#.....#.
####.#.#.#B#####.
.....#...#.......
17 17
...#.............
.#.#.######s.###.
@#...#...#...#.#.
######.#.#.###.#.
.......#.#...#.#.
.#######.###.#.#.
.#.....#.....#...
.###.#########.##
.#!#.......#...#.
.#.#.#####.#.c##.
...#...#.#.#...r.
###S##.#.#.###.T.
.a...#...#...#.#.
b###.###.###.#.#.
.#.A...#.#.#...#.
.#.#.###.#.#####.
...#r............
17 17
.#.a...#.........
.#.#.###.###.####
...#.....#...#...
.#########.###.#.
.........#.....#.
####b###.#######.
...#...........#.
.#.#.####A######.
.#.#.#...#..!#...
#R.#.#.#.#.###.#.
...#.#.#@#.#...#.
.#.#.#.###.###.#.
.#.T.#...#...#.#.
.###.#.#.###.Q.#.
.....#.#...R.#.#.
.#########.#.#.#.
........T..#...#.
17 17
@.....C..........
####.#t#########.
...Q.......#.....
.#.#.#Q#####.###.
r#.#.#.....#.#.#.
.#.###.###.#.#.#.
.#..Q..#...#.#...
.#######.###.###.
...#...#...#...#.
.#.#.#.###.###.##
.#.#.#...#t..#...
##.#.###.###.###.
!#.#.T.#.....#...
.#.#.#.#######.B.
...#.#.........#.
####.#######.###.
b............#...
17 17
.....#.#.......#.
##.#.#.#.#####.#.
...#...#.....#.#.
.#####.#####.#.#.
.#!..#@#.....#...
.###.###.#####S#.
...#.....#.....#.
.########C.###.#.
.......#...#...#.
.###.###.###.#.#.
.#.#.....#.#.#.#.
.#.#######.#.#.#.
.#.....#...#.#.#.
.#.###.#.#.#.###.
.#...#.#.#.#.#...
.###.C.###.#.#.##
.....#.....#.....
