abcdefghijklmnopqrstuvwxyz-=[];/
ABCDEFGHIJKLMNOPQRSTUVWXYZ_+{}:?
OOOOOOOOOOOOOOOOCCCCCCCCCCCCCCCC
7
17 17
...........#.....
.#########.#####.
.......#...#..s.A
.#######.###.####
.#.......#.......
.#.#############.
.#.#.......#...#.
.#.#.#.###.#.#.#.
.#.#.#...#.#.#.#.
.#.###.#.#.#.#.#.
.#...#.#.#..A#...
.###.###.#######.
.#.#!#...#.....#.
.#.###.###.#.###.
...#.....#.#...#.
##.#####.#.###.#.
.........#..@#...
17 17
...#.....#.......
.#.#.###.#.###.#.
!#.#...#...#...#.
##.###.#####.###.
...#.......#.#...
.###.#####.#.###.
...#.#...r.#...#.
##.#.#.#.###.#.#.
.#.#.#.#...#.#.#.
.#.#.#.###.#b#.#.
.#.#@#.#.#.#.#.#.
.#.###.#.#.###.##
...#...#.#...#...
.###.###.###.###.
.#...#.....#.....
.#.###.###.#####.
...#.....#.......
17 17
.#...#...#...#...
.#.#.r.R.#.#.###q
...#.#!#...#....Q
####.##########Q.
.....#...........
.#####.##########
.....#.#.........
.###R#.#########.
...#...#.........
##a#####.#######.
.#.......#.....#.
.#########.###.#.
.....#.....#.#...
.#.###.#####.####
.#...#.#....S#...
.##a.#.#.###.#.#.
...R.....#.....#@
17 17
.........#.......
.###.###.#######.
.#.#...#.#.......
.#.###.#.#.######
..s#...#...#.....
s#.#.#####.#.###.
@#.#.....#.a.#.#.
.#.#####.###.#.#.
.#.#...#...r.#.#.
.#.#.#.#######.#.
.#...A...#.....#.
.#AR####.#####.#.
...#...#.#.....#.
.#.#.#.#.#.#####.
.#...#.#...#..!#.
.#####.###.#.###.
.....#.....#.....
17 17
...#.............
.###.#######.###.
...#...#...#.#...
.#.#.###.#q#.#.#.
.#...#...#.#.#.#.
.#####.S##.###.#.
...#.#.#.....#.#.
##.#.#.#q###.#.#.
@#...#..!#.#.#.#.
.###.#####.#.#.##
...#.#.....#.#...
.###.#.###.#.###.
...#..b#...#.....
##.#####.########
.......#.........
.#############R#.
.............B...
17 17
.......#..!#.....
.#.###.#.###.##S.
.#.#...#.#...#...
.#.#.#q#.###.#.##
.#.#.#.#.....#...
.#.#.#.#########.
.#.#.....#...#...
.#.#####.###.#.##
.#...#...#...#.#.
####.#.###.#.#.#.
.....#.....#.#.#.
.#.#######.###.#.
.#.S...#@..#...#.
.###.#.#####.###.
.#...#.....#...#.
.#.#######.###.#.
....Ar...#.......
17 17
.........#.#...#.
.#######.#.#.#.#.
...#...#...#!#...
##.#.#.###.#####.
...#.#.#...#..@#.
.#.#.#.#.###.#A#.
.#.#.#.#.#...#...
.#r#.#.#.#.###.##
.....#.#.#.#...#.
######.#.#.#.###.
...#...#...#...#.
.#.#.#####.###.#.
.#...#...#.s.#...
.#####.#.###.###.
...#...b...#...#.
.#.#.#####.#####.
.#.......#.......
